Process,Burst Time,Arrival Time,Waiting Time,Turn Around Time,Priority
38,15,1,0,15,3
30,46,1,15,61,5
1,18,2,61,79,1
24,16,3,78,94,2
22,15,4,93,108,1
93,44,4,108,152,1
11,4,7,149,153,5
88,41,7,153,194,5
32,29,9,192,221,3
41,1,11,219,220,1
21,40,12,219,259,2
72,45,12,259,304,3
20,46,13,303,349,1
17,20,14,348,368,2
3,26,16,366,392,5
65,29,16,392,421,5
57,26,17,420,446,2
100,29,17,446,475,4
25,47,18,474,521,2
23,36,18,521,557,3
14,1,19,556,557,3
67,3,19,557,560,5
2,27,20,559,586,1
16,38,20,586,624,1
47,29,21,623,652,1
51,26,21,652,678,2
26,44,22,677,721,4
34,16,23,720,736,2
58,37,23,736,773,3
86,20,24,772,792,1
66,18,24,792,810,4
96,26,24,810,836,5
55,28,25,835,863,3
12,19,25,863,882,4
29,2,27,880,882,1
84,29,27,882,911,3
10,16,27,911,927,5
80,30,27,927,957,5
63,40,29,955,995,5
18,28,31,993,1021,3
81,11,31,1021,1032,5
37,9,32,1031,1040,3
90,36,33,1039,1075,4
7,8,34,1074,1082,5
27,27,34,1082,1109,5
44,31,35,1108,1139,3
28,1,36,1138,1139,2
15,43,38,1137,1180,4
36,35,40,1178,1213,1
35,45,42,1211,1256,3
8,30,43,1255,1285,4
40,48,44,1284,1332,2
59,40,45,1331,1371,1
85,44,45,1371,1415,1
4,16,49,1411,1427,2
95,20,49,1427,1447,4
71,35,49,1447,1482,5
912,148,50,1481,1629,23
79,39,51,1628,1667,2
110,183,52,3384,3567,1
5,9,52,1702,1711,2
857,10,53,1710,1720,37
50,21,54,1719,1740,2
64,39,54,1740,1779,3
68,23,55,1778,1801,2
54,47,56,1800,1847,3
542,264,56,1847,2111,29
477,145,56,2111,2256,32
442,48,56,2256,2304,36
70,16,58,2302,2318,2
94,24,58,2318,2342,4
375,88,58,2342,2430,41
899,191,58,2430,2621,44
985,170,58,2621,2791,46
33,19,59,2790,2809,1
60,22,59,2809,2831,1
612,65,60,3534,3599,5
811,241,60,2855,3096,17
809,132,60,3096,3228,39
489,49,62,3226,3275,46
46,5,63,3274,3279,3
623,130,63,3279,3409,49
97,49,64,3595,3644,3
83,15,64,3644,3659,5
207,287,64,125814,126101,24
39,23,65,3792,3815,2
61,48,65,3815,3863,2
456,271,65,3863,4134,45
53,41,66,4133,4174,2
69,36,66,4174,4210,4
9,3,67,4209,4212,1
49,16,67,4212,4228,2
87,29,67,4228,4257,3
539,107,67,4257,4364,36
183,37,67,4364,4401,40
74,7,68,4400,4407,3
78,7,69,4406,4413,3
76,35,69,4413,4448,4
196,213,69,4448,4661,25
45,36,70,4660,4696,1
729,75,70,4696,4771,22
577,110,70,4771,4881,37
717,87,70,4881,4968,48
217,13,71,4967,4980,39
121,143,72,4979,5122,8
126,290,73,125969,126259,1
75,2,73,5244,5246,3
77,36,74,5245,5281,1
91,19,74,5281,5300,2
298,46,74,5300,5346,2
649,2,74,5346,5348,29
89,36,75,5347,5383,3
92,26,77,5381,5407,3
602,198,77,126177,126375,3
823,14,77,5485,5499,12
173,193,77,5499,5692,27
989,230,78,126276,126506,2
316,293,78,5789,6082,17
959,151,80,6080,6231,2
99,48,81,6230,6278,2
42,30,82,6277,6307,4
52,17,82,6307,6324,5
276,205,82,6324,6529,39
82,15,83,6528,6543,2
860,235,85,6541,6776,11
424,148,85,6776,6924,45
760,12,86,6923,6935,50
19,1,87,6934,6935,2
712,277,87,6935,7212,41
62,5,88,7211,7216,1
849,116,88,7216,7332,36
798,269,88,7332,7601,41
454,205,88,7601,7806,44
13,25,89,7805,7830,1
98,37,90,7829,7866,1
56,50,90,7866,7916,2
73,27,90,7916,7943,3
274,160,90,7943,8103,49
426,36,91,8102,8138,8
321,30,91,8138,8168,30
48,10,93,8166,8176,5
43,24,95,8174,8198,1
390,223,97,8196,8419,48
794,65,98,8418,8483,2
937,55,98,8483,8538,2
6,25,99,8537,8562,4
31,47,99,8562,8609,4
714,211,100,8608,8819,50
841,62,103,8816,8878,7
787,164,103,8878,9042,18
480,229,103,9042,9271,50
815,222,104,9270,9492,1
292,187,105,9491,9678,5
933,80,106,9677,9757,9
502,111,106,9757,9868,20
215,151,106,9868,10019,35
866,71,107,10018,10089,45
894,202,108,10088,10290,25
398,228,108,10290,10518,46
872,8,109,10517,10525,4
435,8,109,10525,10533,6
675,299,109,10533,10832,10
916,94,109,10832,10926,28
523,38,111,10924,10962,6
300,69,111,10962,11031,23
194,249,112,11030,11279,20
148,251,112,11279,11530,30
907,230,114,11528,11758,25
840,34,114,11758,11792,26
537,103,116,11790,11893,41
682,91,116,11893,11984,47
562,146,117,11983,12129,8
767,291,122,12124,12415,33
941,191,123,12414,12605,47
460,116,124,12604,12720,10
184,265,124,126328,126593,30
758,163,125,12851,13014,8
844,38,126,13013,13051,41
306,224,130,13047,13271,6
169,2,130,13271,13273,16
297,152,131,13272,13424,25
339,190,132,13423,13613,18
237,228,133,13612,13840,4
713,161,133,13840,14001,25
200,295,133,14001,14296,35
408,8,133,14296,14304,41
546,183,133,14304,14487,42
494,220,134,14486,14706,50
965,66,135,14705,14771,24
629,132,135,14771,14903,42
163,288,136,126483,126771,2
742,29,137,14999,15028,27
622,236,138,15027,15263,41
525,33,139,15262,15295,10
453,217,139,15295,15512,26
422,75,139,15512,15587,46
385,11,139,15587,15598,47
308,164,140,15597,15761,12
687,56,140,15761,15817,21
113,196,140,15817,16013,27
396,68,141,16012,16080,6
359,74,141,16080,16154,26
598,222,142,16153,16375,28
947,135,142,16375,16510,46
253,251,143,16509,16760,47
218,206,147,16756,16962,21
935,292,147,16962,17254,25
862,255,149,17252,17507,15
889,181,149,17507,17688,40
382,151,149,17688,17839,44
547,46,150,17838,17884,28
688,58,151,17883,17941,33
335,121,152,17940,18061,4
595,150,154,18059,18209,46
942,78,155,18208,18286,19
388,186,157,18284,18470,6
376,201,157,18470,18671,26
822,4,157,18671,18675,26
311,253,158,18674,18927,49
632,125,161,18924,19049,23
634,135,164,19046,19181,35
268,156,165,19180,19336,32
651,183,168,19333,19516,28
344,218,168,19516,19734,31
786,137,170,19732,19869,34
162,209,174,126660,126869,14
213,152,174,19938,20090,34
331,266,176,20088,20354,18
535,46,177,20353,20399,6
521,233,177,20399,20632,12
796,46,177,20632,20678,44
226,21,179,20676,20697,30
209,180,183,20693,20873,11
779,180,184,20872,21052,27
659,1,187,21049,21050,14
271,142,188,21049,21191,28
304,227,188,21191,21418,46
807,9,189,21417,21426,16
693,217,190,21425,21642,1
190,74,190,21642,21716,15
138,2,193,21713,21715,23
952,136,193,21715,21851,41
204,51,194,21850,21901,47
997,246,195,21900,22146,13
871,175,195,22146,22321,26
439,179,195,22321,22500,38
589,294,196,126724,127018,1
731,101,196,22622,22723,6
897,16,196,22723,22739,24
608,19,198,22737,22756,2
203,284,200,22754,23038,46
265,284,201,126874,127158,44
252,254,203,23174,23428,40
510,110,206,23425,23535,27
514,253,206,23535,23788,36
238,107,206,23788,23895,39
413,211,207,23894,24105,45
175,165,208,24104,24269,8
833,124,209,24268,24392,40
663,104,211,24390,24494,19
212,227,215,24490,24717,47
957,74,217,24715,24789,26
923,298,218,127002,127300,44
908,150,221,24924,25074,40
122,18,222,25073,25091,29
999,77,223,25090,25167,20
950,95,223,25167,25262,42
836,73,223,25262,25335,45
119,96,224,25334,25430,50
996,162,225,25429,25591,12
112,68,225,25591,25659,15
604,66,227,25657,25723,10
552,133,227,25723,25856,31
391,241,229,25854,26095,9
630,80,230,26094,26174,50
782,285,231,26173,26458,22
563,70,231,26458,26528,44
618,216,232,26527,26743,25
755,218,233,26742,26960,15
639,258,234,26959,27217,37
880,12,235,27216,27228,14
455,53,235,27228,27281,28
812,12,236,27280,27292,13
635,160,239,27289,27449,22
417,133,239,27449,27582,24
281,110,240,27581,27691,44
587,166,243,27688,27854,18
703,34,245,27852,27886,9
976,217,247,27884,28101,17
199,95,248,28100,28195,39
594,34,249,28194,28228,13
887,261,249,127141,127402,40
332,23,250,28355,28378,3
854,5,250,28378,28383,47
305,160,251,28382,28542,36
367,132,254,28539,28671,30
718,146,254,28671,28817,38
370,21,255,28816,28837,19
487,283,256,28836,29119,50
177,114,257,29118,29232,7
732,161,257,29232,29393,18
189,279,260,127262,127541,12
351,134,263,29516,29650,46
327,199,263,29650,29849,49
101,277,265,29847,30124,9
421,80,265,30124,30204,42
603,63,265,30204,30267,47
445,255,266,127411,127666,6
793,106,266,30390,30496,27
667,282,267,30495,30777,38
601,149,270,30774,30923,47
972,187,271,30922,31109,43
233,211,272,31108,31319,9
386,173,272,31319,31492,10
926,1,274,31490,31491,14
949,64,275,31490,31554,12
801,229,275,31554,31783,29
817,133,277,31781,31914,38
642,159,277,31914,32073,49
259,286,278,32072,32358,17
914,194,278,32358,32552,23
720,209,278,32552,32761,29
962,249,278,32761,33010,30
172,281,278,33010,33291,41
674,130,280,33289,33419,8
504,239,283,33416,33655,16
558,234,287,33651,33885,48
333,292,288,33884,34176,15
541,60,288,34176,34236,32
751,196,288,34236,34432,32
349,72,289,34431,34503,32
301,164,290,34502,34666,11
149,138,290,34666,34804,22
420,201,291,34803,35004,5
330,272,292,35003,35275,25
404,25,293,35274,35299,18
694,288,294,127499,127787,44
394,168,296,35435,35603,32
468,26,297,35602,35628,17
461,179,298,35627,35806,22
757,14,299,35805,35819,32
134,100,299,35819,35919,41
885,197,299,35919,36116,48
155,64,301,36114,36178,6
568,79,301,36178,36257,8
902,45,301,36257,36302,40
536,262,303,36300,36562,50
222,233,306,36559,36792,23
269,63,307,36791,36854,4
416,57,309,36852,36909,1
783,19,309,36909,36928,26
641,251,311,127646,127897,5
904,102,311,37050,37152,19
726,129,311,37152,37281,27
830,28,314,37278,37306,2
451,111,314,37306,37417,43
832,85,314,37417,37502,46
221,56,317,37499,37555,7
129,103,317,37555,37658,8
681,236,317,37658,37894,15
934,280,317,37894,38174,42
585,97,319,38172,38269,11
146,169,320,38268,38437,18
781,65,324,38433,38498,4
762,73,325,38497,38570,8
771,257,326,38569,38826,35
211,247,329,127801,128048,3
958,149,330,38900,39049,21
342,228,330,39049,39277,48
392,104,331,39276,39380,8
533,45,331,39380,39425,35
132,20,332,39424,39444,9
167,217,332,39444,39661,13
548,266,332,39661,39927,20
790,133,334,39925,40058,3
749,10,336,40056,40066,37
336,119,340,40062,40181,26
927,92,341,40180,40272,12
144,236,341,40272,40508,25
154,97,343,40506,40603,41
943,88,344,40602,40690,8
262,148,346,40688,40836,20
518,286,346,127892,128178,44
886,45,346,40975,41020,48
986,276,347,41019,41295,25
284,63,347,41295,41358,41
701,70,348,41357,41427,11
513,186,348,41427,41613,25
206,298,348,128028,128326,50
915,232,349,41760,41992,26
186,65,350,41991,42056,27
223,165,350,42056,42221,35
881,254,350,42221,42475,48
554,67,351,42474,42541,1
384,108,352,42540,42648,47
153,127,352,42648,42775,49
633,180,353,42774,42954,9
628,67,353,42954,43021,35
968,81,354,43020,43101,9
135,135,354,43101,43236,44
495,207,354,43236,43443,46
325,4,356,43441,43445,5
362,93,357,43444,43537,13
273,183,358,43536,43719,18
340,217,358,43719,43936,28
315,4,359,43935,43939,4
677,127,359,43939,44066,38
870,170,361,44064,44234,36
777,284,362,128214,128498,2
607,127,362,44331,44458,34
150,184,362,44458,44642,39
964,8,365,44639,44647,18
877,26,366,44646,44672,6
982,119,366,44672,44791,47
418,189,367,44790,44979,21
403,251,367,128368,128619,23
637,155,368,45103,45258,30
647,73,369,45257,45330,37
267,245,370,45329,45574,16
310,2,370,45574,45576,17
145,3,372,45574,45577,4
512,235,372,45577,45812,49
258,224,373,45811,46035,11
705,98,375,46033,46131,12
708,172,375,46131,46303,32
572,19,375,46303,46322,44
474,69,375,46322,46391,47
176,160,376,46390,46550,12
567,79,376,46550,46629,50
380,59,377,46628,46687,17
545,141,377,46687,46828,32
826,10,377,46828,46838,44
171,233,379,46836,47069,12
527,18,379,47069,47087,28
586,275,381,47085,47360,10
918,228,381,47360,47588,15
365,145,382,47587,47732,11
888,229,382,47732,47961,27
648,49,382,47961,48010,34
475,271,382,48010,48281,38
429,294,383,128476,128770,4
242,202,383,48407,48609,6
991,252,384,48608,48860,4
313,78,384,48860,48938,26
329,116,386,48936,49052,7
890,207,388,49050,49257,16
896,25,389,49256,49281,8
205,36,390,49280,49316,30
198,300,392,128627,128927,24
272,66,394,49446,49512,34
449,65,395,49511,49576,25
151,251,395,49576,49827,44
379,215,397,49825,50040,29
188,237,397,50040,50277,32
501,39,400,50274,50313,39
395,94,400,50313,50407,45
940,237,406,50401,50638,12
837,78,406,50638,50716,34
553,145,407,50715,50860,47
168,26,408,50859,50885,39
802,277,408,50885,51162,44
620,32,409,51161,51193,40
105,7,409,51193,51200,44
473,144,409,51200,51344,47
109,146,410,51343,51489,38
348,30,411,51488,51518,24
656,94,412,51517,51611,14
883,158,414,51609,51767,50
939,205,415,51766,51971,27
136,29,416,51970,51999,28
734,126,416,51999,52125,35
746,123,418,52123,52246,11
165,38,418,52246,52284,27
973,115,419,52283,52398,12
763,240,420,52397,52637,39
322,295,420,52637,52932,42
230,4,424,52928,52932,8
448,285,425,128756,129041,11
852,34,425,53069,53103,15
111,271,425,53103,53374,20
346,81,427,53372,53453,24
814,46,429,53451,53497,7
735,93,429,53497,53590,11
319,1,429,53590,53591,42
827,148,430,53590,53738,1
706,145,430,53738,53883,31
556,60,431,53882,53942,4
616,90,431,53942,54032,18
728,222,435,54028,54250,7
769,300,435,54250,54550,22
557,236,436,54549,54785,46
987,185,437,54784,54969,8
141,161,438,54968,55129,25
497,153,438,55129,55282,35
788,3,439,55281,55284,23
875,196,440,55283,55479,18
856,195,441,55478,55673,43
431,53,442,55672,55725,38
818,297,442,128879,129176,41
741,197,445,55867,56064,4
920,37,445,56064,56101,28
893,80,446,56100,56180,27
898,51,447,56179,56230,5
990,247,447,56230,56477,7
661,163,449,56475,56638,17
853,12,450,56637,56649,3
954,19,451,56648,56667,6
846,230,452,56666,56896,45
244,133,453,56895,57028,10
719,166,454,57027,57193,9
381,4,454,57193,57197,19
285,115,454,57197,57312,45
529,267,455,57311,57578,35
256,195,459,57574,57769,2
775,17,459,57769,57786,27
107,155,459,57786,57941,48
317,258,462,57938,58196,21
361,217,462,58196,58413,29
254,251,463,58412,58663,50
838,159,464,58662,58821,18
979,106,465,58820,58926,31
409,68,466,58925,58993,11
571,247,467,58992,59239,6
850,107,469,59237,59344,45
816,61,470,59343,59404,8
876,177,472,59402,59579,24
606,196,473,59578,59774,23
353,99,475,59772,59871,45
580,134,476,59870,60004,7
772,200,477,60003,60203,37
644,111,478,60202,60313,35
792,166,478,60313,60479,40
509,88,478,60479,60567,43
181,68,480,60565,60633,22
314,76,480,60633,60709,25
360,106,481,60708,60814,17
664,69,481,60814,60883,45
910,224,482,60882,61106,4
270,266,483,129004,129270,27
530,205,485,61234,61439,17
522,13,485,61439,61452,24
806,280,486,61451,61731,18
922,40,489,61728,61768,18
835,222,490,61767,61989,18
956,215,490,61989,62204,34
157,193,490,62204,62397,45
318,287,492,129137,129424,5
627,134,492,62519,62653,15
579,198,492,62653,62851,41
789,93,495,62848,62941,35
463,282,496,62940,63222,9
930,36,497,63221,63257,11
696,235,502,63252,63487,4
753,260,502,129287,129547,4
373,208,503,63613,63821,28
293,63,505,63819,63882,32
236,13,507,63880,63893,16
774,91,507,63893,63984,37
369,200,510,63981,64181,21
593,92,513,64178,64270,24
492,231,514,64269,64500,26
354,219,514,64500,64719,38
724,166,516,64717,64883,1
723,58,518,64881,64939,39
407,188,519,64938,65126,16
483,224,520,65125,65349,8
901,207,520,65349,65556,9
672,199,520,65556,65755,29
401,248,521,65754,66002,10
636,7,522,66001,66008,31
831,297,523,66007,66304,10
662,177,523,66304,66481,13
142,146,523,66481,66627,30
869,224,524,129427,129651,2
347,58,524,66724,66782,12
932,54,524,66782,66836,16
995,245,525,66835,67080,40
491,293,527,67078,67371,29
278,195,529,67369,67564,30
574,194,530,67563,67757,7
839,5,532,67755,67760,9
722,298,532,67760,68058,33
414,196,532,68058,68254,45
795,137,534,68252,68389,22
859,223,538,68385,68608,16
133,182,540,68606,68788,20
486,92,544,68784,68876,13
925,100,545,68875,68975,42
864,60,546,68974,69034,29
892,294,547,69033,69327,49
879,46,550,69324,69370,20
865,203,550,69370,69573,46
861,212,551,69572,69784,32
704,176,554,69781,69957,23
450,267,554,69957,70224,43
193,253,556,70222,70475,9
756,225,556,70475,70700,42
873,230,556,70700,70930,49
249,159,557,70929,71088,2
540,46,558,71087,71133,50
511,221,560,71131,71352,5
551,6,560,71352,71358,35
476,76,561,71357,71433,24
605,38,562,71432,71470,44
891,135,563,71469,71604,2
185,74,563,71604,71678,30
921,37,564,71677,71714,27
520,2,565,71713,71715,41
532,135,568,71712,71847,38
992,1,569,71846,71847,25
115,223,569,71847,72070,26
813,242,569,72070,72312,42
929,263,569,72312,72575,42
277,203,571,129515,129718,19
498,40,571,72662,72702,41
312,275,572,72701,72976,41
152,280,574,129591,129871,6
936,116,574,73098,73214,42
645,41,575,73213,73254,48
275,31,576,73253,73284,10
984,35,577,73283,73318,5
747,116,577,73318,73434,28
670,143,577,73434,73577,40
255,258,578,73576,73834,13
197,52,580,73832,73884,2
251,31,580,73884,73915,39
399,36,585,73910,73946,22
592,162,587,73944,74106,19
761,270,588,74105,74375,41
613,197,592,74371,74568,20
438,243,593,74567,74810,18
488,179,593,74810,74989,48
500,61,595,74987,75048,8
824,245,595,75048,75293,13
243,134,597,75291,75425,20
423,288,597,75425,75713,31
621,2,599,75711,75713,11
975,112,599,75713,75825,20
279,27,599,75825,75852,50
919,93,600,75851,75944,30
478,157,601,75943,76100,36
867,146,603,76098,76244,27
610,17,604,76243,76260,13
519,205,604,76260,76465,20
764,229,605,76464,76693,8
733,215,606,76692,76907,36
227,21,606,76907,76928,38
214,199,607,76927,77126,15
538,71,609,77124,77195,40
851,53,611,77193,77246,44
685,174,613,77244,77418,7
590,33,613,77418,77451,20
611,9,614,77450,77459,13
104,203,616,77457,77660,20
459,4,616,77660,77664,46
358,110,617,77663,77773,3
245,100,618,77772,77872,27
565,292,618,77872,78164,36
192,12,619,78163,78175,40
419,165,620,78174,78339,22
116,87,620,78339,78426,48
791,168,622,78424,78592,43
993,181,623,78591,78772,42
496,127,623,78772,78899,49
555,102,624,78898,79000,33
576,282,624,129692,129974,47
671,290,628,79125,79415,29
804,278,629,129846,130124,1
960,140,630,79536,79676,5
900,68,630,79676,79744,32
909,94,631,79743,79837,42
400,60,632,79836,79896,45
730,55,632,79896,79951,50
174,292,636,129972,130264,45
447,29,637,80091,80120,12
967,244,639,80118,80362,15
178,75,639,80362,80437,21
295,82,643,80433,80515,5
744,269,643,130140,130409,26
219,30,644,80631,80661,5
234,152,644,80661,80813,33
131,142,645,80812,80954,47
994,195,647,80952,81147,24
652,194,647,81147,81341,36
437,14,649,81339,81353,24
528,172,649,81353,81525,40
638,45,651,81523,81568,12
507,143,654,81565,81708,11
828,163,654,81708,81871,13
264,69,654,81871,81940,25
485,117,656,81938,82055,37
366,32,658,82053,82085,6
334,244,658,130275,130519,8
928,172,658,82204,82376,26
288,47,659,82375,82422,22
588,233,659,82422,82655,22
524,294,661,82653,82947,29
953,61,666,82942,83003,34
584,98,667,83002,83100,44
225,242,667,83100,83342,49
195,101,669,83340,83441,44
1000,80,671,83439,83519,14
118,57,672,83518,83575,17
371,292,673,83574,83866,49
581,208,674,83865,84073,4
676,147,677,84070,84217,42
653,277,679,84215,84492,36
845,85,680,84491,84576,4
434,237,680,84576,84813,11
224,187,682,84811,84998,32
471,1,682,84998,84999,32
843,126,683,84998,85124,3
797,283,683,130363,130646,28
356,47,683,85255,85302,46
969,157,684,85301,85458,10
803,171,684,85458,85629,32
752,134,686,85627,85761,2
241,211,687,85760,85971,36
428,150,689,85969,86119,25
287,300,690,86118,86418,18
446,262,690,130522,130784,26
364,277,691,86534,86811,34
690,151,693,86809,86960,13
368,86,693,86960,87046,27
484,180,698,87041,87221,5
658,289,698,87221,87510,21
239,164,699,87509,87673,15
299,77,699,87673,87750,19
974,138,702,87747,87885,29
397,268,705,87882,88150,50
139,297,706,130621,130918,34
650,96,707,88295,88391,34
534,130,708,88390,88520,49
355,169,709,88519,88688,7
597,269,709,130784,131053,28
683,177,711,88817,88994,9
472,287,712,88993,89280,18
692,188,712,89280,89468,24
411,14,712,89468,89482,26
506,170,713,89481,89651,21
855,103,714,89650,89753,29
283,265,714,89753,90018,32
619,113,714,90018,90131,47
646,185,715,90130,90315,36
596,98,716,90314,90412,17
931,225,716,90412,90637,39
458,143,716,90637,90780,45
560,164,718,90778,90942,23
770,51,718,90942,90993,42
402,60,721,90990,91050,29
503,258,721,91050,91308,42
323,47,721,91308,91355,45
944,149,722,91354,91503,29
508,72,722,91503,91575,42
863,212,724,91573,91785,29
821,70,724,91785,91855,32
374,59,726,91853,91912,23
378,134,727,91911,92045,28
499,214,728,92044,92258,17
963,166,730,92256,92422,16
320,296,730,130901,131197,28
878,134,730,92553,92687,41
490,297,733,92684,92981,21
440,187,734,92980,93167,44
977,183,738,93163,93346,21
882,113,738,93346,93459,48
739,111,739,93458,93569,41
482,64,739,93569,93633,49
389,69,740,93632,93701,4
737,145,742,93699,93844,11
235,166,742,131112,131278,14
158,146,742,93917,94063,29
847,300,744,94061,94361,38
257,137,745,94360,94497,44
917,56,746,94496,94552,11
457,299,748,131130,131429,7
493,204,749,94691,94895,7
140,242,750,94894,95136,35
583,255,751,95135,95390,46
911,294,752,131287,131581,11
702,207,752,95527,95734,35
805,221,755,131480,131701,2
296,207,756,95828,96035,37
377,9,756,96035,96044,50
905,202,757,96043,96245,21
743,169,757,96245,96414,29
517,63,757,96414,96477,48
309,80,759,96475,96555,37
655,168,760,96554,96722,28
467,231,763,96719,96950,6
543,18,763,96950,96968,38
350,202,764,96967,97169,20
338,71,764,97169,97240,47
103,69,767,97237,97306,17
766,196,767,97306,97502,25
352,5,767,97502,97507,39
383,149,770,97504,97653,33
180,280,771,97652,97932,31
466,260,772,97931,98191,13
665,3,773,98190,98193,14
229,8,773,98193,98201,44
286,104,774,98200,98304,45
848,76,775,98303,98379,13
387,215,777,98377,98592,4
406,246,780,98589,98835,5
250,197,780,98835,99032,20
372,76,781,99031,99107,48
302,105,782,99106,99211,23
246,27,782,99211,99238,43
978,134,785,99235,99369,13
906,159,788,99366,99525,10
980,229,788,99525,99754,11
591,7,788,99754,99761,30
678,262,791,99758,100020,22
640,254,791,100020,100274,25
260,235,792,100273,100508,17
425,152,795,100505,100657,6
575,145,795,100657,100802,43
955,104,795,100802,100906,46
343,130,797,100904,101034,7
393,162,797,101034,101196,17
216,193,797,101196,101389,37
680,236,798,101388,101624,48
689,8,801,101621,101629,5
669,27,801,101629,101656,35
108,16,802,101655,101671,28
432,192,804,101669,101861,38
736,206,804,101861,102067,42
868,26,807,102064,102090,13
570,298,808,131514,131812,24
479,300,809,102222,102522,10
660,142,810,102521,102663,5
208,196,810,102663,102859,17
550,46,810,102859,102905,42
441,259,812,102903,103162,17
748,114,812,103162,103276,40
970,86,813,103275,103361,21
945,249,813,103361,103610,42
128,6,815,103608,103614,14
363,283,816,103613,103896,46
695,59,824,103888,103947,24
106,80,826,103945,104025,28
946,273,827,131664,131937,47
544,195,829,104151,104346,13
691,23,830,104345,104368,15
710,194,831,104367,104561,12
465,190,832,104560,104750,22
738,195,832,104750,104945,50
578,38,834,104943,104981,28
643,15,837,104978,104993,30
740,134,839,104991,105125,17
810,215,839,105125,105340,39
164,97,839,105340,105437,45
773,100,840,105436,105536,47
337,175,842,105534,105709,1
280,196,844,105707,105903,45
130,252,845,105902,106154,20
263,233,845,106154,106387,38
433,255,847,106385,106640,39
858,108,849,106638,106746,8
754,147,849,106746,106893,15
625,53,849,106893,106946,23
679,39,849,106946,106985,41
842,42,849,106985,107027,49
566,99,851,107025,107124,24
716,283,851,107124,107407,29
179,30,852,107406,107436,19
341,216,852,107436,107652,39
778,53,853,107651,107704,45
780,79,855,107702,107781,15
721,171,856,107780,107951,30
924,77,857,107950,108027,40
938,203,857,108027,108230,42
759,119,857,108230,108349,47
626,81,860,108346,108427,29
117,93,861,108426,108519,13
231,57,862,108518,108575,25
776,133,863,108574,108707,38
481,201,863,108707,108908,42
569,261,865,108906,109167,39
182,92,865,109167,109259,49
137,70,866,109258,109328,15
988,43,866,109328,109371,19
526,65,866,109371,109436,26
614,293,868,131765,132058,28
981,193,870,109563,109756,39
191,169,870,109756,109925,42
874,130,871,109924,110054,37
415,157,871,110054,110211,42
324,44,874,110208,110252,26
615,38,877,110249,110287,26
715,192,879,110285,110477,20
707,47,879,110477,110524,21
505,244,881,110522,110766,15
247,88,881,110766,110854,50
120,133,882,110853,110986,45
307,68,884,110984,111052,7
727,275,884,111052,111327,48
201,285,886,131898,132183,32
452,33,887,111466,111499,2
290,57,888,111498,111555,36
202,222,888,111555,111777,37
785,249,891,111774,112023,20
709,25,891,112023,112048,41
114,202,892,112047,112249,9
631,210,894,112247,112457,30
430,215,894,112457,112672,39
819,150,895,112671,112821,30
564,226,897,112819,113045,29
561,175,897,113045,113220,32
961,189,898,113219,113408,27
784,287,900,113406,113693,18
600,237,900,113693,113930,35
170,228,902,113928,114156,4
971,129,902,114156,114285,32
768,267,903,114284,114551,11
248,121,903,114551,114672,14
808,26,905,114670,114696,26
998,84,906,114695,114779,17
291,151,907,114778,114929,21
913,146,911,114925,115071,14
765,188,912,115070,115258,50
725,216,916,115254,115470,41
143,172,917,115469,115641,16
326,88,917,115641,115729,42
711,202,920,115726,115928,5
220,299,921,132007,132306,13
884,90,923,116066,116156,27
160,156,924,116155,116311,15
125,113,924,116311,116424,42
668,226,927,116421,116647,4
948,59,927,116647,116706,28
166,61,930,116703,116764,6
684,46,934,116760,116806,20
147,124,936,116804,116928,5
427,290,938,116926,117216,49
232,55,940,117214,117269,11
464,235,941,117268,117503,42
599,22,943,117501,117523,28
266,6,943,117523,117529,42
698,48,944,117528,117576,14
582,140,945,117575,117715,20
410,129,946,117714,117843,2
210,8,948,117841,117849,2
470,81,948,117849,117930,31
289,132,949,117929,118061,41
657,17,950,118060,118077,4
294,104,950,118077,118181,15
895,42,951,118180,118222,12
654,222,951,118222,118444,33
820,214,952,118443,118657,15
700,234,952,118657,118891,27
951,178,952,118891,119069,46
357,55,954,119067,119122,1
686,294,954,132146,132440,4
303,4,954,119249,119253,26
983,223,956,132360,132583,3
825,162,957,119328,119490,12
282,185,957,119490,119675,34
799,174,957,119675,119849,34
261,178,959,119847,120025,27
444,4,960,120024,120028,10
573,186,960,120028,120214,30
531,266,960,120214,120480,42
673,88,962,120478,120566,1
161,135,964,120564,120699,18
666,9,965,120698,120707,18
559,98,965,120707,120805,21
240,155,966,120804,120959,39
102,77,967,120958,121035,48
750,233,968,121034,121267,16
624,224,969,121266,121490,1
187,177,969,121490,121667,13
412,243,969,121667,121910,35
228,170,971,121908,122078,10
156,291,972,132433,132724,24
834,104,973,122210,122314,42
697,163,974,122313,122476,19
609,80,975,122475,122555,18
462,190,983,122547,122737,18
159,89,985,122735,122824,35
515,220,985,122824,123044,45
469,41,986,123043,123084,31
829,187,987,123083,123270,35
903,73,987,123270,123343,50
443,274,988,123342,123616,45
549,294,989,123615,123909,38
345,173,990,123908,124081,5
800,125,991,124080,124205,2
436,37,993,124203,124240,7
124,41,993,124240,124281,15
328,98,994,124280,124378,10
127,15,994,124378,124393,11
617,175,994,124393,124568,17
405,105,994,124568,124673,40
745,82,996,124671,124753,12
516,15,998,124751,124766,11
123,137,999,124765,124902,8
699,92,999,124902,124994,10
966,19,999,124994,125013,39
5374,182,8000,125696,125878,1
8254,42,8000,125878,125920,20
6485,161,8000,125920,126081,30
1334,186,8000,126081,126267,35
6359,287,8001,126266,126553,1
1428,198,8001,126553,126751,7
4178,51,8001,126751,126802,37
7034,197,8001,126802,126999,40
8887,133,8002,126998,127131,13
9247,276,8002,127131,127407,15
5675,1,8002,127407,127408,22
8643,2,8002,127408,127410,25
4482,235,8002,127410,127645,38
9982,48,8003,127644,127692,9
4605,134,8003,127692,127826,40
2990,14,8004,127825,127839,1
1598,43,8004,127839,127882,5
8866,222,8004,127882,128104,17
3073,186,8004,128104,128290,25
6527,143,8004,128290,128433,40
7531,95,8004,128433,128528,42
3834,109,8004,128528,128637,43
6656,142,8004,128637,128779,50
3882,48,8005,128778,128826,5
5851,54,8005,128826,128880,5
6750,288,8005,128880,129168,20
1163,200,8005,129168,129368,22
1839,207,8005,129368,129575,27
5567,58,8005,129575,129633,30
9570,240,8005,129633,129873,33
1052,141,8005,129873,130014,47
3470,157,8006,130013,130170,45
9480,238,8006,130170,130408,45
6959,148,8007,130407,130555,15
8305,172,8007,130555,130727,22
4228,123,8007,130727,130850,27
5410,254,8007,130850,131104,37
3748,151,8008,131103,131254,7
9191,157,8008,131254,131411,11
4917,20,8008,131411,131431,44
6639,195,8008,131431,131626,45
2688,160,8009,131625,131785,20
5539,157,8009,131785,131942,46
5821,15,8009,131942,131957,49
5603,286,8010,1451969,1452255,8
3049,218,8010,132096,132314,10
2826,193,8010,132314,132507,20
7648,12,8010,132507,132519,29
9836,27,8010,132519,132546,29
2348,43,8011,132545,132588,11
6143,203,8011,132588,132791,13
4602,237,8011,132791,133028,23
7359,94,8011,133028,133122,34
1709,174,8011,133122,133296,36
5571,19,8011,133296,133315,40
9202,141,8011,133315,133456,47
6151,213,8012,133455,133668,20
8269,207,8012,133668,133875,31
2878,215,8012,133875,134090,32
9349,84,8012,134090,134174,37
9064,88,8012,134174,134262,40
2152,155,8013,134261,134416,17
4319,179,8013,134416,134595,25
6228,248,8013,134595,134843,36
4174,164,8013,134843,135007,38
5903,111,8013,135007,135118,41
3779,204,8014,135117,135321,18
9105,30,8014,135321,135351,30
6884,259,8014,135351,135610,35
7454,4,8014,135610,135614,48
9434,250,8015,135613,135863,31
5141,236,8015,135863,136099,32
9895,170,8015,136099,136269,32
2636,221,8015,136269,136490,33
2003,152,8016,136489,136641,1
5487,173,8016,136641,136814,3
5115,57,8016,136814,136871,6
3707,163,8016,136871,137034,9
9735,81,8016,137034,137115,23
3447,165,8017,137114,137279,5
9849,201,8017,137279,137480,23
5182,174,8017,137480,137654,42
8229,208,8018,137653,137861,42
5324,48,8018,137861,137909,46
3260,213,8019,137908,138121,19
1122,259,8019,138121,138380,24
1648,36,8019,138380,138416,44
5688,18,8020,138415,138433,13
9826,36,8020,138433,138469,31
3408,71,8020,138469,138540,42
5780,32,8021,138539,138571,2
8071,83,8021,138571,138654,18
6147,173,8021,138654,138827,41
2397,109,8021,138827,138936,42
2340,245,8021,138936,139181,45
2273,65,8021,139181,139246,47
7910,200,8022,139245,139445,5
2987,91,8022,139445,139536,6
6452,2,8022,139536,139538,10
4477,257,8022,139538,139795,13
8714,108,8022,139795,139903,37
1413,6,8023,139902,139908,2
9868,82,8023,139908,139990,3
6977,16,8023,139990,140006,21
6597,128,8023,140006,140134,36
9454,248,8023,140134,140382,36
8746,112,8024,140381,140493,17
1210,141,8024,140493,140634,22
6336,261,8025,140633,140894,15
6862,27,8025,140894,140921,32
5844,158,8025,140921,141079,44
4538,257,8026,141078,141335,16
4448,181,8026,141335,141516,25
5527,251,8026,141516,141767,33
7486,293,8026,141767,142060,44
6301,13,8026,142060,142073,50
4209,46,8027,142072,142118,6
5562,59,8027,142118,142177,8
8119,2,8027,142177,142179,8
3203,218,8027,142179,142397,28
9814,254,8027,142397,142651,30
6635,120,8027,142651,142771,46
5053,299,8028,1452094,1452393,28
6174,84,8028,142913,142997,34
7855,169,8028,142997,143166,36
1487,67,8028,143166,143233,37
1670,297,8028,1452245,1452542,44
1294,238,8029,143380,143618,19
3965,292,8029,143618,143910,23
9788,176,8029,143910,144086,33
4901,181,8029,144086,144267,47
2719,80,8030,144266,144346,25
7747,12,8030,144346,144358,43
9725,136,8031,144357,144493,3
8112,165,8031,144493,144658,8
5645,58,8031,144658,144716,16
5478,250,8031,144716,144966,20
5093,8,8031,144966,144974,25
5813,112,8031,144974,145086,25
2511,143,8031,145086,145229,29
8395,170,8031,145229,145399,32
6999,176,8031,145399,145575,36
8732,269,8031,145575,145844,39
5938,198,8031,145844,146042,40
5868,128,8031,146042,146170,49
1798,283,8032,146169,146452,4
7272,186,8032,146452,146638,17
1307,172,8032,146638,146810,18
6374,296,8032,1452398,1452694,29
9172,174,8032,146950,147124,41
9897,238,8032,147124,147362,48
8084,191,8033,147361,147552,7
6869,8,8033,147552,147560,9
3727,233,8033,147560,147793,16
3584,76,8033,147793,147869,25
9659,28,8033,147869,147897,48
9212,59,8034,147896,147955,40
2383,15,8035,147954,147969,18
2570,3,8035,147969,147972,23
3070,186,8035,147972,148158,33
8277,208,8035,148158,148366,47
5078,193,8036,148365,148558,4
5186,288,8036,1452547,1452835,28
4446,243,8036,148701,148944,30
6491,276,8036,148944,149220,34
1666,293,8036,149220,149513,40
1115,117,8036,149513,149630,49
3861,259,8037,149629,149888,2
1006,290,8038,149887,150177,6
2436,108,8038,150177,150285,23
4493,58,8038,150285,150343,32
4182,219,8038,150343,150562,38
1755,195,8039,150561,150756,6
1002,290,8039,150756,151046,13
3714,151,8039,151046,151197,28
6926,257,8039,151197,151454,37
2334,59,8039,151454,151513,40
2257,102,8040,151512,151614,3
4530,42,8040,151614,151656,34
6933,288,8040,151656,151944,34
1802,272,8040,151944,152216,36
8417,144,8040,152216,152360,41
6270,22,8040,152360,152382,45
7082,169,8041,152381,152550,16
8532,299,8041,152550,152849,20
8078,219,8041,152849,153068,22
2422,242,8041,153068,153310,45
8364,142,8042,153309,153451,7
5401,77,8042,153451,153528,22
2813,215,8042,153528,153743,29
2421,250,8042,153743,153993,30
9321,285,8042,153993,154278,32
7004,235,8042,154278,154513,35
5052,89,8042,154513,154602,43
2277,46,8043,154601,154647,6
3547,57,8043,154647,154704,16
7029,150,8043,154704,154854,28
4340,241,8043,154854,155095,37
4168,41,8043,155095,155136,43
2534,284,8043,155136,155420,49
7972,144,8044,155419,155563,4
1230,19,8044,155563,155582,11
9029,102,8044,155582,155684,18
9517,9,8044,155684,155693,21
2755,205,8044,155693,155898,22
9469,149,8044,155898,156047,46
1020,178,8045,156046,156224,7
9319,241,8045,156224,156465,7
6614,37,8045,156465,156502,30
8648,53,8046,156501,156554,20
2026,236,8046,156554,156790,26
4741,52,8046,156790,156842,26
1767,34,8046,156842,156876,38
5108,86,8046,156876,156962,42
7746,191,8046,156962,157153,45
5954,255,8047,157152,157407,36
6644,21,8047,157407,157428,36
8276,107,8048,157427,157534,6
9660,100,8048,157534,157634,13
6904,251,8048,157634,157885,14
6193,265,8048,157885,158150,19
6713,3,8048,158150,158153,22
2228,285,8048,158153,158438,30
3346,280,8048,1452688,1452968,33
7760,177,8049,158572,158749,2
1882,35,8049,158749,158784,6
5509,291,8050,158783,159074,7
1189,170,8050,159074,159244,13
4414,4,8050,159244,159248,18
7157,218,8051,159247,159465,27
6805,125,8051,159465,159590,34
6587,198,8052,159589,159787,2
1378,184,8052,159787,159971,11
1585,116,8052,159971,160087,36
8102,79,8052,160087,160166,40
4105,290,8052,1452821,1453111,46
9356,111,8053,160308,160419,3
4349,265,8053,160419,160684,21
9419,83,8053,160684,160767,33
4655,237,8053,160767,161004,40
6848,197,8054,161003,161200,5
7984,35,8054,161200,161235,16
8524,51,8054,161235,161286,20
5158,156,8054,161286,161442,34
3523,248,8054,161442,161690,47
5653,147,8055,161689,161836,7
6822,69,8055,161836,161905,14
1926,81,8055,161905,161986,16
5420,215,8055,161986,162201,31
5967,168,8056,162200,162368,5
2892,262,8056,162368,162630,48
3881,46,8057,162629,162675,10
3039,116,8057,162675,162791,18
2675,101,8057,162791,162892,20
1040,174,8057,162892,163066,23
2596,80,8057,163066,163146,24
8596,299,8057,163146,163445,41
9669,246,8058,163444,163690,10
2168,116,8058,163690,163806,19
2968,187,8058,163806,163993,26
6240,210,8058,163993,164203,36
1785,155,8059,164202,164357,14
6931,97,8059,164357,164454,22
9829,75,8059,164454,164529,49
2593,105,8060,164528,164633,2
9230,221,8060,164633,164854,33
6294,261,8060,164854,165115,35
1942,179,8060,165115,165294,41
3478,177,8060,165294,165471,45
1779,293,8061,165470,165763,20
2653,103,8061,165763,165866,48
6992,64,8061,165866,165930,48
4004,13,8061,165930,165943,49
4104,202,8063,165941,166143,3
7093,42,8063,166143,166185,25
7913,115,8063,166185,166300,46
8340,274,8064,166299,166573,4
1014,212,8064,166573,166785,23
7149,104,8064,166785,166889,46
2063,98,8065,166888,166986,13
4858,138,8065,166986,167124,19
6260,208,8065,167124,167332,49
4363,172,8066,167331,167503,5
6484,25,8066,167503,167528,33
2744,8,8066,167528,167536,46
3312,206,8067,167535,167741,36
9678,273,8067,167741,168014,47
9597,193,8067,168014,168207,48
8575,165,8068,168206,168371,1
2286,92,8068,168371,168463,3
8426,50,8068,168463,168513,3
2777,147,8068,168513,168660,37
3841,5,8068,168660,168665,48
8817,146,8068,168665,168811,50
5654,158,8069,168810,168968,6
1750,296,8069,168968,169264,12
9809,111,8069,169264,169375,21
5926,286,8069,169375,169661,36
9278,286,8069,169661,169947,46
3868,135,8070,169946,170081,2
9256,201,8070,170081,170282,14
3632,69,8070,170282,170351,21
1290,49,8070,170351,170400,27
1053,88,8070,170400,170488,28
2738,267,8071,170487,170754,34
9129,37,8071,170754,170791,43
9381,223,8072,170790,171013,19
8578,228,8072,171013,171241,28
8762,39,8072,171241,171280,34
7840,1,8073,171279,171280,6
5471,190,8073,171280,171470,13
3609,46,8073,171470,171516,15
8767,96,8073,171516,171612,16
9042,143,8073,171612,171755,24
4338,96,8073,171755,171851,27
9153,177,8073,171851,172028,35
3938,64,8074,172027,172091,1
4364,30,8074,172091,172121,4
4037,217,8074,172121,172338,11
4786,78,8074,172338,172416,21
5037,41,8074,172416,172457,28
4554,232,8074,172457,172689,31
9877,2,8074,172689,172691,45
1121,6,8074,172691,172697,48
7487,204,8074,172697,172901,49
8884,5,8075,172900,172905,24
3257,54,8075,172905,172959,30
3956,58,8075,172959,173017,50
1241,18,8076,173016,173034,3
4367,87,8076,173034,173121,13
8106,257,8076,173121,173378,13
8024,156,8076,173378,173534,25
8148,137,8076,173534,173671,40
7614,69,8077,173670,173739,8
4147,226,8077,173739,173965,16
1643,199,8077,173965,174164,31
9635,30,8077,174164,174194,33
4841,105,8078,174193,174298,13
3245,159,8078,174298,174457,28
2917,285,8078,174457,174742,35
4410,154,8079,174741,174895,29
5614,189,8079,174895,175084,50
3917,28,8080,175083,175111,18
4603,115,8080,175111,175226,22
2008,32,8080,175226,175258,24
5802,283,8080,175258,175541,26
2086,156,8080,175541,175697,41
9656,148,8080,175697,175845,44
2863,211,8080,175845,176056,49
4747,27,8081,176055,176082,20
3226,75,8081,176082,176157,32
7467,55,8081,176157,176212,34
9746,18,8081,176212,176230,35
2000,159,8081,176230,176389,38
8509,159,8081,176389,176548,44
5706,54,8082,176547,176601,8
8076,6,8082,176601,176607,8
4274,236,8082,176607,176843,12
6187,148,8082,176843,176991,16
3118,244,8082,176991,177235,18
3804,264,8082,177235,177499,19
6199,241,8082,177499,177740,38
1994,18,8083,177739,177757,21
6076,265,8083,177757,178022,24
1744,164,8083,178022,178186,29
3483,292,8083,1452940,1453232,29
5569,251,8083,178326,178577,42
1991,145,8084,178576,178721,13
9429,6,8084,178721,178727,19
4220,72,8084,178727,178799,27
5211,300,8084,1453091,1453391,29
4576,15,8084,178939,178954,32
2021,284,8084,178954,179238,38
3318,235,8085,179237,179472,2
9079,5,8085,179472,179477,29
5863,242,8085,179477,179719,34
9641,81,8085,179719,179800,38
8133,106,8085,179800,179906,45
9617,147,8086,179905,180052,1
3701,95,8086,180052,180147,3
2786,9,8086,180147,180156,8
2404,265,8086,180156,180421,13
5966,241,8086,180421,180662,15
5286,63,8086,180662,180725,18
9563,29,8086,180725,180754,30
4682,17,8086,180754,180771,39
3420,273,8086,180771,181044,50
9928,83,8087,181043,181126,1
8961,73,8087,181126,181199,9
2930,228,8087,181199,181427,24
8824,12,8087,181427,181439,40
8996,142,8087,181439,181581,40
6868,94,8088,181580,181674,4
1302,88,8088,181674,181762,12
2772,68,8088,181762,181830,50
4988,274,8089,181829,182103,5
8117,243,8089,182103,182346,20
3464,62,8089,182346,182408,40
2758,295,8090,182407,182702,21
6801,253,8091,182701,182954,13
2319,47,8091,182954,183001,28
7490,106,8091,183001,183107,37
3595,132,8091,183107,183239,46
7595,201,8092,183238,183439,7
1589,31,8092,183439,183470,33
6438,241,8093,183469,183710,4
8586,45,8093,183710,183755,14
2862,38,8093,183755,183793,15
4213,93,8093,183793,183886,19
8537,42,8093,183886,183928,27
5299,100,8093,183928,184028,28
3225,105,8093,184028,184133,37
8986,58,8093,184133,184191,41
2235,76,8093,184191,184267,48
7694,171,8094,184266,184437,6
5034,77,8094,184437,184514,16
9066,250,8094,184514,184764,20
5161,66,8094,184764,184830,42
4167,91,8094,184830,184921,43
7696,235,8095,184920,185155,13
7836,153,8095,185155,185308,23
2545,13,8095,185308,185321,27
3876,32,8096,185320,185352,7
2514,192,8096,185352,185544,30
7299,30,8096,185544,185574,36
5991,85,8096,185574,185659,39
5510,23,8097,185658,185681,39
4689,266,8098,185680,185946,26
4008,134,8098,185946,186080,36
6783,81,8098,186080,186161,38
5009,85,8098,186161,186246,43
9022,227,8098,186246,186473,45
6709,248,8099,186472,186720,16
5155,300,8099,186720,187020,27
2548,235,8099,187020,187255,48
4478,174,8100,187254,187428,2
9560,152,8100,187428,187580,41
1339,56,8100,187580,187636,42
2068,240,8101,187635,187875,1
3424,138,8101,187875,188013,10
3460,123,8101,188013,188136,28
7664,268,8101,188136,188404,30
9392,268,8101,188404,188672,31
3327,24,8101,188672,188696,43
5081,125,8102,188695,188820,8
7027,4,8102,188820,188824,8
8980,70,8102,188824,188894,22
1394,43,8102,188894,188937,24
9407,175,8103,188936,189111,16
5750,42,8103,189111,189153,18
6549,241,8103,189153,189394,22
4797,215,8103,189394,189609,30
7935,165,8103,189609,189774,31
2709,81,8103,189774,189855,32
3179,292,8103,189855,190147,49
3575,248,8104,190146,190394,3
7744,136,8104,190394,190530,4
4756,230,8104,190530,190760,10
5453,39,8104,190760,190799,19
1118,141,8104,190799,190940,22
6548,66,8105,190939,191005,1
6286,278,8105,1453235,1453513,22
4828,120,8105,191140,191260,25
7068,11,8105,191260,191271,44
7590,281,8105,191271,191552,48
7902,57,8106,191551,191608,13
9399,175,8106,191608,191783,34
3790,270,8106,191783,192053,38
2730,139,8107,192052,192191,6
9313,113,8107,192191,192304,15
4667,187,8107,192304,192491,29
3536,97,8107,192491,192588,40
2905,185,8108,192587,192772,6
8035,127,8108,192772,192899,9
6819,181,8108,192899,193080,28
5740,139,8109,193079,193218,6
8362,208,8109,193218,193426,6
6381,82,8109,193426,193508,14
3321,72,8109,193508,193580,47
1893,143,8109,193580,193723,50
5317,121,8110,193722,193843,7
7652,79,8110,193843,193922,16
2816,45,8110,193922,193967,22
2120,48,8110,193967,194015,23
6406,216,8110,194015,194231,35
9819,18,8110,194231,194249,45
9443,199,8110,194249,194448,50
9565,3,8111,194447,194450,1
8390,129,8111,194450,194579,18
1692,250,8111,194579,194829,25
7147,229,8111,194829,195058,49
6772,231,8112,195057,195288,1
3903,186,8112,195288,195474,34
2601,144,8112,195474,195618,37
1706,187,8112,195618,195805,39
6024,218,8114,195803,196021,11
8864,81,8114,196021,196102,23
6495,88,8115,196101,196189,13
4394,91,8115,196189,196280,25
7391,93,8115,196280,196373,26
1035,101,8115,196373,196474,27
2520,84,8115,196474,196558,41
4202,190,8116,196557,196747,4
4830,111,8116,196747,196858,27
9791,245,8116,196858,197103,36
2607,172,8116,197103,197275,39
4017,7,8116,197275,197282,43
9974,70,8117,197281,197351,13
3537,131,8117,197351,197482,32
6529,212,8117,197482,197694,49
2928,225,8118,197693,197918,4
2369,10,8118,197918,197928,7
6627,243,8118,197928,198171,10
5793,82,8118,198171,198253,22
4812,4,8118,198253,198257,25
9120,60,8118,198257,198317,28
4842,51,8119,198316,198367,9
9214,95,8119,198367,198462,20
8625,295,8119,198462,198757,27
5722,202,8119,198757,198959,31
8925,18,8120,198958,198976,15
3877,255,8120,198976,199231,21
7831,240,8120,199231,199471,30
7710,289,8122,199469,199758,16
1139,290,8122,199758,200048,18
2352,275,8122,200048,200323,41
6205,196,8122,200323,200519,43
2260,259,8122,200519,200778,50
5496,290,8123,200777,201067,10
1708,121,8123,201067,201188,22
9931,231,8123,201188,201419,42
5890,251,8124,201418,201669,6
4624,183,8124,201669,201852,17
8696,32,8124,201852,201884,18
8711,160,8124,201884,202044,22
6967,52,8124,202044,202096,24
1092,17,8124,202096,202113,34
8776,227,8124,202113,202340,34
7059,29,8125,202339,202368,5
4765,114,8125,202368,202482,23
5375,194,8125,202482,202676,23
7410,234,8125,202676,202910,29
2103,39,8125,202910,202949,37
3069,290,8125,1453350,1453640,46
2358,132,8125,203092,203224,47
1512,264,8125,203224,203488,48
9750,157,8126,203487,203644,7
8309,257,8126,203644,203901,44
1686,35,8127,203900,203935,10
8724,71,8127,203935,204006,18
3835,111,8127,204006,204117,19
3939,117,8127,204117,204234,20
8808,155,8127,204234,204389,31
5423,76,8127,204389,204465,32
5228,255,8127,204465,204720,46
2926,93,8128,204719,204812,2
2677,221,8128,204812,205033,17
2517,157,8128,205033,205190,19
5073,294,8128,205190,205484,21
4322,8,8128,205484,205492,48
4207,254,8129,205491,205745,46
2018,113,8130,205744,205857,1
3952,169,8130,205857,206026,12
2624,68,8130,206026,206094,14
7464,101,8131,206093,206194,11
1083,241,8131,206194,206435,22
9883,190,8131,206435,206625,34
1213,15,8132,206624,206639,7
9576,169,8132,206639,206808,17
9820,126,8132,206808,206934,37
6109,67,8133,206933,207000,8
2083,206,8133,207000,207206,10
1426,238,8133,207206,207444,11
9575,2,8133,207444,207446,15
8982,76,8133,207446,207522,23
4059,283,8133,207522,207805,32
5988,97,8133,207805,207902,41
4659,116,8134,207901,208017,7
1489,220,8134,208017,208237,16
8469,52,8134,208237,208289,17
5646,166,8134,208289,208455,33
6361,237,8134,208455,208692,48
6468,200,8135,208691,208891,1
7418,83,8135,208891,208974,8
4188,25,8135,208974,208999,22
4942,65,8135,208999,209064,25
5996,59,8135,209064,209123,25
4277,283,8135,209123,209406,28
9892,151,8135,209406,209557,30
7262,128,8135,209557,209685,34
2978,117,8135,209685,209802,36
1061,244,8136,209801,210045,22
5197,86,8136,210045,210131,28
9074,163,8136,210131,210294,38
5576,202,8137,210293,210495,23
6547,298,8137,210495,210793,36
5993,277,8138,210792,211069,34
9863,290,8138,211069,211359,48
2887,153,8139,211358,211511,1
4261,163,8139,211511,211674,8
9288,130,8139,211674,211804,21
8855,227,8139,211804,212031,26
9719,83,8139,212031,212114,27
6341,183,8140,212113,212296,21
8487,111,8140,212296,212407,22
3957,21,8140,212407,212428,34
9187,223,8140,212428,212651,37
9909,177,8141,212650,212827,6
8422,167,8141,212827,212994,14
9844,21,8141,212994,213015,17
6010,178,8141,213015,213193,38
2810,98,8142,213192,213290,16
2858,198,8142,213290,213488,21
6778,77,8142,213488,213565,26
6793,159,8143,213564,213723,23
1130,159,8143,213723,213882,26
3314,146,8143,213882,214028,31
6919,254,8143,214028,214282,32
1783,300,8143,214282,214582,36
6317,208,8143,214582,214790,40
7414,142,8143,214790,214932,46
9769,225,8144,214931,215156,12
1420,69,8144,215156,215225,13
1675,279,8144,215225,215504,30
3083,105,8145,215503,215608,9
4348,209,8145,215608,215817,14
1816,7,8145,215817,215824,16
7412,31,8146,215823,215854,30
6561,173,8146,215854,216027,41
4719,209,8147,216026,216235,21
7900,298,8147,1453474,1453772,25
1679,125,8147,216379,216504,28
3627,226,8147,216504,216730,30
8472,10,8147,216730,216740,37
6840,143,8147,216740,216883,41
5439,267,8147,216883,217150,49
2972,31,8147,217150,217181,50
9830,179,8148,217180,217359,13
6064,225,8148,217359,217584,38
6504,182,8148,217584,217766,44
9600,19,8149,217765,217784,9
4597,78,8149,217784,217862,37
7154,180,8150,217861,218041,4
2727,127,8150,218041,218168,5
8097,11,8150,218168,218179,5
4479,291,8150,1453625,1453916,25
9061,222,8150,218323,218545,25
2666,219,8150,218545,218764,31
2585,120,8150,218764,218884,41
4313,181,8151,218883,219064,5
6921,270,8151,219064,219334,8
9759,162,8151,219334,219496,12
1252,265,8151,219496,219761,15
4910,221,8151,219761,219982,20
4945,78,8151,219982,220060,31
3762,17,8151,220060,220077,40
5465,44,8152,220076,220120,7
6991,221,8152,220120,220341,34
2370,259,8152,220341,220600,39
5803,221,8153,220599,220820,14
8512,253,8153,220820,221073,16
8319,89,8153,221073,221162,45
6150,250,8153,221162,221412,47
9194,281,8154,221411,221692,11
5269,84,8154,221692,221776,39
5157,51,8155,221775,221826,1
2320,113,8155,221826,221939,7
6073,256,8155,221939,222195,16
3990,257,8155,222195,222452,18
1473,169,8155,222452,222621,20
2337,53,8155,222621,222674,20
7146,56,8155,222674,222730,21
6117,130,8155,222730,222860,24
8075,102,8156,222859,222961,3
5703,233,8156,222961,223194,43
1264,197,8156,223194,223391,44
1158,287,8156,223391,223678,50
7417,193,8157,223677,223870,1
7360,54,8157,223870,223924,6
6462,15,8157,223924,223939,15
7383,296,8157,223939,224235,40
2923,234,8157,224235,224469,41
5236,57,8157,224469,224526,46
8555,290,8157,1453766,1454056,46
5519,235,8158,224668,224903,6
1742,160,8158,224903,225063,26
7686,204,8158,225063,225267,27
2802,87,8158,225267,225354,29
1078,25,8159,225353,225378,22
8093,215,8159,225378,225593,24
5953,24,8159,225593,225617,48
6422,250,8160,225616,225866,6
5362,61,8160,225866,225927,12
4729,272,8160,225927,226199,29
3614,18,8160,226199,226217,46
9038,231,8161,226216,226447,2
2880,124,8161,226447,226571,10
5940,46,8161,226571,226617,29
3660,72,8161,226617,226689,32
9720,251,8162,226688,226939,1
3227,242,8162,226939,227181,3
6434,238,8162,227181,227419,3
5138,281,8162,227419,227700,5
8055,229,8162,227700,227929,5
2014,35,8162,227929,227964,8
7429,71,8162,227964,228035,45
8759,77,8162,228035,228112,48
9058,295,8163,1453917,1454212,19
1622,166,8163,228244,228410,25
9474,30,8163,228410,228440,42
6259,37,8164,228439,228476,16
1432,117,8164,228476,228593,34
8497,257,8165,228592,228849,1
2424,142,8165,228849,228991,18
3973,74,8165,228991,229065,43
9577,170,8166,229064,229234,14
9505,19,8166,229234,229253,30
8727,76,8166,229253,229329,31
8905,28,8166,229329,229357,32
8314,95,8167,229356,229451,8
1703,138,8167,229451,229589,10
7756,117,8167,229589,229706,12
8621,147,8167,229706,229853,19
8304,161,8167,229853,230014,32
8960,286,8167,230014,230300,40
3846,224,8168,230299,230523,7
3428,93,8168,230523,230616,34
9502,179,8168,230616,230795,42
5854,231,8168,230795,231026,50
2619,25,8169,231025,231050,3
8180,283,8169,231050,231333,5
3230,142,8169,231333,231475,9
7372,20,8169,231475,231495,15
2787,166,8169,231495,231661,42
1649,257,8170,231660,231917,20
6645,72,8170,231917,231989,28
5457,300,8170,231989,232289,45
4646,203,8170,232289,232492,46
7293,19,8170,232492,232511,46
8267,267,8171,232510,232777,17
8750,56,8171,232777,232833,31
7280,285,8172,232832,233117,14
3122,10,8172,233117,233127,36
4073,101,8172,233127,233228,47
4165,178,8172,233228,233406,48
5333,213,8172,233406,233619,49
6744,254,8173,233618,233872,29
2833,90,8173,233872,233962,35
2035,74,8173,233962,234036,45
8821,287,8174,234035,234322,23
1577,280,8174,234322,234602,36
4336,170,8174,234602,234772,45
1168,213,8174,234772,234985,49
5296,254,8175,234984,235238,3
4879,149,8175,235238,235387,7
9096,34,8175,235387,235421,29
7988,215,8175,235421,235636,30
8170,295,8176,1454053,1454348,18
9726,88,8177,235780,235868,10
9701,130,8177,235868,235998,40
4219,280,8178,235997,236277,24
5795,83,8178,236277,236360,24
9535,3,8178,236360,236363,44
5689,61,8179,236362,236423,2
2703,1,8180,236422,236423,9
1124,127,8180,236423,236550,11
2359,230,8180,236550,236780,16
4999,217,8180,236780,236997,22
4833,39,8180,236997,237036,26
8631,222,8180,237036,237258,36
8205,268,8180,237258,237526,37
1889,154,8180,237526,237680,49
6616,234,8181,237679,237913,1
8863,62,8181,237913,237975,1
4475,136,8181,237975,238111,3
5732,177,8181,238111,238288,6
7919,80,8181,238288,238368,15
2999,32,8181,238368,238400,29
8393,97,8181,238400,238497,39
6562,222,8181,238497,238719,44
7300,233,8182,238718,238951,36
5251,183,8182,238951,239134,38
8990,292,8182,239134,239426,39
9138,158,8182,239426,239584,42
7914,71,8183,239583,239654,13
3709,257,8183,239654,239911,14
4021,62,8183,239911,239973,15
5173,232,8183,239973,240205,17
5408,259,8183,240205,240464,35
7475,127,8183,240464,240591,42
9677,196,8183,240591,240787,46
3788,202,8184,240786,240988,4
1630,176,8184,240988,241164,21
4835,75,8184,241164,241239,25
8779,130,8184,241239,241369,26
2733,92,8184,241369,241461,50
6603,62,8185,241460,241522,12
8294,107,8185,241522,241629,19
7776,12,8185,241629,241641,40
4091,115,8185,241641,241756,47
4339,125,8186,241755,241880,1
6161,279,8186,241880,242159,17
8922,40,8186,242159,242199,26
8019,12,8186,242199,242211,34
6492,19,8186,242211,242230,37
6222,177,8187,242229,242406,11
7582,190,8187,242406,242596,11
9802,148,8187,242596,242744,21
5643,210,8187,242744,242954,40
5905,42,8188,242953,242995,6
3412,131,8188,242995,243126,13
8323,123,8188,243126,243249,23
7351,182,8188,243249,243431,42
3027,178,8188,243431,243609,43
7012,90,8189,243608,243698,10
9622,271,8189,243698,243969,25
2298,61,8189,243969,244030,29
2131,117,8189,244030,244147,32
8938,4,8189,244147,244151,42
3498,154,8190,244150,244304,9
8418,129,8190,244304,244433,17
6837,92,8190,244433,244525,22
1896,86,8190,244525,244611,29
6141,83,8190,244611,244694,42
8331,297,8190,244694,244991,45
7742,45,8191,244990,245035,5
5513,44,8191,245035,245079,20
4160,137,8191,245079,245216,22
4744,82,8191,245216,245298,28
5045,107,8191,245298,245405,41
7938,142,8191,245405,245547,48
6885,215,8192,245546,245761,5
7103,246,8192,245761,246007,5
9414,133,8192,246007,246140,20
6795,19,8192,246140,246159,40
9190,277,8193,246158,246435,2
6037,85,8193,246435,246520,9
7450,214,8193,246520,246734,20
6217,115,8194,246733,246848,1
4025,25,8194,246848,246873,4
4876,2,8194,246873,246875,4
6739,109,8194,246875,246984,11
8542,200,8195,246983,247183,4
7198,11,8195,247183,247194,26
5555,122,8195,247194,247316,40
9203,224,8195,247316,247540,42
4809,266,8195,247540,247806,44
8200,178,8196,247805,247983,5
7556,55,8196,247983,248038,12
6387,112,8196,248038,248150,29
2036,296,8196,248150,248446,37
9133,31,8196,248446,248477,45
9691,227,8196,248477,248704,48
1941,207,8196,248704,248911,49
7973,26,8196,248911,248937,50
1144,68,8197,248936,249004,24
2147,257,8197,249004,249261,43
4788,168,8197,249261,249429,50
1451,205,8198,249428,249633,7
3870,27,8198,249633,249660,19
8399,58,8198,249660,249718,20
7347,209,8199,249717,249926,12
2213,260,8199,249926,250186,30
4960,216,8199,250186,250402,40
4637,22,8199,250402,250424,43
8184,282,8200,250423,250705,3
3753,282,8200,250705,250987,9
5191,186,8200,250987,251173,10
7275,190,8200,251173,251363,10
3216,291,8200,251363,251654,20
3765,142,8200,251654,251796,23
9020,258,8200,251796,252054,31
4509,163,8200,252054,252217,44
3594,248,8201,252216,252464,10
2440,156,8201,252464,252620,24
3487,284,8201,252620,252904,30
7631,67,8201,252904,252971,32
6949,108,8202,252970,253078,7
7676,71,8202,253078,253149,18
4476,101,8202,253149,253250,35
6198,286,8202,253250,253536,40
2527,203,8203,253535,253738,1
6044,58,8203,253738,253796,1
9685,165,8203,253796,253961,17
3390,7,8203,253961,253968,32
7060,171,8203,253968,254139,37
7064,298,8203,254139,254437,38
6533,164,8203,254437,254601,45
7848,8,8203,254601,254609,50
8917,69,8204,254608,254677,1
2044,71,8204,254677,254748,11
3347,10,8204,254748,254758,24
5178,136,8204,254758,254894,27
1733,61,8204,254894,254955,28
7896,71,8204,254955,255026,37
8370,281,8204,255026,255307,39
2985,137,8204,255307,255444,48
1365,141,8204,255444,255585,49
7388,242,8205,255584,255826,19
8386,209,8205,255826,256035,21
8589,77,8205,256035,256112,29
8739,283,8206,256111,256394,12
8181,236,8206,256394,256630,15
2697,279,8206,256630,256909,37
3698,174,8206,256909,257083,37
8401,78,8207,257082,257160,1
5237,78,8207,257160,257238,3
2660,116,8207,257238,257354,45
6543,77,8207,257354,257431,48
6648,4,8208,257430,257434,25
1017,239,8208,257434,257673,27
9277,52,8208,257673,257725,40
4572,186,8208,257725,257911,44
5270,166,8209,257910,258076,2
8014,94,8209,258076,258170,4
3280,152,8209,258170,258322,15
4801,234,8209,258322,258556,16
4772,156,8209,258556,258712,23
8197,146,8209,258712,258858,41
8221,43,8209,258858,258901,45
7252,78,8210,258900,258978,6
1665,189,8210,258978,259167,8
5150,174,8210,259167,259341,31
9121,43,8210,259341,259384,31
7800,290,8210,259384,259674,35
3986,238,8210,259674,259912,41
3249,241,8211,259911,260152,10
8088,203,8211,260152,260355,22
5514,282,8211,260355,260637,26
9979,47,8211,260637,260684,33
6454,198,8211,260684,260882,42
8476,54,8211,260882,260936,44
3843,279,8212,260935,261214,25
1830,228,8212,261214,261442,27
8667,251,8212,261442,261693,35
2170,29,8212,261693,261722,37
5867,72,8212,261722,261794,41
2953,163,8212,261794,261957,46
5682,152,8213,261956,262108,2
8953,273,8213,262108,262381,20
6997,76,8213,262381,262457,22
7370,114,8213,262457,262571,31
5473,159,8213,262571,262730,33
9782,19,8213,262730,262749,34
2205,242,8213,262749,262991,40
1988,135,8213,262991,263126,42
2951,87,8213,263126,263213,46
3646,48,8214,263212,263260,15
3159,299,8214,1454167,1454466,24
4736,268,8214,263403,263671,24
8935,3,8215,263670,263673,38
9188,98,8215,263673,263771,42
7851,57,8216,263770,263827,16
1614,142,8216,263827,263969,20
6078,144,8216,263969,264113,24
2456,297,8216,264113,264410,34
7307,118,8216,264410,264528,39
7585,235,8216,264528,264763,44
8687,141,8216,264763,264904,49
4197,81,8217,264903,264984,4
1762,263,8217,264984,265247,9
7572,150,8217,265247,265397,24
9426,223,8217,265397,265620,32
2037,116,8217,265620,265736,35
6390,73,8217,265736,265809,49
2343,195,8218,265808,266003,3
9977,263,8218,266003,266266,3
4099,84,8219,266265,266349,14
6927,278,8219,266349,266627,18
2800,74,8219,266627,266701,24
3146,293,8219,266701,266994,36
6520,235,8219,266994,267229,42
4243,73,8220,267228,267301,4
6169,272,8220,267301,267573,17
8007,251,8220,267573,267824,29
6953,4,8220,267824,267828,49
9651,286,8220,267828,268114,49
2655,209,8221,268113,268322,8
4177,63,8221,268322,268385,20
6571,10,8221,268385,268395,23
1515,231,8221,268395,268626,29
9878,289,8221,1454316,1454605,46
7317,148,8222,268768,268916,36
2946,172,8222,268916,269088,49
1780,102,8222,269088,269190,50
1992,40,8223,269189,269229,2
9347,166,8223,269229,269395,20
1154,239,8223,269395,269634,21
3291,103,8223,269634,269737,25
2795,219,8223,269737,269956,33
3591,195,8223,269956,270151,37
6420,52,8223,270151,270203,38
6581,126,8223,270203,270329,39
9696,16,8223,270329,270345,43
7814,229,8224,270344,270573,48
8563,103,8225,270572,270675,20
4832,54,8225,270675,270729,38
8438,34,8226,270728,270762,12
4940,182,8226,270762,270944,14
3621,149,8226,270944,271093,19
9978,7,8226,271093,271100,21
3494,236,8226,271100,271336,24
9821,94,8226,271336,271430,32
5727,163,8226,271430,271593,33
2105,195,8226,271593,271788,43
9562,125,8226,271788,271913,50
4883,118,8227,271912,272030,1
6944,149,8227,272030,272179,23
7602,95,8227,272179,272274,30
4331,33,8228,272273,272306,9
6760,36,8228,272306,272342,22
4468,285,8228,272342,272627,35
4884,93,8228,272627,272720,44
2047,184,8228,272720,272904,48
9528,96,8229,272903,272999,23
7628,38,8229,272999,273037,37
5621,288,8229,273037,273325,43
2070,38,8230,273324,273362,3
7599,282,8230,273362,273644,12
4155,188,8230,273644,273832,16
7007,10,8230,273832,273842,24
5106,48,8230,273842,273890,26
1300,32,8230,273890,273922,37
1204,149,8230,273922,274071,45
1190,177,8231,274070,274247,48
5310,218,8232,274246,274464,16
6780,88,8232,274464,274552,16
6047,99,8233,274551,274650,5
3440,153,8233,274650,274803,12
5865,288,8233,1454450,1454738,28
5425,2,8233,274946,274948,39
6691,173,8234,274947,275120,45
7934,58,8235,275119,275177,5
4359,239,8235,275177,275416,7
3222,79,8235,275416,275495,31
6770,278,8235,275495,275773,37
5535,118,8236,275772,275890,16
2739,138,8236,275890,276028,22
3767,76,8237,276027,276103,6
3485,58,8237,276103,276161,16
7438,59,8237,276161,276220,18
4431,218,8237,276220,276438,29
9176,276,8237,276438,276714,30
4725,220,8237,276714,276934,49
5103,17,8238,276933,276950,22
4865,4,8238,276950,276954,28
1897,207,8238,276954,277161,44
1700,85,8239,277160,277245,6
6952,234,8239,277245,277479,8
1367,193,8239,277479,277672,31
1902,149,8239,277672,277821,34
2553,84,8239,277821,277905,34
4762,256,8239,277905,278161,41
6690,17,8240,278160,278177,28
5607,235,8240,278177,278412,43
4116,225,8240,278412,278637,45
8841,120,8241,278636,278756,6
2615,42,8241,278756,278798,13
2679,235,8241,278798,279033,27
1612,23,8241,279033,279056,48
2476,84,8242,279055,279139,4
8061,73,8242,279139,279212,30
6280,217,8243,279211,279428,1
9280,144,8243,279428,279572,4
7727,292,8243,1454587,1454879,9
7331,25,8243,279713,279738,19
3197,238,8243,279738,279976,26
4754,5,8243,279976,279981,27
2513,126,8243,279981,280107,30
3319,231,8243,280107,280338,31
1766,122,8243,280338,280460,33
8349,26,8244,280459,280485,17
1062,4,8244,280485,280489,29
5927,6,8244,280489,280495,35
6861,227,8244,280495,280722,37
8158,232,8244,280722,280954,38
3148,84,8244,280954,281038,39
2760,185,8245,281037,281222,9
2540,58,8245,281222,281280,17
4813,196,8245,281280,281476,17
6776,215,8245,281476,281691,34
5447,145,8246,281690,281835,9
4123,198,8246,281835,282033,23
8478,126,8246,282033,282159,26
3577,146,8246,282159,282305,38
8670,100,8247,282304,282404,8
9631,71,8247,282404,282475,8
9742,189,8247,282475,282664,49
2445,46,8248,282663,282709,16
3397,266,8248,282709,282975,16
3305,57,8248,282975,283032,19
5636,17,8248,283032,283049,19
5741,71,8248,283049,283120,34
4854,187,8248,283120,283307,48
8021,200,8249,283306,283506,21
5635,9,8249,283506,283515,30
5914,98,8249,283515,283613,34
8045,98,8250,283612,283710,12
9612,153,8250,283710,283863,14
7719,115,8250,283863,283978,16
7001,250,8250,283978,284228,22
9664,212,8250,284228,284440,23
2595,264,8250,284440,284704,28
7476,219,8250,284704,284923,32
6446,290,8250,284923,285213,50
9984,177,8251,285212,285389,9
3437,142,8251,285389,285531,32
1735,78,8251,285531,285609,34
2212,299,8251,285609,285908,39
4484,289,8251,285908,286197,40
2547,144,8251,286197,286341,48
4409,143,8251,286341,286484,48
4570,135,8252,286483,286618,35
7387,240,8253,286617,286857,17
4916,156,8253,286857,287013,22
2575,235,8253,287013,287248,27
6285,295,8253,1454729,1455024,29
1496,214,8253,287388,287602,31
6595,294,8253,287602,287896,40
8434,102,8253,287896,287998,47
8494,82,8254,287997,288079,1
4378,209,8254,288079,288288,15
9614,187,8254,288288,288475,16
1342,153,8254,288475,288628,19
1775,31,8254,288628,288659,25
3416,190,8254,288659,288849,25
6231,90,8254,288849,288939,30
4097,3,8254,288939,288942,34
3549,8,8254,288942,288950,46
7726,198,8255,288949,289147,4
1486,226,8255,289147,289373,8
9663,71,8255,289373,289444,17
8760,9,8255,289444,289453,45
8835,174,8256,289452,289626,20
6136,283,8257,289625,289908,5
9273,42,8257,289908,289950,11
6091,131,8257,289950,290081,20
3866,263,8257,290081,290344,26
7611,234,8257,290344,290578,31
1199,121,8257,290578,290699,40
9786,116,8257,290699,290815,44
6040,79,8258,290814,290893,5
2288,275,8258,290893,291168,6
1164,293,8258,1454875,1455168,15
8654,268,8258,291312,291580,36
7264,293,8258,291580,291873,37
1696,216,8259,291872,292088,2
3715,118,8259,292088,292206,19
5071,243,8259,292206,292449,34
9433,98,8259,292449,292547,47
8271,250,8260,292546,292796,9
3325,128,8260,292796,292924,25
2066,62,8260,292924,292986,28
4722,271,8260,292986,293257,47
9731,286,8261,293256,293542,5
9103,7,8261,293542,293549,15
7868,45,8261,293549,293594,16
1402,176,8261,293594,293770,31
2656,237,8262,293769,294006,7
9242,293,8262,294006,294299,13
4578,30,8262,294299,294329,20
1281,204,8262,294329,294533,27
6937,11,8262,294533,294544,29
4244,221,8262,294544,294765,41
5832,61,8262,294765,294826,45
9890,83,8263,294825,294908,4
4565,241,8263,294908,295149,26
4206,176,8263,295149,295325,46
6810,32,8264,295324,295356,25
5766,290,8264,295356,295646,27
7231,122,8265,295645,295767,2
8957,75,8265,295767,295842,23
2209,283,8265,295842,296125,42
1731,111,8266,296124,296235,6
2283,252,8266,296235,296487,15
7829,42,8266,296487,296529,36
7749,113,8266,296529,296642,50
7536,114,8267,296641,296755,44
8906,126,8268,296754,296880,2
5500,86,8268,296880,296966,4
7570,196,8268,296966,297162,8
6002,80,8268,297162,297242,14
3975,251,8268,297242,297493,17
9363,185,8268,297493,297678,27
4679,215,8268,297678,297893,31
9700,203,8268,297893,298096,43
1519,20,8269,298095,298115,1
5842,171,8269,298115,298286,5
9317,282,8269,298286,298568,5
3370,121,8269,298568,298689,10
7643,228,8269,298689,298917,18
9033,54,8269,298917,298971,30
1714,6,8269,298971,298977,33
1079,27,8269,298977,299004,37
4819,244,8269,299004,299248,44
3111,215,8269,299248,299463,46
8610,195,8270,299462,299657,14
4984,100,8270,299657,299757,40
9949,105,8270,299757,299862,49
5143,96,8271,299861,299957,2
9067,162,8271,299957,300119,8
6472,243,8271,300119,300362,12
6821,272,8271,300362,300634,29
4039,265,8271,300634,300899,31
9456,131,8271,300899,301030,36
1734,269,8271,301030,301299,47
1453,98,8272,301298,301396,3
3665,112,8272,301396,301508,14
9266,171,8272,301508,301679,22
4541,266,8272,301679,301945,31
4730,220,8272,301945,302165,43
7625,28,8272,302165,302193,49
9268,229,8273,302192,302421,1
9013,31,8273,302421,302452,18
7897,36,8273,302452,302488,19
4851,214,8273,302488,302702,35
2673,200,8273,302702,302902,37
3839,233,8274,302901,303134,3
8659,18,8274,303134,303152,19
1234,270,8274,303152,303422,21
1844,240,8274,303422,303662,36
6137,143,8274,303662,303805,44
1542,210,8275,303804,304014,2
9860,22,8275,304014,304036,9
7165,231,8275,304036,304267,22
4365,274,8275,1455016,1455290,33
3844,25,8275,304402,304427,49
4358,119,8276,304426,304545,1
4864,152,8276,304545,304697,11
2754,51,8276,304697,304748,21
1054,177,8276,304748,304925,48
2650,181,8277,304924,305105,15
6552,192,8277,305105,305297,41
3628,247,8278,305296,305543,16
6183,103,8278,305543,305646,27
7245,202,8279,305645,305847,6
8839,141,8279,305847,305988,46
5919,183,8280,305987,306170,9
1286,159,8280,306170,306329,29
2479,126,8280,306329,306455,30
2225,284,8280,306455,306739,41
3768,32,8281,306738,306770,9
1494,75,8281,306770,306845,39
1993,113,8281,306845,306958,47
7013,82,8282,306957,307039,23
4357,140,8282,307039,307179,44
5816,74,8283,307178,307252,4
8172,55,8283,307252,307307,45
8251,39,8284,307306,307345,4
4575,283,8284,307345,307628,5
1501,229,8284,307628,307857,7
2326,150,8284,307857,308007,22
4114,102,8285,308006,308108,7
5778,151,8285,308108,308259,12
6404,260,8285,308259,308519,16
9472,32,8285,308519,308551,18
7809,103,8286,308550,308653,43
5060,51,8286,308653,308704,45
9118,248,8287,308703,308951,5
5544,259,8287,308951,309210,23
9213,30,8287,309210,309240,25
5977,63,8287,309240,309303,30
6909,217,8287,309303,309520,49
9173,68,8288,309519,309587,44
3802,281,8288,309587,309868,47
7019,243,8289,309867,310110,31
9015,23,8290,310109,310132,9
7608,87,8290,310132,310219,10
3909,258,8290,310219,310477,28
4057,266,8290,310477,310743,31
6310,72,8290,310743,310815,40
4579,77,8291,310814,310891,1
6497,126,8291,310891,311017,13
6243,34,8291,311017,311051,14
5364,13,8291,311051,311064,15
5565,9,8291,311064,311073,19
9654,164,8291,311073,311237,20
9360,161,8291,311237,311398,21
1794,91,8291,311398,311489,32
3443,86,8291,311489,311575,32
4894,32,8291,311575,311607,50
3803,93,8292,311606,311699,1
7225,251,8292,311699,311950,2
2977,24,8292,311950,311974,15
7465,282,8292,311974,312256,16
7856,206,8292,312256,312462,18
1488,159,8292,312462,312621,21
3766,53,8292,312621,312674,37
1254,192,8293,312673,312865,7
3284,26,8293,312865,312891,13
9692,18,8293,312891,312909,26
4748,19,8293,312909,312928,34
9144,232,8293,312928,313160,34
4590,178,8293,313160,313338,42
3186,15,8294,313337,313352,1
2781,218,8294,313352,313570,2
8781,108,8294,313570,313678,4
3581,264,8294,313678,313942,11
6144,92,8294,313942,314034,25
3678,185,8295,314033,314218,7
1677,234,8295,314218,314452,15
6333,281,8295,314452,314733,21
3562,155,8295,314733,314888,32
3041,95,8295,314888,314983,37
4136,290,8295,314983,315273,38
8786,132,8295,315273,315405,40
9158,27,8295,315405,315432,46
5512,187,8296,315431,315618,1
8745,262,8296,315618,315880,1
8963,180,8296,315880,316060,4
2088,186,8296,316060,316246,40
8042,21,8296,316246,316267,43
6009,86,8296,316267,316353,44
4324,129,8296,316353,316482,47
8424,75,8296,316482,316557,49
6011,162,8297,316556,316718,44
6693,217,8297,316718,316935,45
4474,280,8298,316934,317214,3
2519,250,8298,317214,317464,18
9182,207,8298,317464,317671,19
7799,127,8298,317671,317798,29
8357,73,8298,317798,317871,29
5451,172,8299,317870,318042,38
5521,180,8300,318041,318221,5
9628,171,8300,318221,318392,38
6184,191,8301,318391,318582,14
8244,78,8301,318582,318660,40
7870,246,8301,318660,318906,44
3661,133,8302,318905,319038,3
4569,93,8302,319038,319131,11
9087,151,8302,319131,319282,42
8579,202,8303,319281,319483,3
6814,180,8303,319483,319663,5
5030,192,8303,319663,319855,11
8360,67,8303,319855,319922,19
4521,178,8303,319922,320100,25
5626,167,8303,320100,320267,38
2631,127,8303,320267,320394,41
2285,179,8304,320393,320572,6
5736,218,8304,320572,320790,12
4707,47,8304,320790,320837,23
3214,65,8304,320837,320902,36
5409,86,8304,320902,320988,38
1425,186,8304,320988,321174,44
8634,242,8304,321174,321416,44
5729,237,8305,321415,321652,6
8680,215,8305,321652,321867,11
2661,284,8305,321867,322151,13
9674,258,8305,322151,322409,34
3599,211,8306,322408,322619,4
1705,35,8306,322619,322654,10
3007,98,8306,322654,322752,12
4871,289,8306,322752,323041,27
6589,22,8306,323041,323063,36
2742,69,8306,323063,323132,42
1259,44,8308,323130,323174,2
9997,176,8308,323174,323350,6
3832,258,8308,323350,323608,12
6033,86,8308,323608,323694,26
9374,94,8308,323694,323788,43
7050,294,8308,323788,324082,48
3324,215,8309,324081,324296,5
1400,35,8309,324296,324331,8
3404,259,8309,324331,324590,36
3193,128,8310,324589,324717,15
8539,32,8310,324717,324749,29
7780,149,8311,324748,324897,1
5594,297,8311,324897,325194,7
7955,181,8311,325194,325375,16
3696,151,8311,325375,325526,25
8211,255,8312,325525,325780,1
3848,16,8312,325780,325796,5
7535,169,8312,325796,325965,5
2366,132,8312,325965,326097,7
8428,250,8312,326097,326347,36
7528,292,8313,326346,326638,1
5517,183,8313,326638,326821,4
8167,220,8313,326821,327041,5
7205,293,8313,327041,327334,20
5819,66,8313,327334,327400,43
1166,132,8313,327400,327532,44
9837,78,8313,327532,327610,45
8105,55,8314,327609,327664,6
8819,111,8314,327664,327775,9
3741,67,8314,327775,327842,36
9918,161,8315,327841,328002,7
1080,226,8316,328001,328227,8
2599,234,8316,328227,328461,11
4956,219,8316,328461,328680,13
2500,126,8316,328680,328806,14
7613,148,8316,328806,328954,27
5501,166,8316,328954,329120,38
6191,124,8316,329120,329244,50
7684,165,8316,329244,329409,50
1720,167,8317,329408,329575,22
4236,257,8318,329574,329831,8
4687,135,8318,329831,329966,12
3415,209,8318,329966,330175,17
2117,138,8318,330175,330313,34
1764,144,8318,330313,330457,38
1939,87,8318,330457,330544,44
5416,282,8319,1455113,1455395,19
8569,148,8319,330676,330824,45
1573,220,8319,330824,331044,47
3025,122,8320,331043,331165,12
2762,17,8320,331165,331182,27
8721,143,8320,331182,331325,42
5797,184,8321,331324,331508,2
8879,55,8321,331508,331563,5
8847,142,8321,331563,331705,7
9921,150,8321,331705,331855,8
6539,251,8321,331855,332106,12
7789,117,8321,332106,332223,20
3985,155,8321,332223,332378,24
5948,227,8321,332378,332605,37
3206,28,8322,332604,332632,45
2452,169,8323,332631,332800,3
6502,294,8323,1455251,1455545,29
4757,251,8323,332940,333191,47
4350,244,8324,333190,333434,6
8543,195,8324,333434,333629,8
3275,200,8324,333629,333829,14
6022,101,8324,333829,333930,25
4126,148,8325,333929,334077,7
3164,29,8325,334077,334106,28
5631,18,8325,334106,334124,31
9075,248,8325,334124,334372,37
5346,217,8325,334372,334589,42
3479,156,8325,334589,334745,46
2717,227,8325,334745,334972,47
5397,40,8325,334972,335012,50
3330,260,8326,335011,335271,13
3363,273,8326,335271,335544,16
6218,154,8326,335544,335698,36
3685,116,8327,335697,335813,9
7223,245,8327,335813,336058,11
9139,126,8327,336058,336184,20
3212,201,8328,336183,336384,13
8942,215,8328,336384,336599,23
6732,72,8328,336599,336671,27
1609,2,8328,336671,336673,35
6344,284,8328,336673,336957,40
8936,181,8328,336957,337138,44
5587,87,8328,337138,337225,49
7291,285,8329,337224,337509,14
8236,153,8329,337509,337662,18
7945,96,8329,337662,337758,46
3935,165,8329,337758,337923,47
2072,244,8329,337923,338167,49
1877,227,8330,338166,338393,15
1422,269,8330,338393,338662,24
3253,241,8330,338662,338903,28
7567,84,8330,338903,338987,29
4615,227,8330,338987,339214,37
1311,13,8331,339213,339226,18
3979,249,8331,339226,339475,19
3329,119,8331,339475,339594,28
7451,241,8331,339594,339835,28
8806,215,8331,339835,340050,30
9910,132,8331,340050,340182,30
2121,253,8331,340182,340435,31
3243,203,8331,340435,340638,38
8208,59,8332,340637,340696,1
7120,272,8332,340696,340968,17
8566,177,8332,340968,341145,32
3564,261,8332,341145,341406,45
2160,231,8333,341405,341636,16
1382,86,8333,341636,341722,26
2889,196,8333,341722,341918,31
3530,203,8335,341916,342119,5
5315,196,8335,342119,342315,27
5314,106,8335,342315,342421,31
8015,44,8335,342421,342465,34
4481,278,8335,342465,342743,48
7078,171,8336,342742,342913,18
8460,206,8336,342913,343119,39
7537,51,8336,343119,343170,45
1807,45,8337,343169,343214,15
5638,248,8337,343214,343462,16
4190,180,8337,343462,343642,27
2597,147,8338,343641,343788,10
8405,239,8338,343788,344027,34
2559,113,8338,344027,344140,37
8306,159,8338,344140,344299,44
1695,289,8339,344298,344587,7
3970,66,8339,344587,344653,19
1323,7,8339,344653,344660,24
1895,5,8339,344660,344665,24
3619,32,8339,344665,344697,27
8907,23,8339,344697,344720,30
7580,125,8340,344719,344844,6
7953,298,8340,344844,345142,35
2588,73,8341,345141,345214,23
5322,248,8342,345213,345461,13
6463,283,8342,345461,345744,48
1347,197,8343,345743,345940,4
7810,211,8343,345940,346151,12
2792,91,8343,346151,346242,13
8991,178,8343,346242,346420,25
9523,94,8343,346420,346514,29
3270,113,8343,346514,346627,32
2034,288,8343,346627,346915,38
8967,111,8343,346915,347026,49
6629,155,8344,347025,347180,1
7190,91,8344,347180,347271,6
5895,154,8344,347271,347425,8
6461,209,8344,347425,347634,15
9010,60,8344,347634,347694,19
6430,291,8344,1455389,1455680,22
1642,159,8344,347829,347988,30
9090,103,8344,347988,348091,34
1066,86,8345,348090,348176,3
5199,75,8345,348176,348251,3
4583,37,8345,348251,348288,5
2927,5,8345,348288,348293,9
8927,170,8345,348293,348463,15
3304,132,8345,348463,348595,19
4441,23,8345,348595,348618,26
1450,251,8345,348618,348869,30
5154,258,8345,348869,349127,30
7642,115,8345,349127,349242,31
6318,284,8345,349242,349526,43
2911,226,8345,349526,349752,49
3232,15,8345,349752,349767,50
4211,102,8345,349767,349869,50
9297,239,8346,349868,350107,6
8599,101,8346,350107,350208,19
7241,207,8347,350207,350414,36
6226,69,8347,350414,350483,50
5355,238,8348,350482,350720,30
7126,184,8348,350720,350904,47
1278,222,8348,350904,351126,50
5470,72,8349,351125,351197,10
4720,275,8349,351197,351472,12
2045,265,8349,351472,351737,31
2932,210,8349,351737,351947,46
6425,300,8350,1455528,1455828,18
1272,235,8350,352092,352327,20
4432,148,8350,352327,352475,28
6855,85,8350,352475,352560,37
8240,253,8350,352560,352813,41
6849,124,8351,352812,352936,7
9983,63,8352,352935,352998,8
2264,184,8352,352998,353182,10
3032,178,8352,353182,353360,19
8947,188,8353,353359,353547,23
2407,44,8353,353547,353591,24
2263,186,8353,353591,353777,36
6159,8,8353,353777,353785,38
4268,168,8354,353784,353952,4
1481,86,8354,353952,354038,12
8755,62,8354,354038,354100,15
3127,151,8354,354100,354251,31
7690,239,8354,354251,354490,33
7653,61,8354,354490,354551,40
7874,9,8354,354551,354560,45
2208,148,8355,354559,354707,8
7505,279,8355,354707,354986,30
7701,132,8355,354986,355118,30
6456,136,8355,355118,355254,42
7560,115,8355,355254,355369,49
7398,3,8356,355368,355371,8
9812,223,8356,355371,355594,18
5678,119,8356,355594,355713,26
1535,57,8356,355713,355770,39
1067,94,8356,355770,355864,40
8874,7,8357,355863,355870,8
4384,102,8357,355870,355972,11
3795,254,8357,355972,356226,13
9603,291,8357,1455677,1455968,32
7523,26,8357,356370,356396,33
5114,93,8357,356396,356489,42
8492,129,8357,356489,356618,45
1621,285,8357,356618,356903,46
8605,225,8357,356903,357128,49
5279,259,8358,357127,357386,18
3746,80,8358,357386,357466,42
5145,282,8359,357465,357747,45
3089,257,8359,357747,358004,46
9167,62,8359,358004,358066,46
5220,201,8359,358066,358267,49
8663,93,8360,358266,358359,5
1918,258,8360,358359,358617,11
2623,8,8360,358617,358625,19
3600,251,8360,358625,358876,44
6883,47,8361,358875,358922,34
1165,52,8362,358921,358973,8
3810,239,8362,358973,359212,16
6127,131,8362,359212,359343,22
1514,119,8362,359343,359462,27
9703,84,8363,359461,359545,18
8416,229,8363,359545,359774,26
1082,38,8363,359774,359812,38
1303,45,8363,359812,359857,39
2437,17,8363,359857,359874,47
4352,213,8364,359873,360086,2
1123,37,8364,360086,360123,9
7152,142,8364,360123,360265,37
8564,135,8365,360264,360399,11
5624,133,8365,360399,360532,15
5294,300,8365,360532,360832,41
1377,46,8366,360831,360877,10
7425,247,8366,360877,361124,16
7209,200,8366,361124,361324,18
7455,67,8366,361324,361391,19
1595,91,8366,361391,361482,35
5897,138,8366,361482,361620,36
9670,161,8367,361619,361780,8
3738,132,8367,361780,361912,20
7737,136,8367,361912,362048,20
2840,134,8367,362048,362182,21
4870,59,8367,362182,362241,32
2119,80,8367,362241,362321,34
9715,236,8367,362321,362557,44
5944,208,8368,362556,362764,5
1667,291,8368,362764,363055,10
9864,102,8368,363055,363157,22
8590,49,8368,363157,363206,42
1872,34,8368,363206,363240,44
2246,232,8368,363240,363472,48
2784,153,8368,363472,363625,49
4633,151,8369,363624,363775,10
2748,170,8369,363775,363945,14
7794,298,8369,1455810,1456108,18
1871,272,8369,364091,364363,29
1025,296,8369,364363,364659,35
3098,39,8369,364659,364698,40
1627,185,8369,364698,364883,49
3830,197,8370,364882,365079,27
1269,62,8370,365079,365141,30
9874,61,8370,365141,365202,46
3631,172,8371,365201,365373,16
9559,280,8372,365372,365652,1
2473,172,8372,365652,365824,21
2640,175,8372,365824,365999,34
2255,285,8373,365998,366283,31
5618,64,8373,366283,366347,48
4742,261,8374,366346,366607,18
6441,42,8374,366607,366649,23
8179,65,8374,366649,366714,26
3473,131,8375,366713,366844,31
6798,179,8375,366844,367023,44
9219,173,8376,367022,367195,4
5523,121,8376,367195,367316,10
9521,82,8376,367316,367398,11
4986,279,8376,1455968,1456247,19
7857,188,8376,367531,367719,23
5233,113,8376,367719,367832,28
9713,113,8376,367832,367945,32
8332,227,8376,367945,368172,42
4502,251,8376,368172,368423,45
5142,75,8377,368422,368497,27
3393,162,8377,368497,368659,33
4241,297,8377,1456111,1456408,33
7421,133,8377,368794,368927,43
1979,173,8379,368925,369098,10
7185,218,8379,369098,369316,23
2670,47,8379,369316,369363,29
7712,282,8380,369362,369644,11
1194,199,8380,369644,369843,43
6122,71,8381,369842,369913,11
2200,276,8382,369912,370188,38
9115,296,8383,370187,370483,3
1803,264,8383,370483,370747,21
1100,202,8383,370747,370949,49
8060,260,8384,370948,371208,10
9441,214,8384,371208,371422,29
1913,210,8385,371421,371631,21
6583,161,8385,371631,371792,25
7350,84,8385,371792,371876,38
3014,146,8386,371875,372021,18
9990,262,8386,372021,372283,21
8183,261,8386,372283,372544,46
6860,174,8387,372543,372717,3
5507,200,8387,372717,372917,21
6435,146,8388,372916,373062,1
5524,214,8388,373062,373276,19
9403,11,8389,373275,373286,9
1387,180,8389,373286,373466,21
6498,294,8389,373466,373760,31
5671,59,8389,373760,373819,45
4946,286,8390,373818,374104,10
6061,213,8390,374104,374317,18
5417,87,8390,374317,374404,38
7623,78,8391,374403,374481,5
9198,227,8391,374481,374708,36
9748,77,8391,374708,374785,36
6676,194,8391,374785,374979,38
2417,132,8392,374978,375110,5
3082,48,8392,375110,375158,5
7647,14,8392,375158,375172,6
1238,51,8392,375172,375223,40
9365,41,8393,375222,375263,3
2546,297,8393,375263,375560,20
3469,86,8393,375560,375646,31
4259,291,8393,375646,375937,41
9911,204,8393,375937,376141,42
7083,167,8393,376141,376308,43
5029,61,8394,376307,376368,24
6572,185,8394,376368,376553,32
1147,152,8394,376553,376705,38
4874,171,8394,376705,376876,39
5065,202,8395,376875,377077,1
3158,281,8395,377077,377358,15
1211,253,8396,377357,377610,4
3288,119,8396,377610,377729,14
1566,95,8396,377729,377824,47
1439,279,8397,377823,378102,30
7924,232,8397,378102,378334,40
6196,87,8397,378334,378421,46
3699,24,8398,378420,378444,1
4982,57,8398,378444,378501,15
7991,237,8398,378501,378738,16
9372,8,8398,378738,378746,25
9438,98,8398,378746,378844,25
2350,38,8398,378844,378882,42
7227,38,8399,378881,378919,18
2698,5,8399,378919,378924,22
5637,259,8399,378924,379183,30
6190,109,8400,379182,379291,2
4671,258,8401,379290,379548,5
7323,10,8401,379548,379558,13
4311,257,8401,379558,379815,21
9055,64,8401,379815,379879,46
3980,59,8401,379879,379938,48
1431,196,8402,379937,380133,1
3822,219,8402,380133,380352,1
7545,208,8402,380352,380560,23
7456,47,8402,380560,380607,31
2222,118,8403,380606,380724,6
4726,153,8403,380724,380877,12
9049,232,8403,380877,381109,21
5320,124,8403,381109,381233,26
6139,276,8404,381232,381508,5
2549,285,8404,381508,381793,27
9410,41,8405,381792,381833,9
4041,293,8405,1456237,1456530,28
7409,28,8405,381976,382004,41
1690,286,8406,382003,382289,32
4170,198,8406,382289,382487,35
5864,269,8406,382487,382756,39
1726,60,8406,382756,382816,49
4267,82,8407,382815,382897,15
3728,244,8407,382897,383141,28
1534,118,8407,383141,383259,37
7519,293,8408,383258,383551,17
9833,79,8408,383551,383630,28
3906,248,8408,383630,383878,29
4695,180,8408,383878,384058,31
9952,228,8408,384058,384286,34
9518,35,8408,384286,384321,39
6568,138,8408,384321,384459,41
7286,64,8409,384458,384522,1
2904,12,8409,384522,384534,3
5858,31,8409,384534,384565,27
2963,58,8410,384564,384622,2
4877,90,8410,384622,384712,6
2109,54,8410,384712,384766,12
5254,235,8410,384766,385001,37
2576,74,8410,385001,385075,42
1441,209,8410,385075,385284,43
7333,60,8410,385284,385344,43
9117,56,8411,385343,385399,12
2071,131,8411,385399,385530,19
6646,73,8411,385530,385603,19
3066,257,8411,385603,385860,26
3117,300,8411,1456384,1456684,29
4014,49,8411,386000,386049,34
7407,74,8412,386048,386122,9
6596,226,8412,386122,386348,11
2482,299,8412,386348,386647,13
8735,66,8412,386647,386713,18
6185,97,8412,386713,386810,22
2007,190,8412,386810,387000,40
3778,160,8412,387000,387160,42
1218,128,8413,387159,387287,18
9933,46,8413,387287,387333,21
1975,211,8413,387333,387544,34
3941,123,8413,387544,387667,46
5232,96,8413,387667,387763,50
8617,92,8414,387762,387854,17
6437,30,8414,387854,387884,30
8611,207,8414,387884,388091,40
2050,99,8414,388091,388190,41
4808,32,8415,388189,388221,3
3959,166,8415,388221,388387,18
4763,30,8415,388387,388417,21
8614,269,8415,388417,388686,34
1788,147,8416,388685,388832,7
1049,235,8416,388832,389067,10
4907,277,8416,389067,389344,38
4024,4,8416,389344,389348,48
1878,176,8416,389348,389524,49
6293,169,8416,389524,389693,50
8445,246,8417,389692,389938,1
4435,188,8417,389938,390126,6
7666,9,8417,390126,390135,32
2335,256,8417,390135,390391,44
6351,280,8418,390390,390670,11
1317,77,8418,390670,390747,31
3912,229,8419,390746,390975,15
2149,93,8419,390975,391068,17
2102,233,8419,391068,391301,22
9283,195,8419,391301,391496,22
8421,280,8419,391496,391776,26
4266,266,8419,391776,392042,37
9062,15,8419,392042,392057,38
9470,158,8419,392057,392215,48
5767,134,8420,392214,392348,8
2638,205,8420,392348,392553,9
3667,156,8420,392553,392709,17
5246,86,8420,392709,392795,38
3506,293,8420,392795,393088,45
6353,114,8421,393087,393201,6
9350,214,8421,393201,393415,21
3132,153,8421,393415,393568,29
8334,7,8421,393568,393575,42
7866,279,8421,393575,393854,45
1868,211,8422,393853,394064,7
5419,112,8422,394064,394176,13
4344,278,8422,1456538,1456816,22
8113,231,8422,394311,394542,31
4520,212,8422,394542,394754,36
4723,288,8423,394753,395041,2
7202,33,8423,395041,395074,33
1344,177,8423,395074,395251,39
1244,185,8423,395251,395436,45
9179,275,8424,395435,395710,10
1409,15,8424,395710,395725,29
9946,240,8424,395725,395965,48
6123,234,8425,395964,396198,5
2015,6,8425,396198,396204,22
8192,57,8425,396204,396261,22
4287,277,8425,396261,396538,25
7301,57,8425,396538,396595,41
1384,83,8425,396595,396678,45
2157,62,8425,396678,396740,49
8860,45,8426,396739,396784,17
6459,19,8426,396784,396803,25
3905,17,8426,396803,396820,40
8657,272,8426,396820,397092,40
7986,35,8426,397092,397127,49
4827,232,8427,397126,397358,4
3629,65,8427,397358,397423,11
9634,155,8427,397423,397578,40
8149,76,8427,397578,397654,44
9959,110,8427,397654,397764,44
2073,237,8428,397763,398000,1
5163,123,8428,398000,398123,19
8514,68,8428,398123,398191,34
4652,157,8428,398191,398348,38
6356,157,8428,398348,398505,40
7504,46,8428,398505,398551,47
2592,96,8429,398550,398646,6
7553,94,8429,398646,398740,16
1295,75,8429,398740,398815,18
3207,160,8430,398814,398974,11
3663,152,8431,398973,399125,11
4149,270,8431,399125,399395,47
7592,144,8432,399394,399538,1
5264,12,8432,399538,399550,24
5456,247,8432,399550,399797,34
4245,80,8433,399796,399876,12
4501,138,8433,399876,400014,24
4278,20,8433,400014,400034,29
2991,1,8433,400034,400035,34
5550,88,8434,400034,400122,26
8830,27,8434,400122,400149,29
1343,66,8434,400149,400215,30
5725,129,8434,400215,400344,30
7294,294,8434,400344,400638,36
6464,143,8434,400638,400781,37
1823,296,8434,400781,401077,44
8799,142,8434,401077,401219,47
1837,109,8435,401218,401327,1
8443,40,8435,401327,401367,22
1449,181,8435,401367,401548,44
6099,281,8436,401547,401828,2
9338,96,8436,401828,401924,9
2024,20,8436,401924,401944,11
6866,44,8436,401944,401988,14
8726,158,8436,401988,402146,30
2974,47,8437,402145,402192,28
4223,167,8437,402192,402359,33
2144,131,8437,402359,402490,43
2896,105,8437,402490,402595,45
8336,193,8438,402594,402787,5
6698,82,8438,402787,402869,9
2918,2,8438,402869,402871,10
1553,205,8438,402871,403076,13
4380,54,8438,403076,403130,14
7477,191,8438,403130,403321,15
8584,228,8438,403321,403549,19
9776,147,8438,403549,403696,26
4292,283,8438,403696,403979,28
4510,268,8438,403979,404247,42
5911,107,8438,404247,404354,49
2061,87,8439,404353,404440,15
7698,77,8439,404440,404517,23
7207,68,8439,404517,404585,27
6734,139,8439,404585,404724,43
3559,255,8439,404724,404979,44
4592,138,8440,404978,405116,6
1022,234,8440,405116,405350,23
1888,40,8440,405350,405390,33
3836,160,8441,405389,405549,34
2950,89,8442,405548,405637,13
2506,257,8442,405637,405894,24
1748,110,8442,405894,406004,44
7778,274,8442,406004,406278,48
7909,112,8442,406278,406390,48
4900,170,8443,406389,406559,34
5605,43,8443,406559,406602,50
5102,70,8444,406601,406671,8
2351,279,8444,1456659,1456938,22
3364,187,8445,406805,406992,40
8503,108,8446,406991,407099,5
9205,22,8446,407099,407121,11
7844,287,8446,407121,407408,17
6836,25,8446,407408,407433,35
5746,119,8446,407433,407552,36
7509,256,8447,407551,407807,5
9025,197,8447,407807,408004,19
2290,44,8447,408004,408048,42
8365,137,8447,408048,408185,48
9855,195,8448,408184,408379,16
7041,19,8448,408379,408398,24
2993,222,8448,408398,408620,38
9084,37,8448,408620,408657,42
3964,148,8448,408657,408805,45
8809,50,8449,408804,408854,6
7336,195,8450,408853,409048,25
9961,145,8450,409048,409193,39
4702,94,8450,409193,409287,41
5597,69,8451,409286,409355,11
7420,283,8451,409355,409638,18
1200,37,8451,409638,409675,22
5180,57,8451,409675,409732,42
7008,60,8451,409732,409792,45
5272,60,8451,409792,409852,48
3508,120,8452,409851,409971,31
6773,160,8452,409971,410131,36
9688,201,8452,410131,410332,38
2416,4,8452,410332,410336,42
4492,181,8453,410335,410516,2
2776,242,8453,410516,410758,11
4443,259,8453,410758,411017,36
8437,246,8454,411016,411262,16
9554,52,8454,411262,411314,18
3553,157,8454,411314,411471,20
5415,118,8454,411471,411589,26
6481,218,8454,411589,411807,31
7841,103,8454,411807,411910,43
6072,280,8454,411910,412190,48
2114,167,8455,412189,412356,6
2357,260,8455,412356,412616,6
7136,57,8455,412616,412673,10
8482,296,8455,412673,412969,14
1569,280,8455,412969,413249,30
5592,205,8455,413249,413454,41
1531,52,8455,413454,413506,47
3116,280,8456,413505,413785,11
4878,230,8456,413785,414015,14
2025,99,8456,414015,414114,35
4077,144,8457,414113,414257,7
6112,165,8457,414257,414422,41
3971,1,8458,414421,414422,9
5668,179,8458,414422,414601,9
3849,173,8458,414601,414774,33
7959,73,8458,414774,414847,37
1492,149,8459,414846,414995,21
7586,122,8459,414995,415117,27
6442,297,8459,415117,415414,31
8513,273,8459,1456788,1457061,33
3797,137,8459,415549,415686,35
6825,187,8459,415686,415873,42
2306,102,8460,415872,415974,2
6034,128,8460,415974,416102,6
6636,22,8460,416102,416124,18
3233,203,8460,416124,416327,22
3855,10,8460,416327,416337,28
3574,52,8460,416337,416389,32
5735,112,8460,416389,416501,34
6887,102,8460,416501,416603,46
5303,198,8460,416603,416801,49
2874,288,8461,416800,417088,2
3140,86,8461,417088,417174,3
2439,123,8461,417174,417297,5
4198,258,8461,417297,417555,15
5726,71,8461,417555,417626,19
9798,29,8461,417626,417655,31
2854,166,8462,417654,417820,17
5878,97,8462,417820,417917,27
5268,44,8462,417917,417961,28
9707,260,8463,417960,418220,19
7939,163,8463,418220,418383,42
9773,140,8464,418382,418522,7
6440,7,8464,418522,418529,9
6665,181,8464,418529,418710,15
8964,62,8464,418710,418772,24
6360,6,8464,418772,418778,26
9550,194,8464,418778,418972,31
1657,160,8464,418972,419132,33
5598,28,8464,419132,419160,37
6138,116,8464,419160,419276,37
6685,22,8464,419276,419298,49
3234,259,8465,419297,419556,37
9178,116,8465,419556,419672,41
6394,296,8465,1456912,1457208,42
1636,217,8465,419815,420032,48
7481,122,8465,420032,420154,48
2198,66,8466,420153,420219,10
3781,95,8466,420219,420314,10
8548,22,8466,420314,420336,11
3637,80,8466,420336,420416,16
5358,88,8467,420415,420503,5
5341,73,8467,420503,420576,7
1698,74,8467,420576,420650,13
5338,72,8467,420650,420722,42
3724,169,8467,420722,420891,43
4549,289,8468,1457065,1457354,8
7097,63,8468,421030,421093,12
7679,153,8468,421093,421246,13
2251,113,8468,421246,421359,15
7048,248,8468,421359,421607,21
9743,270,8468,421607,421877,24
2274,218,8468,421877,422095,40
4893,230,8468,422095,422325,44
7254,46,8468,422325,422371,48
6405,111,8468,422371,422482,50
8811,227,8469,422481,422708,2
3094,217,8469,422708,422925,13
9954,24,8469,422925,422949,24
4316,82,8469,422949,423031,25
5195,158,8469,423031,423189,30
6371,59,8469,423189,423248,31
7035,10,8469,423248,423258,33
7382,265,8470,423257,423522,4
5871,291,8470,423522,423813,14
7527,51,8470,423813,423864,14
2793,157,8470,423864,424021,17
4734,162,8470,424021,424183,19
5164,195,8470,424183,424378,25
2206,112,8470,424378,424490,33
6653,232,8470,424490,424722,38
8317,258,8471,424721,424979,1
9639,185,8471,424979,425164,6
9629,121,8471,425164,425285,11
8247,82,8471,425285,425367,33
6030,79,8472,425366,425445,8
9544,265,8472,425445,425710,8
4183,64,8472,425710,425774,40
2089,248,8473,425773,426021,8
4911,83,8473,426021,426104,14
4849,3,8473,426104,426107,15
3569,51,8473,426107,426158,20
6046,279,8473,426158,426437,40
8919,171,8474,426436,426607,7
7375,80,8474,426607,426687,14
2474,275,8474,426687,426962,34
4850,125,8474,426962,427087,43
2185,208,8475,427086,427294,3
4283,116,8475,427294,427410,17
7371,200,8475,427410,427610,17
2020,177,8475,427610,427787,34
7471,26,8475,427787,427813,38
4654,87,8476,427812,427899,23
6675,177,8476,427899,428076,29
5340,29,8476,428076,428105,50
4926,93,8477,428104,428197,17
6236,38,8477,428197,428235,20
3021,183,8477,428235,428418,26
4257,193,8477,428418,428611,34
3056,245,8477,428611,428856,46
7283,22,8478,428855,428877,2
4016,138,8478,428877,429015,12
9754,222,8478,429015,429237,22
4092,237,8478,429237,429474,26
3896,100,8478,429474,429574,28
8188,45,8478,429574,429619,35
9457,5,8479,429618,429623,39
1898,94,8480,429622,429716,30
2864,264,8480,429716,429980,41
9011,34,8481,429979,430013,2
8412,63,8481,430013,430076,5
3402,34,8481,430076,430110,19
5153,292,8481,1457197,1457489,25
4902,154,8481,430254,430408,32
7415,144,8481,430408,430552,44
1508,149,8482,430551,430700,8
8465,75,8482,430700,430775,20
4995,15,8482,430775,430790,23
8766,123,8482,430790,430913,24
9657,118,8482,430913,431031,36
3711,280,8482,431031,431311,38
7327,60,8482,431311,431371,49
3395,143,8483,431370,431513,31
7707,93,8483,431513,431606,40
1077,188,8483,431606,431794,47
2815,251,8484,431793,432044,3
1167,203,8484,432044,432247,11
4440,84,8484,432247,432331,19
7195,78,8484,432331,432409,24
5353,114,8484,432409,432523,39
9822,108,8485,432522,432630,8
3490,16,8485,432630,432646,27
3309,139,8485,432646,432785,29
9386,159,8486,432784,432943,6
7723,161,8486,432943,433104,11
7379,239,8486,433104,433343,13
7428,280,8486,433343,433623,18
6879,259,8486,433623,433882,22
2305,29,8486,433882,433911,24
4137,65,8487,433910,433975,8
9089,80,8487,433975,434055,18
4100,207,8487,434055,434262,34
7498,238,8487,434262,434500,34
9869,15,8487,434500,434515,48
4680,6,8488,434514,434520,19
6251,234,8488,434520,434754,20
5068,18,8488,434754,434772,21
7226,267,8488,434772,435039,35
8728,295,8488,435039,435334,38
7255,236,8488,435334,435570,39
8326,12,8488,435570,435582,46
9866,181,8489,435581,435762,9
7773,299,8489,435762,436061,16
7014,175,8489,436061,436236,26
7714,126,8489,436236,436362,38
6762,88,8489,436362,436450,43
4731,120,8490,436449,436569,11
9440,294,8490,1457336,1457630,25
5466,222,8490,436713,436935,48
2532,146,8490,436935,437081,49
7739,91,8491,437080,437171,4
5847,69,8491,437171,437240,40
2715,122,8491,437240,437362,41
5642,96,8491,437362,437458,45
6624,94,8492,437457,437551,2
7094,141,8492,437551,437692,2
4234,272,8492,437692,437964,7
2644,250,8492,437964,438214,22
2651,95,8492,438214,438309,38
1635,181,8492,438309,438490,41
9098,161,8493,438489,438650,4
8666,139,8493,438650,438789,12
4852,270,8493,438789,439059,38
2219,42,8493,439059,439101,41
6269,245,8494,439100,439345,3
6413,144,8494,439345,439489,5
5367,298,8494,1457485,1457783,9
3662,82,8494,439630,439712,46
6683,180,8494,439712,439892,50
2515,192,8495,439891,440083,10
1658,39,8495,440083,440122,16
7548,60,8495,440122,440182,19
8965,276,8495,440182,440458,23
1859,107,8495,440458,440565,44
3381,168,8495,440565,440733,45
6591,222,8496,440732,440954,3
3353,40,8496,440954,440994,5
8036,37,8496,440994,441031,22
1921,280,8496,441031,441311,24
4015,254,8496,441311,441565,47
9650,277,8497,441564,441841,1
2163,102,8497,441841,441943,12
9310,245,8497,441943,442188,35
2287,211,8497,442188,442399,43
3084,275,8498,442398,442673,7
2433,245,8498,442673,442918,36
8462,219,8498,442918,443137,49
3752,211,8499,443136,443347,20
8500,169,8499,443347,443516,20
3706,59,8499,443516,443575,33
6981,271,8499,443575,443846,48
7689,212,8500,443845,444057,5
1196,108,8500,444057,444165,26
8182,229,8500,444165,444394,35
9543,209,8500,444394,444603,36
6609,144,8500,444603,444747,49
1214,300,8501,444746,445046,1
1150,96,8501,445046,445142,8
4704,134,8501,445142,445276,10
2459,80,8501,445276,445356,23
1289,255,8501,445356,445611,27
1133,253,8501,445611,445864,30
5818,155,8501,445864,446019,31
9619,289,8501,446019,446308,35
6013,29,8501,446308,446337,46
6192,144,8501,446337,446481,48
4923,230,8501,446481,446711,50
6290,299,8502,446710,447009,1
7636,99,8502,447009,447108,4
5984,274,8502,447108,447382,26
8587,104,8502,447382,447486,39
6305,143,8502,447486,447629,50
6620,12,8503,447628,447640,6
8731,286,8503,447640,447926,15
6692,18,8503,447926,447944,20
8943,21,8503,447944,447965,24
6563,157,8503,447965,448122,28
2743,182,8503,448122,448304,29
6908,282,8504,1457638,1457920,33
7292,35,8504,448438,448473,37
2505,7,8505,448472,448479,2
3223,145,8505,448479,448624,14
4442,103,8505,448624,448727,30
6718,252,8505,448727,448979,34
4796,196,8505,448979,449175,44
5687,140,8506,449174,449314,24
6846,85,8506,449314,449399,28
8738,237,8507,449398,449635,2
4969,253,8507,449635,449888,17
1126,205,8507,449888,450093,24
6674,168,8507,450093,450261,39
7612,280,8507,450261,450541,40
3607,87,8507,450541,450628,43
3011,138,8508,450627,450765,3
4370,156,8508,450765,450921,8
7302,118,8508,450921,451039,27
7700,240,8508,451039,451279,33
9333,213,8508,451279,451492,33
1366,263,8508,451492,451755,34
8488,175,8509,451754,451929,5
7843,113,8509,451929,452042,18
9522,77,8509,452042,452119,32
7492,44,8509,452119,452163,44
6114,1,8509,452163,452164,47
8979,134,8510,452163,452297,7
1774,188,8510,452297,452485,18
1587,15,8510,452485,452500,32
9254,126,8510,452500,452626,32
5159,94,8510,452626,452720,33
5406,144,8510,452720,452864,36
9228,272,8510,452864,453136,37
4176,184,8510,453136,453320,46
9793,175,8511,453319,453494,10
7511,132,8511,453494,453626,29
3871,219,8511,453626,453845,34
4593,38,8511,453845,453883,36
6918,170,8512,453882,454052,1
7311,234,8512,454052,454286,5
5856,212,8512,454286,454498,13
5759,297,8512,454498,454795,14
7946,79,8512,454795,454874,14
8123,156,8512,454874,455030,16
4265,87,8512,455030,455117,31
4653,75,8512,455117,455192,42
8290,219,8512,455192,455411,48
8138,288,8513,455410,455698,21
1950,42,8513,455698,455740,34
9078,144,8514,455739,455883,2
8692,241,8514,455883,456124,25
3224,215,8514,456124,456339,36
4825,83,8515,456338,456421,1
7096,191,8515,456421,456612,1
3773,77,8515,456612,456689,17
3777,124,8515,456689,456813,23
8155,91,8515,456813,456904,46
4990,226,8516,456903,457129,6
9423,259,8516,457129,457388,9
9766,211,8516,457388,457599,15
6364,245,8516,457599,457844,50
8143,243,8516,457844,458087,50
4913,207,8517,458086,458293,20
4426,281,8517,458293,458574,31
6110,143,8517,458574,458717,33
2618,211,8517,458717,458928,38
3535,167,8518,458927,459094,40
6542,300,8518,1457757,1458057,43
3145,31,8519,459242,459273,22
3060,236,8519,459273,459509,32
4273,183,8519,459509,459692,32
5006,294,8519,1457912,1458206,32
6335,38,8519,459836,459874,33
9290,128,8519,459874,460002,36
1842,209,8519,460002,460211,45
6786,279,8520,460210,460489,3
9236,207,8520,460489,460696,8
4627,23,8520,460696,460719,11
6436,195,8520,460719,460914,15
8136,19,8520,460914,460933,21
7999,296,8520,460933,461229,38
8297,169,8521,461228,461397,22
6358,140,8521,461397,461537,29
5058,209,8521,461537,461746,41
3306,170,8522,461745,461915,1
3995,141,8522,461915,462056,2
6092,297,8522,462056,462353,3
4673,155,8522,462353,462508,20
7786,163,8522,462508,462671,33
1550,292,8522,462671,462963,47
2429,242,8522,462963,463205,48
4423,13,8523,463204,463217,1
9724,173,8523,463217,463390,3
5791,214,8523,463390,463604,15
3106,46,8523,463604,463650,40
1059,45,8523,463650,463695,42
2354,239,8524,463694,463933,13
9346,47,8524,463933,463980,14
1459,28,8524,463980,464008,18
6332,25,8524,464008,464033,31
7976,26,8524,464033,464059,35
2059,287,8524,464059,464346,36
7106,13,8525,464345,464358,5
8904,90,8525,464358,464448,7
1523,271,8525,464448,464719,11
7180,158,8525,464719,464877,13
6312,267,8525,1458067,1458334,19
2694,135,8525,465010,465145,29
6389,153,8525,465145,465298,39
5266,284,8525,465298,465582,50
3925,288,8526,465581,465869,43
5720,184,8527,465868,466052,1
5171,272,8527,466052,466324,2
3262,168,8527,466324,466492,24
9199,12,8527,466492,466504,26
6349,113,8528,466503,466616,19
4545,123,8529,466615,466738,4
3705,205,8529,466738,466943,12
6017,158,8529,466943,467101,21
5693,23,8529,467101,467124,25
6088,202,8529,467124,467326,31
2750,114,8530,467325,467439,1
3204,129,8530,467439,467568,1
8698,47,8530,467568,467615,7
4326,291,8530,1458185,1458476,15
3046,257,8530,467759,468016,33
3029,261,8530,468016,468277,35
4401,161,8530,468277,468438,41
7507,240,8530,468438,468678,47
4948,276,8530,468678,468954,48
9545,12,8531,468953,468965,20
7250,99,8531,468965,469064,39
2587,7,8531,469064,469071,47
3421,255,8532,469070,469325,1
3747,259,8532,469325,469584,19
9526,148,8532,469584,469732,21
3894,128,8532,469732,469860,27
2962,274,8532,469860,470134,40
5486,121,8533,470133,470254,17
6086,107,8533,470254,470361,28
1536,260,8533,470361,470621,31
6227,156,8533,470621,470777,35
2603,219,8534,470776,470995,36
4674,213,8534,470995,471208,47
3003,36,8535,471207,471243,4
1796,94,8535,471243,471337,33
5975,256,8535,471337,471593,37
9985,182,8535,471593,471775,42
6045,98,8536,471774,471872,11
3235,131,8536,471872,472003,12
2753,202,8536,472003,472205,17
3568,54,8536,472205,472259,26
1826,129,8536,472259,472388,37
7182,96,8537,472387,472483,16
5312,95,8537,472483,472578,23
6545,139,8537,472578,472717,26
4382,122,8537,472717,472839,27
1625,154,8537,472839,472993,31
9477,175,8537,472993,473168,49
7215,146,8538,473167,473313,19
2683,26,8538,473313,473339,20
5747,120,8538,473339,473459,39
6038,293,8539,1458327,1458620,8
7819,209,8539,473598,473807,24
2141,186,8539,473807,473993,27
2281,1,8539,473993,473994,33
3023,94,8539,473994,474088,34
1048,39,8539,474088,474127,36
8742,84,8539,474127,474211,49
1583,26,8540,474210,474236,4
4012,140,8540,474236,474376,14
2233,25,8540,474376,474401,50
3655,175,8541,474400,474575,21
5396,147,8541,474575,474722,27
3331,176,8541,474722,474898,44
6418,269,8541,474898,475167,47
3588,231,8541,475167,475398,49
1861,192,8542,475397,475589,10
9611,62,8542,475589,475651,24
3776,164,8542,475651,475815,35
3124,66,8543,475814,475880,23
2227,242,8544,475879,476121,5
9484,117,8544,476121,476238,36
3719,118,8544,476238,476356,43
6328,254,8544,476356,476610,44
6746,259,8544,476610,476869,49
3433,71,8545,476868,476939,16
2332,20,8545,476939,476959,21
8865,150,8545,476959,477109,34
7346,7,8545,477109,477116,49
2845,243,8546,477115,477358,4
8196,4,8546,477358,477362,23
4548,122,8546,477362,477484,33
7107,145,8546,477484,477629,38
5792,210,8546,477629,477839,40
4332,78,8546,477839,477917,47
4125,20,8547,477916,477936,48
6715,3,8548,477935,477938,16
7822,146,8548,477938,478084,30
1479,187,8549,478083,478270,4
4060,43,8549,478270,478313,10
4935,10,8549,478313,478323,18
1552,41,8549,478323,478364,20
7879,237,8549,478364,478601,23
1915,65,8550,478600,478665,9
2700,92,8550,478665,478757,13
5983,291,8550,478757,479048,35
2757,228,8551,479047,479275,3
3110,278,8551,479275,479553,7
6807,213,8551,479553,479766,9
2039,235,8551,479766,480001,10
8050,190,8551,480001,480191,14
8299,227,8551,480191,480418,17
6906,140,8551,480418,480558,23
3190,156,8552,480557,480713,12
2125,126,8552,480713,480839,16
5660,27,8552,480839,480866,16
3436,286,8552,480866,481152,27
1597,29,8553,481151,481180,8
2104,226,8553,481180,481406,43
5839,37,8554,481405,481442,5
6188,158,8554,481442,481600,6
6075,66,8554,481600,481666,31
1239,215,8554,481666,481881,49
8118,56,8554,481881,481937,50
2387,17,8555,481936,481953,11
9740,3,8555,481953,481956,28
6100,138,8555,481956,482094,33
2079,129,8555,482094,482223,39
1674,59,8555,482223,482282,49
9243,213,8555,482282,482495,49
5935,224,8556,482494,482718,20
3006,67,8556,482718,482785,29
7278,213,8557,482784,482997,10
6806,31,8557,482997,483028,17
2116,245,8557,483028,483273,19
7090,281,8557,483273,483554,23
3988,134,8557,483554,483688,34
5350,220,8558,483687,483907,10
2702,297,8558,483907,484204,14
6005,160,8558,484204,484364,49
6703,190,8559,484363,484553,8
6525,261,8559,484553,484814,29
7071,13,8560,484813,484826,6
3758,187,8560,484826,485013,11
4162,32,8560,485013,485045,41
7748,180,8561,485044,485224,10
7411,96,8561,485224,485320,15
9944,4,8561,485320,485324,16
6264,24,8561,485324,485348,26
5200,168,8561,485348,485516,28
3899,207,8561,485516,485723,41
6295,178,8561,485723,485901,46
5923,96,8562,485900,485996,4
2371,46,8562,485996,486042,9
5745,91,8562,486042,486133,9
7493,216,8562,486133,486349,24
3035,54,8562,486349,486403,43
9592,230,8562,486403,486633,46
8640,61,8563,486632,486693,2
9929,138,8563,486693,486831,28
6261,232,8563,486831,487063,29
5075,160,8563,487063,487223,36
5902,17,8563,487223,487240,40
1858,17,8564,487239,487256,28
7172,120,8564,487256,487376,31
4388,213,8564,487376,487589,35
7206,35,8565,487588,487623,7
5351,37,8565,487623,487660,12
2538,212,8565,487660,487872,14
4658,278,8565,487872,488150,18
4231,235,8565,488150,488385,35
9425,104,8565,488385,488489,46
7629,184,8565,488489,488673,47
4218,77,8566,488672,488749,7
2347,250,8566,488749,488999,24
7772,151,8566,488999,489150,31
7405,5,8566,489150,489155,35
6429,231,8567,489154,489385,17
8885,73,8567,489385,489458,17
4678,279,8567,489458,489737,30
8396,87,8567,489737,489824,30
3545,292,8567,489824,490116,36
8375,100,8567,490116,490216,40
6534,191,8567,490216,490407,47
3653,104,8568,490406,490510,1
7658,270,8568,490510,490780,15
7056,19,8568,490780,490799,19
9163,192,8568,490799,490991,31
9571,214,8568,490991,491205,32
6510,28,8568,491205,491233,33
9574,161,8568,491233,491394,34
8325,177,8568,491394,491571,42
5289,109,8568,491571,491680,47
1073,198,8569,491679,491877,25
3356,94,8569,491877,491971,36
1854,20,8569,491971,491991,47
3247,66,8570,491990,492056,50
8483,240,8571,492055,492295,2
2325,207,8571,492295,492502,9
7579,39,8571,492502,492541,11
8722,62,8571,492541,492603,12
6957,91,8571,492603,492694,29
7823,237,8571,492694,492931,29
4067,77,8571,492931,493008,38
8480,189,8571,493008,493197,45
9780,240,8572,493196,493436,6
4096,104,8572,493436,493540,14
7571,89,8572,493540,493629,17
5117,200,8573,493628,493828,8
7865,228,8573,493828,494056,9
1177,93,8573,494056,494149,13
9227,107,8573,494149,494256,40
4355,162,8574,494255,494417,6
9840,163,8574,494417,494580,12
5385,37,8574,494580,494617,28
2067,5,8574,494617,494622,35
2484,124,8574,494622,494746,38
4663,65,8574,494746,494811,42
9255,244,8574,494811,495055,43
1911,96,8574,495055,495151,46
1228,247,8575,495150,495397,10
5194,219,8575,495397,495616,16
1440,113,8575,495616,495729,30
2629,36,8575,495729,495765,32
5293,52,8575,495765,495817,47
1270,143,8575,495817,495960,49
5014,113,8576,495959,496072,12
1920,277,8576,496072,496349,17
4157,212,8576,496349,496561,22
1952,63,8576,496561,496624,23
5542,191,8576,496624,496815,26
8859,266,8576,496815,497081,27
4193,84,8576,497081,497165,44
6650,12,8576,497165,497177,48
1776,185,8577,497176,497361,16
6447,258,8577,497361,497619,24
5112,27,8577,497619,497646,29
6847,67,8577,497646,497713,29
6951,256,8577,497713,497969,44
7620,179,8577,497969,498148,46
1745,8,8577,498148,498156,50
3061,99,8578,498155,498254,4
2979,103,8578,498254,498357,5
7821,96,8578,498357,498453,9
7740,125,8578,498453,498578,37
9894,180,8579,498577,498757,3
8320,137,8579,498757,498894,7
7274,98,8579,498894,498992,14
8373,138,8579,498992,499130,25
5572,195,8579,499130,499325,26
1567,185,8579,499325,499510,31
7318,106,8579,499510,499616,33
8701,135,8579,499616,499751,33
6969,24,8579,499751,499775,41
8000,61,8579,499775,499836,44
5559,83,8579,499836,499919,47
7219,199,8579,499919,500118,50
1554,151,8580,500117,500268,2
7105,18,8580,500268,500286,14
8790,108,8580,500286,500394,16
1201,202,8580,500394,500596,21
4131,294,8580,1458435,1458729,25
2499,195,8580,500740,500935,27
4677,35,8581,500934,500969,2
4112,290,8581,500969,501259,10
2084,18,8581,501259,501277,22
4260,257,8581,501277,501534,22
5135,7,8581,501534,501541,33
8453,278,8582,501540,501818,27
3299,264,8583,501817,502081,6
6354,293,8583,502081,502374,6
2311,186,8583,502374,502560,15
8639,284,8583,502560,502844,32
1870,199,8583,502844,503043,33
9871,9,8583,503043,503052,42
7941,27,8583,503052,503079,43
5579,111,8583,503079,503190,48
2292,83,8584,503189,503272,12
1329,90,8584,503272,503362,13
7603,242,8584,503362,503604,13
8558,294,8584,503604,503898,23
2078,255,8584,503898,504153,44
6784,39,8584,504153,504192,49
2031,27,8585,504191,504218,13
7159,70,8585,504218,504288,19
2136,295,8585,1458580,1458875,25
9151,51,8585,504432,504483,30
9941,193,8585,504483,504676,40
3125,168,8586,504675,504843,10
4920,2,8586,504843,504845,27
8709,28,8586,504845,504873,28
3636,169,8587,504872,505041,24
8449,232,8587,505041,505273,36
3774,227,8587,505273,505500,41
2438,256,8587,505500,505756,45
1373,83,8588,505755,505838,6
2368,232,8588,505838,506070,8
1429,210,8588,506070,506280,49
7151,33,8589,506279,506312,1
9721,161,8589,506312,506473,29
2986,149,8589,506473,506622,35
4814,135,8589,506622,506757,41
7129,63,8589,506757,506820,42
7931,167,8590,506819,506986,5
2056,93,8590,506986,507079,26
4518,189,8590,507079,507268,29
7095,111,8590,507268,507379,38
2654,260,8591,507378,507638,1
9081,148,8591,507638,507786,26
1931,124,8591,507786,507910,28
8988,147,8591,507910,508057,43
3816,111,8591,508057,508168,50
4302,12,8592,508167,508179,2
6325,115,8592,508179,508294,3
8883,287,8592,508294,508581,3
2539,70,8592,508581,508651,26
7683,172,8593,508650,508822,10
2418,188,8593,508822,509010,21
6876,3,8593,509010,509013,29
5837,157,8593,509013,509170,38
3958,277,8594,509169,509446,3
6177,154,8594,509446,509600,9
5193,72,8594,509600,509672,37
9002,263,8595,509671,509934,9
1031,53,8595,509934,509987,19
9043,117,8595,509987,510104,26
6152,215,8595,510104,510319,30
3317,114,8595,510319,510433,35
5589,285,8595,510433,510718,41
4356,150,8596,510717,510867,10
9383,170,8596,510867,511037,11
1756,199,8596,511037,511236,22
4936,185,8596,511236,511421,43
3812,1,8597,511420,511421,16
4106,193,8597,511421,511614,16
4959,32,8597,511614,511646,49
8700,130,8598,511645,511775,20
8058,21,8598,511775,511796,26
7128,19,8598,511796,511815,29
1397,102,8598,511815,511917,33
5762,84,8599,511916,512000,17
5373,20,8599,512000,512020,30
3372,237,8599,512020,512257,31
8585,143,8599,512257,512400,33
9623,286,8600,512399,512685,1
8616,262,8600,512685,512947,4
1790,166,8600,512947,513113,23
9391,95,8600,513113,513208,26
7322,63,8600,513208,513271,28
8257,228,8600,513271,513499,33
9047,112,8600,513499,513611,38
7337,226,8601,513610,513836,6
5718,42,8601,513836,513878,16
9009,25,8601,513878,513903,19
6930,277,8601,513903,514180,23
1860,191,8601,514180,514371,30
9161,105,8601,514371,514476,31
3505,85,8602,514475,514560,1
9257,3,8602,514560,514563,4
3622,103,8602,514563,514666,5
1908,180,8602,514666,514846,21
3671,37,8602,514846,514883,28
8803,55,8602,514883,514938,32
8520,187,8602,514938,515125,37
4117,250,8602,515125,515375,40
3659,136,8603,515374,515510,13
3399,205,8603,515510,515715,29
1919,48,8604,515714,515762,9
8827,58,8604,515762,515820,39
4532,215,8605,515819,516034,12
1995,249,8605,516034,516283,35
9832,13,8606,516282,516295,10
4932,175,8606,516295,516470,13
1909,41,8606,516470,516511,16
9601,35,8606,516511,516546,19
7257,96,8606,516546,516642,21
9099,58,8606,516642,516700,35
8868,213,8606,516700,516913,36
9777,43,8606,516913,516956,49
9442,125,8607,516955,517080,14
1833,299,8607,517080,517379,21
6496,28,8607,517379,517407,23
6890,278,8607,1458718,1458996,33
7593,257,8607,517542,517799,45
1581,50,8607,517799,517849,49
3004,300,8608,517848,518148,20
7569,134,8608,518148,518282,23
9449,290,8608,518282,518572,23
9760,275,8608,518572,518847,36
3566,34,8609,518846,518880,1
9293,5,8609,518880,518885,7
7801,179,8609,518885,519064,11
2345,253,8609,519064,519317,18
2914,189,8609,519317,519506,28
1588,69,8609,519506,519575,36
2774,46,8609,519575,519621,47
8470,163,8609,519621,519784,49
9032,193,8610,519783,519976,1
8559,248,8610,519976,520224,19
4574,250,8610,520224,520474,29
6350,247,8610,520474,520721,33
7948,227,8610,520721,520948,43
8609,17,8611,520947,520964,11
8407,174,8611,520964,521138,28
5665,198,8611,521138,521336,47
2942,191,8611,521336,521527,48
6299,132,8611,521527,521659,48
2773,89,8612,521658,521747,10
7681,8,8612,521747,521755,18
8234,125,8612,521755,521880,20
2648,141,8612,521880,522021,36
4775,210,8613,522020,522230,3
9858,148,8613,522230,522378,28
4758,229,8614,522377,522606,19
7968,187,8614,522606,522793,35
1781,33,8614,522793,522826,46
2243,182,8615,522825,523007,18
5040,111,8615,523007,523118,32
3456,127,8615,523118,523245,44
6001,8,8615,523245,523253,46
6215,164,8616,523252,523416,11
9448,9,8616,523416,523425,18
8740,135,8616,523425,523560,19
1310,119,8616,523560,523679,44
5628,176,8616,523679,523855,47
5148,283,8616,523855,524138,50
7733,249,8616,524138,524387,50
3028,119,8617,524386,524505,9
4594,129,8617,524505,524634,17
3396,230,8617,524634,524864,36
4379,292,8617,524864,525156,40
5796,194,8618,525155,525349,7
5383,64,8618,525349,525413,14
1813,228,8618,525413,525641,22
2419,244,8618,525641,525885,25
1516,117,8618,525885,526002,28
4937,199,8618,526002,526201,32
3769,288,8618,526201,526489,39
4906,155,8618,526489,526644,46
9373,266,8619,526643,526909,12
1243,256,8619,526909,527165,14
4205,270,8620,527164,527434,7
7951,196,8620,527434,527630,18
8647,190,8620,527630,527820,41
5826,48,8620,527820,527868,49
3290,1,8621,527867,527868,1
3815,186,8621,527868,528054,14
1852,54,8621,528054,528108,21
1537,286,8621,1458847,1459133,22
5306,188,8621,528243,528431,22
9529,61,8621,528431,528492,22
1434,103,8621,528492,528595,24
7488,4,8621,528595,528599,25
3435,31,8621,528599,528630,34
1990,21,8621,528630,528651,43
6856,295,8621,528651,528946,43
3477,49,8621,528946,528995,44
3152,203,8622,528994,529197,16
4715,245,8622,529197,529442,38
3608,284,8622,529442,529726,46
6245,238,8622,529726,529964,46
5754,70,8623,529963,530033,9
4617,36,8623,530033,530069,10
4927,52,8623,530069,530121,10
2749,232,8623,530121,530353,26
9005,270,8623,530353,530623,46
3510,173,8624,530622,530795,18
1360,85,8624,530795,530880,21
8429,281,8624,530880,531161,26
1962,133,8624,531161,531294,27
9368,259,8624,531294,531553,39
7911,36,8624,531553,531589,42
8374,204,8624,531589,531793,45
2182,195,8625,531792,531987,29
9972,300,8625,531987,532287,35
3772,185,8625,532287,532472,36
4528,25,8626,532471,532496,17
6975,197,8626,532496,532693,19
6320,174,8626,532693,532867,20
7102,223,8626,532867,533090,23
8261,273,8626,533090,533363,37
8683,16,8626,533363,533379,47
3926,148,8627,533378,533526,1
7030,48,8627,533526,533574,10
4294,63,8627,533574,533637,40
6843,210,8627,533637,533847,43
2678,70,8628,533846,533916,14
8250,84,8628,533916,534000,15
5495,263,8628,534000,534263,16
7232,257,8628,534263,534520,33
8447,298,8628,534520,534818,35
7894,70,8628,534818,534888,37
5849,71,8628,534888,534959,46
9157,227,8629,534958,535185,4
3202,135,8629,535185,535320,18
6905,164,8629,535320,535484,28
6574,60,8629,535484,535544,39
7820,253,8630,535543,535796,7
8580,54,8630,535796,535850,11
2573,173,8630,535850,536023,14
8120,70,8630,536023,536093,19
6179,46,8630,536093,536139,27
1227,229,8631,536138,536367,2
3297,210,8631,536367,536577,33
3425,32,8631,536577,536609,33
4199,274,8631,536609,536883,40
3991,27,8631,536883,536910,47
1981,235,8631,536910,537145,48
5388,142,8631,537145,537287,48
5422,275,8631,537287,537562,48
1618,236,8632,537561,537797,9
8115,36,8632,537797,537833,11
1624,14,8632,537833,537847,45
3391,197,8633,537846,538043,5
7711,153,8633,538043,538196,6
2373,92,8633,538196,538288,11
9831,2,8633,538288,538290,14
8433,53,8633,538290,538343,16
3915,52,8633,538343,538395,35
8176,21,8634,538394,538415,8
4164,85,8634,538415,538500,32
7376,123,8634,538500,538623,33
5580,139,8634,538623,538762,36
3898,255,8634,538762,539017,37
7660,99,8634,539017,539116,40
5483,209,8635,539115,539324,9
8708,275,8635,539324,539599,41
2016,288,8635,539599,539887,48
9114,87,8636,539886,539973,14
3806,267,8636,539973,540240,21
1318,287,8636,540240,540527,39
4886,95,8636,540527,540622,45
7061,292,8636,540622,540914,45
1835,209,8636,540914,541123,46
8385,214,8637,541122,541336,2
7363,23,8637,541336,541359,3
8818,141,8637,541359,541500,5
7164,162,8637,541500,541662,15
9046,172,8637,541662,541834,16
9542,28,8637,541834,541862,16
3910,287,8637,1458984,1459271,19
2901,202,8637,541995,542197,30
2486,127,8637,542197,542324,35
2254,173,8637,542324,542497,38
3528,116,8637,542497,542613,50
1647,55,8638,542612,542667,47
3157,4,8639,542666,542670,20
8583,65,8639,542670,542735,38
3130,227,8640,542734,542961,5
9393,73,8640,542961,543034,14
4895,32,8640,543034,543066,26
6911,3,8641,543065,543068,2
4194,169,8641,543068,543237,12
8201,144,8641,543237,543381,27
8901,285,8641,543381,543666,28
9520,220,8641,543666,543886,43
3220,68,8641,543886,543954,44
8199,99,8642,543953,544052,1
1824,278,8642,1459133,1459411,19
1225,100,8642,544185,544285,23
5208,34,8642,544285,544319,28
4070,267,8642,544319,544586,30
5943,300,8643,1459267,1459567,28
8880,277,8643,544728,545005,34
6623,248,8644,545004,545252,13
7353,189,8644,545252,545441,26
7577,61,8644,545441,545502,36
1096,204,8645,545501,545705,10
6079,266,8645,545705,545971,15
4214,117,8645,545971,546088,22
2435,260,8646,546087,546347,2
3968,38,8646,546347,546385,35
9112,123,8646,546385,546508,44
7261,119,8647,546507,546626,2
5840,118,8647,546626,546744,5
1917,251,8647,546744,546995,23
4860,65,8647,546995,547060,25
3501,44,8647,547060,547104,38
6775,200,8648,547103,547303,1
3960,271,8648,547303,547574,43
5035,240,8648,547574,547814,49
8976,210,8649,547813,548023,1
2159,172,8649,548023,548195,23
5661,11,8649,548195,548206,48
7915,231,8649,548206,548437,50
4253,296,8650,548436,548732,16
3606,70,8650,548732,548802,18
1506,135,8650,548802,548937,20
1460,202,8650,548937,549139,32
6719,245,8650,549139,549384,40
8346,207,8650,549384,549591,42
4861,42,8651,549590,549632,17
5841,292,8652,549631,549923,2
7368,219,8652,549923,550142,2
8359,213,8652,550142,550355,32
6867,94,8652,550355,550449,35
8697,257,8652,550449,550706,38
5366,165,8653,550705,550870,10
5773,167,8653,550870,551037,12
1761,21,8653,551037,551058,22
4321,11,8653,551058,551069,41
9200,116,8654,551068,551184,2
1998,287,8654,551184,551471,37
9320,155,8655,551470,551625,14
8538,82,8655,551625,551707,22
6722,24,8655,551707,551731,36
6710,197,8655,551731,551928,37
5130,91,8656,551927,552018,7
1437,125,8656,552018,552143,24
8893,24,8656,552143,552167,30
5440,237,8656,552167,552404,33
5915,177,8656,552404,552581,39
1221,65,8657,552580,552645,19
7557,140,8657,552645,552785,35
1090,219,8657,552785,553004,41
5828,293,8658,553003,553296,1
3944,191,8658,553296,553487,2
1086,93,8658,553487,553580,10
2135,37,8658,553580,553617,41
3831,114,8658,553617,553731,46
1097,140,8659,553730,553870,29
5027,192,8659,553870,554062,30
8878,93,8659,554062,554155,33
2989,253,8660,554154,554407,4
6671,163,8660,554407,554570,4
8253,19,8660,554570,554589,6
5347,165,8660,554589,554754,13
6599,204,8660,554754,554958,14
3166,38,8660,554958,554996,30
6103,81,8660,554996,555077,34
5280,52,8660,555077,555129,36
7546,187,8660,555129,555316,43
7876,169,8660,555316,555485,49
1181,32,8661,555484,555516,3
3432,61,8661,555516,555577,6
1462,276,8661,555577,555853,8
3400,290,8661,555853,556143,10
9193,214,8661,556143,556357,14
5859,62,8661,556357,556419,29
7033,169,8661,556419,556588,36
4657,125,8662,556587,556712,9
2395,201,8662,556712,556913,19
9249,125,8662,556913,557038,19
8782,43,8662,557038,557081,37
9602,98,8662,557081,557179,37
9106,238,8663,557178,557416,7
2134,26,8663,557416,557442,14
5327,161,8663,557442,557603,24
8307,106,8663,557603,557709,25
1108,62,8663,557709,557771,34
5558,298,8664,557770,558068,35
7804,172,8665,558067,558239,7
1275,256,8665,558239,558495,17
6084,264,8665,558495,558759,24
7981,296,8665,1459402,1459698,24
4746,81,8665,558902,558983,27
6626,3,8665,558983,558986,45
5893,110,8666,558985,559095,7
3499,64,8666,559095,559159,22
9082,110,8666,559159,559269,22
3387,140,8666,559269,559409,24
1362,286,8666,559409,559695,30
3540,39,8666,559695,559734,32
7348,294,8667,559733,560027,7
2173,285,8667,560027,560312,12
7065,96,8667,560312,560408,13
1438,210,8667,560408,560618,20
5098,131,8667,560618,560749,20
8452,13,8667,560749,560762,31
8213,108,8667,560762,560870,35
6824,20,8667,560870,560890,38
9958,201,8667,560890,561091,38
3282,175,8668,561090,561265,1
1399,47,8668,561265,561312,5
7201,98,8668,561312,561410,5
1111,205,8668,561410,561615,20
9222,154,8669,561614,561768,14
2252,298,8669,1459551,1459849,24
3063,262,8669,561911,562173,36
4329,241,8669,562173,562414,36
6532,220,8669,562414,562634,37
3450,257,8669,562634,562891,43
5241,172,8670,562890,563062,24
5772,277,8670,563062,563339,25
8156,81,8670,563339,563420,28
2204,274,8670,563420,563694,35
7674,283,8671,563693,563976,20
6550,257,8671,563976,564233,42
8409,264,8671,564233,564497,45
1385,279,8671,564497,564776,48
3657,188,8672,564775,564963,17
2388,295,8672,564963,565258,23
8278,243,8672,565258,565501,36
5245,75,8672,565501,565576,38
5104,43,8672,565576,565619,44
1478,35,8672,565619,565654,47
2240,47,8673,565653,565700,11
1862,141,8673,565700,565841,26
7193,6,8673,565841,565847,33
8861,60,8673,565847,565907,41
8163,59,8674,565906,565965,1
9135,158,8674,565965,566123,3
2217,57,8674,566123,566180,6
8710,167,8675,566179,566346,17
6130,44,8675,566346,566390,32
9872,151,8675,566390,566541,43
7160,210,8675,566541,566751,50
9018,4,8676,566750,566754,19
9561,95,8676,566754,566849,29
3652,23,8676,566849,566872,30
8413,118,8676,566872,566990,37
7439,32,8676,566990,567022,42
1795,113,8677,567021,567134,9
3362,214,8677,567134,567348,16
6779,52,8677,567348,567400,25
8489,58,8677,567400,567458,25
9835,143,8677,567458,567601,38
4398,141,8677,567601,567742,46
1996,257,8678,567741,567998,10
4897,38,8678,567998,568036,10
9620,249,8678,568036,568285,19
6633,93,8678,568285,568378,24
4553,178,8678,568378,568556,30
7373,167,8679,568555,568722,17
9751,121,8679,568722,568843,27
4237,18,8679,568843,568861,49
8100,87,8680,568860,568947,25
2190,89,8680,568947,569036,39
3380,12,8680,569036,569048,42
5939,111,8680,569048,569159,45
2118,197,8681,569158,569355,36
2394,38,8682,569354,569392,6
5838,247,8682,569392,569639,16
1973,192,8682,569639,569831,42
4222,67,8683,569830,569897,12
1637,267,8683,569897,570164,15
5213,45,8683,570164,570209,33
2377,268,8683,570209,570477,45
1292,14,8684,570476,570490,26
3691,165,8684,570490,570655,34
6984,17,8684,570655,570672,40
6465,275,8684,570672,570947,50
2561,31,8685,570946,570977,28
2589,162,8685,570977,571139,28
5669,59,8686,571138,571197,47
5393,70,8687,571196,571266,8
6508,160,8688,571265,571425,2
9492,194,8688,571425,571619,5
4026,205,8688,571619,571824,31
9646,73,8688,571824,571897,39
7115,205,8688,571897,572102,40
9900,113,8689,572101,572214,15
2265,82,8689,572214,572296,18
5577,176,8689,572296,572472,42
3949,244,8689,572472,572716,47
3734,238,8690,572715,572953,13
3341,144,8690,572953,573097,50
5715,60,8691,573096,573156,21
6794,241,8691,573156,573397,22
9960,8,8691,573397,573405,32
8729,118,8691,573405,573523,35
8956,190,8692,573522,573712,4
6831,67,8692,573712,573779,15
6662,216,8692,573779,573995,20
5937,109,8692,573995,574104,38
9908,230,8692,574104,574334,46
3987,202,8693,574333,574535,4
1957,44,8693,574535,574579,13
1179,195,8693,574579,574774,26
1539,209,8693,574774,574983,40
3731,275,8694,574982,575257,13
4524,182,8694,575257,575439,16
3018,195,8694,575439,575634,22
5028,22,8694,575634,575656,41
6334,113,8694,575656,575769,47
5710,44,8695,575768,575812,4
1389,281,8695,575812,576093,20
4733,126,8695,576093,576219,24
2130,237,8695,576219,576456,31
5221,244,8695,576456,576700,35
3326,138,8695,576700,576838,43
3598,64,8696,576837,576901,10
7321,168,8696,576901,577069,15
1867,232,8696,577069,577301,18
4395,137,8696,577301,577438,20
5235,165,8696,577438,577603,23
9827,256,8696,577603,577859,44
3867,73,8696,577859,577932,48
4076,160,8697,577931,578091,15
3256,149,8697,578091,578240,31
9185,255,8697,578240,578495,45
6854,48,8698,578494,578542,2
5392,139,8698,578542,578681,18
9828,105,8698,578681,578786,18
1887,207,8698,578786,578993,23
9101,118,8698,578993,579111,31
2107,109,8698,579111,579220,33
4035,232,8698,579220,579452,37
2051,102,8698,579452,579554,38
7178,159,8698,579554,579713,47
9733,81,8699,579712,579793,11
3333,43,8699,579793,579836,15
4770,60,8699,579836,579896,44
3340,272,8699,579896,580168,49
5861,50,8700,580167,580217,1
8479,31,8700,580217,580248,2
7520,17,8700,580248,580265,5
1969,258,8700,580265,580523,13
4330,195,8700,580523,580718,25
2775,238,8700,580718,580956,27
1694,160,8700,580956,581116,28
5477,100,8700,581116,581216,50
8896,50,8702,581214,581264,15
1578,227,8703,581263,581490,7
1551,257,8703,581490,581747,17
8618,69,8703,581747,581816,21
1901,171,8703,581816,581987,29
1418,290,8703,581987,582277,40
6474,37,8704,582276,582313,35
3378,238,8704,582313,582551,37
5113,58,8704,582551,582609,41
8815,37,8704,582609,582646,46
8245,65,8704,582646,582711,49
9109,20,8705,582710,582730,12
5036,17,8705,582730,582747,35
5825,236,8705,582747,582983,35
4669,207,8706,582982,583189,12
2308,221,8706,583189,583410,16
1557,14,8706,583410,583424,32
6696,250,8706,583424,583674,46
2221,106,8707,583673,583779,17
6512,47,8707,583779,583826,18
1541,182,8707,583826,584008,21
3770,114,8707,584008,584122,22
8272,51,8707,584122,584173,29
3654,99,8707,584173,584272,31
1173,88,8707,584272,584360,38
2423,56,8707,584360,584416,39
2178,170,8708,584415,584585,12
5109,226,8708,584585,584811,23
2879,285,8708,584811,585096,24
3315,81,8708,585096,585177,31
4252,157,8708,585177,585334,46
8029,228,8708,585334,585562,47
1984,297,8708,585562,585859,48
8219,257,8709,585858,586115,6
5504,163,8709,586115,586278,15
3796,75,8709,586278,586353,19
7184,76,8709,586353,586429,19
5432,89,8709,586429,586518,21
7390,261,8709,586518,586779,22
8723,119,8709,586779,586898,25
8003,231,8709,586898,587129,26
9815,112,8709,587129,587241,34
8930,185,8709,587241,587426,42
4399,49,8709,587426,587475,50
5508,232,8710,587474,587706,9
3105,7,8710,587706,587713,13
3703,115,8710,587713,587828,17
7011,105,8710,587828,587933,31
8018,65,8710,587933,587998,34
9604,216,8710,587998,588214,36
8966,4,8710,588214,588218,50
1070,202,8711,588217,588419,18
1498,299,8712,588418,588717,14
3924,126,8712,588717,588843,28
5800,204,8712,588843,589047,33
3928,273,8712,589047,589320,40
6186,298,8714,589318,589616,7
2128,111,8714,589616,589727,11
1407,163,8714,589727,589890,29
2129,197,8714,589890,590087,37
8463,86,8714,590087,590173,42
6368,122,8714,590173,590295,48
4038,276,8715,590294,590570,7
6423,67,8715,590570,590637,23
7197,125,8715,590637,590762,26
4867,297,8715,590762,591059,31
4187,168,8715,591059,591227,39
5201,111,8715,591227,591338,50
2906,127,8716,591337,591464,5
3085,224,8716,591464,591688,16
2563,115,8716,591688,591803,24
6249,237,8716,591803,592040,33
5330,43,8716,592040,592083,43
5632,195,8717,592082,592277,5
7936,120,8717,592277,592397,13
3133,299,8717,1459658,1459957,28
1482,32,8717,592540,592572,32
3853,126,8717,592572,592698,36
7950,149,8718,592697,592846,1
8613,82,8718,592846,592928,24
6322,256,8719,592927,593183,37
5441,117,8720,593182,593299,11
7243,286,8720,593299,593585,25
3681,228,8720,593585,593813,28
7038,35,8720,593813,593848,28
5744,144,8720,593848,593992,41
6214,123,8721,593991,594114,24
6823,109,8721,594114,594223,26
5817,297,8721,594223,594520,30
6399,197,8721,594520,594717,43
6444,242,8722,594716,594958,10
4151,204,8722,594958,595162,14
9901,40,8722,595162,595202,41
3666,255,8722,595202,595457,43
5485,63,8722,595457,595520,44
5617,195,8722,595520,595715,44
2401,227,8723,595714,595941,4
7167,210,8723,595941,596151,19
5394,31,8723,596151,596182,26
8392,64,8724,596181,596245,10
6553,124,8725,596244,596368,2
9181,26,8725,596368,596394,4
1881,47,8725,596394,596441,6
9580,174,8725,596441,596615,6
2309,196,8725,596615,596811,8
1284,247,8725,596811,597058,13
2249,21,8725,597058,597079,22
7462,3,8725,597079,597082,49
6211,53,8726,597081,597134,48
4862,43,8727,597133,597176,5
2722,132,8727,597176,597308,21
4335,19,8727,597308,597327,29
3405,227,8727,597327,597554,39
4083,289,8727,597554,597843,49
1411,298,8728,597842,598140,1
2966,158,8728,598140,598298,21
8997,152,8728,598298,598450,35
2162,211,8729,598449,598660,44
1611,67,8730,598659,598726,9
1697,5,8730,598726,598731,12
3601,143,8730,598731,598874,15
9155,17,8730,598874,598891,16
4056,238,8730,598891,599129,18
6736,199,8730,599129,599328,39
1559,71,8731,599327,599398,1
4069,182,8731,599398,599580,10
1892,94,8731,599580,599674,17
1291,98,8731,599674,599772,26
4305,30,8732,599771,599801,3
5480,54,8732,599801,599855,12
8339,193,8732,599855,600048,19
3639,159,8732,600048,600207,20
8801,257,8732,600207,600464,22
6544,10,8732,600464,600474,45
7047,165,8732,600474,600639,49
7958,193,8732,600639,600832,50
8484,1,8733,600831,600832,3
7646,138,8733,600832,600970,8
2959,67,8733,600970,601037,12
6647,294,8733,601037,601331,38
3626,65,8733,601331,601396,43
1890,16,8733,601396,601412,49
4191,199,8734,601411,601610,6
4270,16,8734,601610,601626,17
7276,15,8734,601626,601641,18
2895,154,8734,601641,601795,24
2933,113,8734,601795,601908,25
6101,202,8734,601908,602110,26
1840,44,8734,602110,602154,36
4607,64,8735,602153,602217,18
5918,66,8735,602217,602283,20
3823,66,8735,602283,602349,23
5074,185,8735,602349,602534,26
2327,212,8735,602534,602746,27
5829,300,8735,602746,603046,27
3638,157,8735,603046,603203,50
7453,294,8736,603202,603496,2
1605,29,8736,603496,603525,9
1880,294,8736,603525,603819,13
9848,9,8736,603819,603828,20
1509,150,8736,603828,603978,29
3002,14,8736,603978,603992,39
8810,31,8736,603992,604023,46
5552,109,8737,604022,604131,24
8685,223,8737,604131,604354,36
3466,224,8737,604354,604578,37
8473,13,8737,604578,604591,41
5124,283,8738,604590,604873,3
7204,233,8738,604873,605106,10
8006,177,8738,605106,605283,11
8651,242,8738,605283,605525,11
1026,142,8738,605525,605667,18
1355,293,8738,605667,605960,30
9988,43,8738,605960,606003,31
4810,139,8738,606003,606142,36
7177,224,8739,606141,606365,9
9962,189,8739,606365,606554,15
9473,168,8739,606554,606722,18
4826,58,8739,606722,606780,20
5734,300,8739,1459800,1460100,33
7887,10,8739,606915,606925,34
7458,285,8739,606925,607210,41
8288,4,8739,607210,607214,45
4868,162,8740,607213,607375,9
8749,43,8740,607375,607418,10
1443,67,8740,607418,607485,12
3875,295,8740,607485,607780,16
9382,246,8740,607780,608026,32
4577,224,8740,608026,608250,43
4724,207,8740,608250,608457,50
2201,299,8741,608456,608755,3
1390,205,8741,608755,608960,7
5959,184,8741,608960,609144,13
1729,263,8741,609144,609407,37
3735,53,8741,609407,609460,46
6841,143,8742,609459,609602,11
5123,171,8742,609602,609773,22
2411,137,8742,609773,609910,24
6955,27,8743,609909,609936,1
1874,218,8743,609936,610154,8
7514,139,8743,610154,610293,10
5756,220,8743,610293,610513,12
1471,231,8743,610513,610744,20
3434,44,8743,610744,610788,20
5702,282,8743,610788,611070,27
6414,207,8744,611069,611276,14
5061,254,8744,611276,611530,24
6577,11,8744,611530,611541,25
9599,54,8744,611541,611595,26
5229,113,8744,611595,611708,29
4505,189,8744,611708,611897,34
2303,212,8744,611897,612109,46
2680,249,8744,612109,612358,48
8191,213,8745,612357,612570,16
8152,288,8745,612570,612858,17
3136,175,8745,612858,613033,26
7122,175,8745,613033,613208,36
3933,221,8745,613208,613429,46
4269,210,8745,613429,613639,50
8455,76,8746,613638,613714,44
2232,74,8747,613713,613787,3
5276,281,8747,613787,614068,12
9934,19,8747,614068,614087,33
1747,41,8747,614087,614128,44
6004,216,8748,614127,614343,30
6963,159,8748,614343,614502,37
4955,291,8748,614502,614793,49
5869,76,8749,614792,614868,3
2075,38,8749,614868,614906,8
2218,220,8749,614906,615126,25
4146,243,8749,615126,615369,43
3847,156,8749,615369,615525,45
2330,163,8750,615524,615687,8
8950,107,8750,615687,615794,18
3344,291,8750,615794,616085,26
3236,96,8750,616085,616181,28
2598,230,8750,616181,616411,35
7067,146,8750,616411,616557,44
9765,192,8750,616557,616749,50
6740,94,8751,616748,616842,1
1480,94,8751,616842,616936,8
7401,146,8751,616936,617082,13
9568,12,8752,617081,617093,34
3811,230,8752,617093,617323,37
6654,78,8752,617323,617401,47
1222,6,8753,617400,617406,24
4071,23,8753,617406,617429,25
5384,27,8753,617429,617456,30
8591,20,8753,617456,617476,33
4771,192,8754,617475,617667,5
2391,36,8754,617667,617703,8
6558,30,8754,617703,617733,26
5808,83,8754,617733,617816,30
4007,30,8754,617816,617846,39
2362,23,8754,617846,617869,41
3851,216,8754,617869,618085,43
7046,161,8755,618084,618245,4
7010,155,8755,618245,618400,23
4144,71,8755,618400,618471,26
4490,231,8755,618471,618702,34
1174,161,8755,618702,618863,46
2002,129,8755,618863,618992,50
2207,140,8756,618991,619131,4
1268,197,8756,619131,619328,34
3467,137,8756,619328,619465,38
5855,205,8756,619465,619670,50
4129,272,8757,619669,619941,11
1071,168,8757,619941,620109,49
7408,30,8758,620108,620138,3
5262,17,8758,620138,620155,28
9341,102,8758,620155,620257,38
4963,267,8759,620256,620523,13
7983,121,8759,620523,620644,13
7543,259,8759,620644,620903,27
1372,136,8759,620903,621039,38
9690,168,8759,621039,621207,44
3251,146,8760,621206,621352,9
2627,120,8760,621352,621472,21
2344,116,8760,621472,621588,24
4517,5,8760,621588,621593,26
1903,10,8760,621593,621603,30
3076,33,8760,621603,621636,31
5978,92,8760,621636,621728,49
6070,129,8761,621727,621856,17
8291,47,8761,621856,621903,23
7020,299,8761,621903,622202,31
8051,118,8761,622202,622320,31
8934,14,8761,622320,622334,38
7627,248,8761,622334,622582,42
2385,162,8761,622582,622744,43
2791,45,8761,622744,622789,50
7203,1,8762,622788,622789,23
3694,53,8762,622789,622842,27
3323,160,8762,622842,623002,32
7058,114,8762,623002,623116,39
6230,37,8763,623115,623152,24
7757,40,8763,623152,623192,49
6649,37,8764,623191,623228,7
7558,65,8764,623228,623293,7
7002,217,8764,623293,623510,31
9745,244,8764,623510,623754,46
5570,82,8764,623754,623836,48
3592,229,8765,623835,624064,10
8526,169,8765,624064,624233,19
9513,223,8765,624233,624456,21
6082,218,8765,624456,624674,48
7965,297,8766,1459933,1460230,8
3656,58,8766,624813,624871,14
4028,57,8766,624871,624928,22
2984,100,8766,624928,625028,25
3645,82,8766,625028,625110,33
1752,71,8766,625110,625181,42
8626,169,8767,625180,625349,5
9143,176,8767,625349,625525,14
5307,152,8767,625525,625677,18
7615,36,8767,625677,625713,21
7927,78,8767,625713,625791,24
7782,164,8767,625791,625955,32
3196,267,8767,625955,626222,38
4696,94,8767,626222,626316,42
2797,260,8768,626315,626575,1
7349,199,8768,626575,626774,43
1997,36,8769,626773,626809,8
5214,17,8769,626809,626826,11
1195,26,8769,626826,626852,21
3900,95,8769,626852,626947,28
5020,16,8769,626947,626963,29
1619,289,8769,626963,627252,35
5760,69,8769,627252,627321,36
8653,248,8769,627321,627569,41
1739,169,8770,627568,627737,32
6948,106,8770,627737,627843,39
9225,223,8771,627842,628065,1
2964,284,8771,628065,628349,14
1143,195,8771,628349,628544,21
1395,177,8771,628544,628721,21
8189,78,8771,628721,628799,24
4709,300,8771,628799,629099,34
1349,106,8771,629099,629205,36
6062,113,8771,629205,629318,48
7447,250,8771,629318,629568,49
2579,10,8771,629568,629578,50
7533,88,8772,629577,629665,22
5421,116,8772,629665,629781,24
1246,148,8772,629781,629929,32
5575,125,8772,629929,630054,32
8144,21,8772,630054,630075,36
2244,272,8773,630074,630346,3
3057,276,8773,1460090,1460366,19
9302,7,8773,630479,630486,21
2382,213,8774,630485,630698,8
1682,122,8774,630698,630820,28
2920,110,8774,630820,630930,49
1640,299,8774,1460218,1460517,50
9128,175,8775,631076,631251,14
3946,140,8775,631251,631391,31
9582,211,8775,631391,631602,42
9586,120,8776,631601,631721,4
6573,279,8776,631721,632000,38
6990,206,8777,631999,632205,13
3745,141,8777,632205,632346,22
4767,274,8777,632346,632620,24
3680,293,8777,632620,632913,27
4156,250,8777,632913,633163,27
1028,142,8777,633163,633305,41
8282,216,8778,633304,633520,9
6704,94,8778,633520,633614,28
5260,26,8778,633614,633640,29
4327,112,8778,633640,633752,46
8649,279,8778,633752,634031,48
6027,147,8779,634030,634177,40
6275,50,8779,634177,634227,44
2621,201,8779,634227,634428,49
1563,30,8780,634427,634457,2
9354,143,8780,634457,634600,19
1507,129,8780,634600,634729,25
4619,12,8780,634729,634741,30
1484,227,8780,634741,634968,32
9367,6,8781,634967,634973,15
1628,206,8781,634973,635179,16
6689,101,8781,635179,635280,29
3687,260,8781,635280,635540,31
7790,284,8781,635540,635824,31
2848,95,8782,635823,635918,19
5352,133,8782,635918,636051,19
5070,90,8782,636051,636141,25
2029,12,8782,636141,636153,32
8761,172,8782,636153,636325,42
9326,248,8783,636324,636572,2
7137,90,8783,636572,636662,22
5136,139,8783,636662,636801,31
6292,240,8784,636800,637040,12
5848,226,8784,637040,637266,13
4366,22,8784,637266,637288,29
9936,271,8784,637288,637559,35
7638,262,8784,637559,637821,40
7867,221,8784,637821,638042,42
9771,39,8784,638042,638081,46
3873,51,8785,638080,638131,14
8432,295,8785,1460373,1460668,19
8217,94,8785,638264,638358,20
7377,183,8785,638358,638541,43
5960,201,8786,638540,638741,6
5403,11,8786,638741,638752,15
8012,109,8786,638752,638861,17
4027,198,8786,638861,639059,21
7626,19,8786,639059,639078,22
3238,166,8786,639078,639244,26
2824,253,8786,639244,639497,30
3725,90,8786,639497,639587,38
8632,266,8787,639586,639852,14
9186,26,8787,639852,639878,14
1296,153,8787,639878,640031,18
3520,3,8787,640031,640034,37
3908,200,8788,640033,640233,13
7619,195,8789,640232,640427,28
3414,19,8789,640427,640446,36
9716,116,8789,640446,640562,47
3178,291,8789,640562,640853,49
4526,53,8790,640852,640905,4
4821,125,8790,640905,641030,14
7732,169,8791,641029,641198,2
6941,186,8791,641198,641384,3
8146,84,8791,641384,641468,36
6367,77,8791,641468,641545,41
7181,204,8791,641545,641749,45
4540,79,8792,641748,641827,30
4023,257,8792,641827,642084,33
8954,207,8792,642084,642291,34
9937,115,8792,642291,642406,36
5259,53,8793,642405,642458,1
4620,137,8793,642458,642595,2
7260,79,8793,642595,642674,13
4930,144,8793,642674,642818,23
2410,258,8793,642818,643076,49
7496,224,8793,643076,643300,49
3298,198,8794,643299,643497,15
3890,119,8794,643497,643616,22
1610,130,8795,643615,643745,23
2997,272,8795,643745,644017,40
4368,159,8796,644016,644175,18
8227,71,8796,644175,644246,20
8450,203,8796,644246,644449,23
1341,285,8796,1460522,1460807,33
1081,80,8796,644584,644664,37
7279,270,8796,644664,644934,40
8844,246,8796,644934,645180,45
3129,130,8796,645180,645310,47
2396,159,8797,645309,645468,17
1160,104,8797,645468,645572,23
5064,134,8797,645572,645706,37
9170,54,8798,645705,645759,1
3259,230,8798,645759,645989,15
9694,170,8798,645989,646159,16
1396,36,8798,646159,646195,21
3989,40,8798,646195,646235,46
3907,29,8799,646234,646263,3
4013,249,8799,646263,646512,5
2324,95,8799,646512,646607,17
9790,185,8799,646607,646792,17
4412,182,8799,646792,646974,34
9637,171,8799,646974,647145,38
5761,212,8800,647144,647356,20
8303,136,8801,647355,647491,6
8547,51,8801,647491,647542,14
6699,106,8801,647542,647648,48
9131,271,8802,647647,647918,12
9086,275,8802,647918,648193,26
9732,33,8802,648193,648226,26
7406,297,8802,648226,648523,30
7604,25,8802,648523,648548,34
6175,57,8802,648548,648605,37
7977,171,8802,648605,648776,42
8552,136,8802,648776,648912,43
6516,17,8803,648911,648928,28
7343,70,8803,648928,648998,35
3156,267,8804,648997,649264,10
6557,3,8804,649264,649267,14
2729,41,8804,649267,649308,19
5069,24,8804,649308,649332,29
1510,208,8804,649332,649540,44
6401,226,8805,649539,649765,3
1613,199,8805,649765,649964,8
9995,168,8805,649964,650132,10
4485,48,8805,650132,650180,30
4904,98,8805,650180,650278,45
2804,6,8805,650278,650284,48
8107,40,8806,650283,650323,5
9298,79,8806,650323,650402,7
6329,237,8806,650402,650639,33
9223,178,8806,650639,650817,49
6785,36,8807,650816,650852,6
5370,73,8807,650852,650925,7
8355,276,8807,650925,651201,18
9271,208,8807,651201,651409,18
4939,281,8807,651409,651690,21
2828,199,8807,651690,651889,27
6682,116,8807,651889,652005,34
3413,137,8807,652005,652142,35
6518,169,8807,652142,652311,42
7672,151,8808,652310,652461,4
5424,166,8808,652461,652627,7
6039,209,8808,652627,652836,11
9171,147,8808,652836,652983,19
4881,231,8808,652983,653214,25
4058,251,8808,653214,653465,29
9281,276,8808,653465,653741,30
7854,6,8808,653741,653747,37
1912,161,8808,653747,653908,44
6730,37,8808,653908,653945,47
8160,197,8809,653944,654141,16
3368,35,8809,654141,654176,18
4839,138,8809,654176,654314,36
6253,179,8809,654314,654493,36
8022,37,8810,654492,654529,5
8372,121,8810,654529,654650,7
1972,3,8810,654650,654653,9
4184,78,8810,654653,654731,11
2958,189,8810,654731,654920,14
5610,185,8810,654920,655105,22
2528,208,8810,655105,655313,25
4153,241,8810,655313,655554,26
1582,107,8810,655554,655661,31
1928,36,8810,655661,655697,33
9435,195,8810,655697,655892,34
1436,46,8810,655892,655938,42
5655,227,8810,655938,656165,49
7483,119,8811,656164,656283,2
3100,218,8811,656283,656501,11
5363,256,8811,656501,656757,17
6197,68,8811,656757,656825,26
9424,230,8811,656825,657055,32
9652,198,8811,657055,657253,37
9244,104,8811,657253,657357,43
8780,35,8812,657356,657391,6
2857,47,8812,657391,657438,14
9432,199,8812,657438,657637,23
5771,291,8812,1460648,1460939,24
3718,286,8812,657780,658066,32
9303,93,8813,658065,658158,40
9325,291,8813,658158,658449,40
5921,75,8813,658449,658524,41
4516,263,8814,658523,658786,11
2969,109,8814,658786,658895,12
6400,247,8814,658895,659142,38
1379,46,8815,659141,659187,2
8978,243,8815,659187,659430,26
7767,133,8815,659430,659563,27
3000,31,8815,659563,659594,32
4172,130,8815,659594,659724,35
3338,229,8815,659724,659953,38
6680,28,8816,659952,659980,5
4227,241,8816,659980,660221,15
1212,69,8816,660221,660290,19
5593,138,8816,660290,660428,24
8969,98,8816,660428,660526,34
8464,135,8817,660525,660660,24
8753,146,8817,660660,660806,39
1819,249,8818,660805,661054,19
6993,217,8818,661054,661271,20
9916,129,8818,661271,661400,30
8161,242,8818,661400,661642,33
8999,183,8818,661642,661825,37
6688,125,8818,661825,661950,48
1256,115,8819,661949,662064,13
6965,294,8819,662064,662358,39
8067,127,8819,662358,662485,42
1593,183,8820,662484,662667,3
8937,95,8820,662667,662762,8
1330,84,8820,662762,662846,15
1940,222,8820,662846,663068,24
6178,41,8820,663068,663109,25
8082,292,8820,663109,663401,45
1652,290,8821,663400,663690,16
8882,165,8821,663690,663855,18
5807,63,8821,663855,663918,29
8641,25,8821,663918,663943,32
8993,180,8821,663943,664123,35
7670,101,8821,664123,664224,48
9557,183,8822,664223,664406,26
1011,161,8822,664406,664567,39
2132,41,8822,664567,664608,45
3384,98,8822,664608,664706,45
9998,25,8822,664706,664731,46
6015,256,8822,664731,664987,47
6604,81,8823,664986,665067,8
2239,260,8823,665067,665327,39
2115,34,8823,665327,665361,45
1732,12,8823,665361,665373,49
5782,75,8824,665372,665447,7
4499,39,8824,665447,665486,18
5974,252,8824,665486,665738,32
7601,35,8824,665738,665773,36
1007,292,8824,665773,666065,40
1885,271,8824,666065,666336,50
4700,250,8824,666336,666586,50
7621,252,8825,666585,666837,2
4529,8,8825,666837,666845,3
7512,22,8825,666845,666867,13
8046,183,8825,666867,667050,23
3940,208,8825,667050,667258,33
5556,185,8825,667258,667443,39
8903,245,8826,667442,667687,3
2825,129,8826,667687,667816,10
4408,75,8826,667816,667891,17
3449,40,8826,667891,667931,26
3891,139,8826,667931,668070,32
2203,16,8826,668070,668086,33
6833,208,8826,668086,668294,41
8715,143,8827,668293,668436,18
1688,76,8827,668436,668512,28
4449,182,8827,668512,668694,44
5488,220,8828,668693,668913,15
4539,269,8829,668912,669181,7
9417,38,8829,669181,669219,10
9537,229,8829,669219,669448,24
6878,159,8829,669448,669607,33
2581,96,8829,669607,669703,36
7967,281,8830,669702,669983,11
8280,169,8830,669983,670152,25
2610,102,8830,670152,670254,26
6555,294,8830,1460777,1461071,32
9145,13,8830,670398,670411,39
8262,294,8831,670410,670704,6
7882,276,8831,670704,670980,16
6853,249,8831,670980,671229,20
5546,22,8831,671229,671251,22
2434,6,8831,671251,671257,25
5356,154,8831,671257,671411,38
4684,215,8831,671411,671626,46
5564,245,8832,671625,671870,19
6721,295,8832,671870,672165,37
7644,56,8832,672165,672221,39
7554,176,8832,672221,672397,40
2608,106,8833,672396,672502,8
2771,277,8833,672502,672779,16
2299,281,8834,672778,673059,2
3700,134,8834,673059,673193,7
1326,240,8834,673193,673433,26
7473,141,8834,673433,673574,29
2921,246,8834,673574,673820,38
4582,199,8834,673820,674019,40
4290,5,8834,674019,674024,41
1137,260,8834,674024,674284,48
9630,26,8835,674283,674309,8
5707,252,8835,674309,674561,25
7892,92,8835,674561,674653,28
3534,19,8835,674653,674672,37
9538,242,8835,674672,674914,45
2241,104,8836,674913,675017,10
6303,50,8836,675017,675067,13
4458,280,8836,675067,675347,20
5176,189,8836,675347,675536,50
4537,238,8837,675535,675773,7
6357,243,8837,675773,676016,19
6717,32,8837,676016,676048,39
4229,147,8837,676048,676195,46
7132,192,8838,676194,676386,16
3199,187,8838,676386,676573,17
7070,112,8838,676573,676685,25
9668,293,8838,1460919,1461212,25
1944,178,8838,676829,677007,29
3311,95,8838,677007,677102,30
3215,32,8838,677102,677134,34
8928,111,8838,677134,677245,38
6157,100,8838,677245,677345,40
4031,236,8838,677345,677581,43
4887,121,8838,677581,677702,49
9647,82,8839,677701,677783,2
9956,23,8839,677783,677806,20
1475,106,8839,677806,677912,34
6421,296,8839,677912,678208,40
7998,24,8839,678208,678232,44
5190,141,8840,678231,678372,23
5777,225,8841,678371,678596,4
7921,234,8841,678596,678830,21
5390,179,8841,678830,679009,44
2471,245,8842,679008,679253,11
7296,126,8842,679253,679379,33
6180,137,8842,679379,679516,48
3261,92,8843,679515,679607,1
8837,32,8843,679607,679639,10
7277,128,8843,679639,679767,12
3723,211,8843,679767,679978,14
7495,2,8844,679977,679979,8
6634,216,8844,679979,680195,22
3160,232,8844,680195,680427,26
5531,55,8844,680427,680482,27
7092,278,8844,680482,680760,41
9119,163,8844,680760,680923,41
6276,168,8845,680922,681090,2
7072,106,8845,681090,681196,5
7361,275,8845,681196,681471,7
2077,231,8845,681471,681702,19
6769,137,8845,681702,681839,37
4912,182,8845,681839,682021,44
1777,166,8845,682021,682187,45
5090,289,8846,682186,682475,35
7378,243,8846,682475,682718,36
8204,220,8846,682718,682938,47
5018,298,8847,682937,683235,12
1237,171,8847,683235,683406,16
7826,136,8847,683406,683542,23
9679,120,8847,683542,683662,28
8296,263,8847,683662,683925,30
2907,246,8847,683925,684171,31
6621,293,8847,684171,684464,31
8920,80,8848,684463,684543,11
4113,12,8848,684543,684555,14
7069,212,8848,684555,684767,22
1105,56,8848,684767,684823,32
8047,9,8848,684823,684832,38
4947,202,8848,684832,685034,42
9945,100,8849,685033,685133,27
8757,34,8849,685133,685167,30
8053,192,8849,685167,685359,36
5616,233,8850,685358,685591,2
4784,145,8850,685591,685736,9
9856,40,8850,685736,685776,14
8125,235,8850,685776,686011,17
7358,11,8851,686010,686021,10
4783,217,8851,686021,686238,11
8002,288,8851,686238,686526,41
5536,200,8852,686525,686725,20
4139,59,8852,686725,686784,26
1217,78,8852,686784,686862,27
3161,28,8852,686862,686890,33
3972,222,8852,686890,687112,37
3525,157,8853,687111,687268,1
8496,46,8853,687268,687314,49
4043,11,8854,687313,687324,13
7196,300,8854,1461056,1461356,29
5369,275,8854,687464,687739,34
9768,297,8854,687739,688036,37
6309,206,8854,688036,688242,42
1600,15,8854,688242,688257,44
2900,296,8854,688257,688553,48
2010,27,8855,688552,688579,5
9808,53,8855,688579,688632,10
2310,164,8855,688632,688796,14
1623,50,8855,688796,688846,28
9955,120,8855,688846,688966,34
2916,47,8856,688965,689012,23
5794,76,8856,689012,689088,39
2472,102,8857,689087,689189,2
2779,286,8857,689189,689475,21
6288,53,8857,689475,689528,39
9292,66,8857,689528,689594,47
4118,168,8857,689594,689762,48
6278,218,8857,689762,689980,48
2489,243,8858,689979,690222,1
2957,31,8858,690222,690253,7
8246,234,8858,690253,690487,18
5094,112,8858,690487,690599,20
2844,64,8858,690599,690663,26
1091,41,8858,690663,690704,29
6735,232,8859,690703,690935,4
3792,285,8859,690935,691220,14
6754,188,8859,691220,691408,16
8794,77,8859,691408,691485,23
7460,132,8859,691485,691617,28
5446,81,8859,691617,691698,49
6567,163,8860,691697,691860,5
8233,299,8860,1461201,1461500,43
1617,50,8861,692008,692058,6
5277,278,8861,692058,692336,20
3051,29,8861,692336,692365,27
8094,86,8861,692365,692451,44
8185,260,8862,692450,692710,1
6263,54,8862,692710,692764,2
1532,167,8862,692764,692931,34
7975,266,8863,692930,693196,6
9369,58,8863,693196,693254,7
3642,11,8863,693254,693265,13
3668,203,8863,693265,693468,37
7555,150,8863,693468,693618,46
7076,13,8864,693617,693630,2
2289,239,8864,693630,693869,8
4739,270,8864,693869,694139,14
9315,79,8864,694139,694218,17
8439,203,8864,694218,694421,30
7200,53,8864,694421,694474,40
7969,100,8865,694473,694573,3
6189,291,8865,694573,694864,17
9461,186,8865,694864,695050,22
7073,78,8865,695050,695128,39
7591,18,8865,695128,695146,49
8576,109,8866,695145,695254,17
2194,71,8866,695254,695325,35
1809,10,8867,695324,695334,3
5046,177,8867,695334,695511,7
3173,166,8867,695511,695677,17
2302,245,8867,695677,695922,18
4325,100,8867,695922,696022,28
1263,23,8867,696022,696045,29
2690,211,8868,696044,696255,5
1351,7,8868,696255,696262,14
6962,78,8868,696262,696340,20
2293,196,8868,696340,696536,23
3976,55,8868,696536,696591,25
5003,288,8869,696590,696878,1
8110,219,8869,696878,697097,21
2789,256,8869,697097,697353,25
7485,179,8869,697353,697532,48
6415,46,8870,697531,697577,7
9146,49,8870,697577,697626,13
4307,193,8870,697626,697819,15
5016,52,8870,697819,697871,30
4020,90,8870,697871,697961,35
3551,47,8871,697960,698007,12
6982,153,8871,698007,698160,12
8751,258,8871,698160,698418,18
5050,54,8871,698418,698472,19
1152,42,8871,698472,698514,32
4466,97,8871,698514,698611,39
9402,105,8872,698610,698715,4
7538,37,8873,698714,698751,25
5608,204,8873,698751,698955,30
7179,268,8874,698954,699222,5
5434,243,8874,699222,699465,10
1336,199,8874,699465,699664,36
3064,190,8874,699664,699854,40
1333,11,8874,699854,699865,43
6370,122,8875,699864,699986,5
6257,81,8876,699985,700066,1
2085,41,8876,700066,700107,12
8873,91,8876,700107,700198,17
4072,29,8876,700198,700227,34
7108,160,8876,700227,700387,38
9796,144,8876,700387,700531,44
3472,2,8877,700530,700532,2
5843,107,8877,700532,700639,41
1691,10,8877,700639,700649,46
4216,112,8877,700649,700761,50
3526,288,8878,700760,701048,5
7632,32,8878,701048,701080,15
5548,125,8878,701080,701205,19
2458,4,8878,701205,701209,26
3901,32,8878,701209,701241,31
7189,246,8878,701241,701487,34
2214,273,8878,701487,701760,39
9717,274,8878,701760,702034,41
9942,200,8879,702033,702233,1
8394,153,8879,702233,702386,5
2151,34,8879,702386,702420,16
4546,4,8879,702420,702424,34
9482,220,8879,702424,702644,48
3509,96,8879,702644,702740,49
8787,191,8880,702739,702930,11
8145,234,8880,702930,703164,16
9240,147,8880,703164,703311,16
5530,283,8880,703311,703594,35
1634,202,8881,703593,703795,2
4263,23,8881,703795,703818,12
5866,148,8881,703818,703966,17
1192,288,8881,703966,704254,18
9100,182,8881,704254,704436,25
5463,132,8881,704436,704568,31
7118,95,8881,704568,704663,41
7883,252,8881,704663,704915,48
9130,224,8882,704914,705138,15
2796,14,8882,705138,705152,24
2133,37,8882,705152,705189,46
2508,126,8882,705189,705315,47
2831,125,8883,705314,705439,5
1369,189,8883,705439,705628,8
3113,81,8883,705628,705709,15
9781,265,8883,705709,705974,19
9882,247,8883,705974,706221,21
3885,207,8883,706221,706428,29
8952,243,8883,706428,706671,50
5719,43,8884,706670,706713,9
2533,87,8884,706713,706800,20
5615,244,8884,706800,707044,40
2948,256,8884,707044,707300,42
8550,97,8884,707300,707397,43
2317,283,8885,707396,707679,18
5122,28,8885,707679,707707,20
2682,276,8885,707707,707983,28
3732,87,8886,707982,708069,1
3514,214,8886,708069,708283,18
6679,28,8886,708283,708311,33
4760,46,8886,708311,708357,43
2466,53,8887,708356,708409,22
4000,38,8887,708409,708447,24
5231,177,8887,708447,708624,28
7440,19,8887,708624,708643,31
2495,30,8887,708643,708673,34
1983,273,8887,708673,708946,39
6480,31,8887,708946,708977,42
7610,175,8887,708977,709152,43
5845,4,8887,709152,709156,46
1925,166,8888,709155,709321,1
4996,102,8888,709321,709423,20
6799,220,8888,709423,709643,20
4009,79,8888,709643,709722,34
5402,271,8888,709722,709993,39
2224,33,8888,709993,710026,45
2048,41,8889,710025,710066,4
7312,103,8889,710066,710169,16
9037,154,8889,710169,710323,25
6475,187,8890,710322,710509,29
5973,245,8891,710508,710753,13
7761,246,8891,710753,710999,24
5047,189,8891,710999,711188,40
8461,95,8891,711188,711283,50
5273,273,8892,711282,711555,31
4397,136,8892,711555,711691,36
3518,2,8892,711691,711693,38
4640,182,8893,711692,711874,12
5177,207,8893,711874,712081,15
1960,91,8893,712081,712172,42
2839,244,8894,712171,712415,22
6316,60,8894,712415,712475,22
6980,261,8894,712475,712736,22
9755,200,8894,712736,712936,23
7806,140,8895,712935,713075,2
3921,209,8895,713075,713284,4
1754,21,8895,713284,713305,23
1907,126,8895,713305,713431,37
8551,297,8896,1461317,1461614,6
1392,287,8896,713577,713864,16
3967,274,8896,713864,714138,25
5139,4,8896,714138,714142,48
4636,285,8896,714142,714427,49
4555,286,8896,714427,714713,50
7997,18,8896,714713,714731,50
4387,165,8897,714730,714895,21
6875,161,8897,714895,715056,36
9142,243,8897,715056,715299,47
2112,252,8898,715298,715550,2
9642,161,8898,715550,715711,2
9006,59,8898,715711,715770,30
3246,241,8898,715770,716011,43
9156,155,8899,716010,716165,4
5876,129,8899,716165,716294,9
1075,88,8899,716294,716382,11
9136,300,8899,716382,716682,12
8682,28,8899,716682,716710,16
9845,79,8899,716710,716789,22
1327,286,8899,716789,717075,24
9514,43,8899,717075,717118,33
8026,187,8899,717118,717305,38
3647,87,8899,717305,717392,39
2154,129,8900,717391,717520,39
2301,104,8900,717520,717624,47
2450,283,8901,717623,717906,5
8356,281,8901,717906,718187,41
5528,131,8901,718187,718318,43
3919,103,8901,718318,718421,48
2955,208,8901,718421,718629,50
8594,30,8902,718628,718658,13
1712,108,8902,718658,718766,19
7240,6,8902,718766,718772,20
5042,47,8902,718772,718819,21
3716,186,8902,718819,719005,24
8369,20,8902,719005,719025,25
7842,292,8902,1461465,1461757,28
5005,87,8902,719168,719255,32
1350,259,8902,719255,719514,47
4804,16,8903,719513,719529,13
1591,125,8903,719529,719654,17
6802,25,8903,719654,719679,20
2790,22,8903,719679,719701,22
8028,124,8904,719700,719824,5
9180,259,8904,719824,720083,12
9747,297,8904,1461612,1461909,24
5360,96,8904,720226,720322,43
9501,257,8905,720321,720578,6
6971,213,8905,720578,720791,8
2247,283,8905,720791,721074,12
6766,14,8905,721074,721088,13
6881,42,8905,721088,721130,18
1452,37,8905,721130,721167,34
6686,18,8905,721167,721185,39
6811,88,8906,721184,721272,5
2122,126,8906,721272,721398,22
7141,123,8906,721398,721521,32
3624,265,8906,721521,721786,35
3488,242,8906,721786,722028,36
9853,173,8906,722028,722201,43
9233,254,8906,722201,722455,44
9413,231,8906,722455,722686,49
3493,186,8906,722686,722872,50
5738,209,8907,722871,723080,12
7578,253,8907,723080,723333,24
9971,48,8907,723333,723381,39
9052,1,8908,723380,723381,1
1927,122,8908,723381,723503,10
2562,228,8908,723503,723731,11
3458,127,8908,723731,723858,23
3287,39,8908,723858,723897,34
3198,138,8908,723897,724035,45
6701,156,8908,724035,724191,46
4670,219,8909,724190,724409,9
2716,79,8909,724409,724488,22
4552,291,8909,724488,724779,43
1346,169,8909,724779,724948,48
6585,201,8910,724947,725148,2
2390,213,8910,725148,725361,16
1251,184,8910,725361,725545,17
6384,18,8910,725545,725563,23
3273,72,8910,725563,725635,24
8741,179,8910,725635,725814,29
3793,91,8910,725814,725905,35
3829,212,8910,725905,726117,45
8660,113,8911,726116,726229,1
8546,222,8911,726229,726451,14
9964,5,8911,726451,726456,15
7491,124,8911,726456,726580,48
5387,244,8912,726579,726823,12
1704,183,8912,726823,727006,31
4390,232,8913,727005,727237,15
9994,180,8913,727237,727417,35
5265,202,8913,727417,727619,36
2053,31,8914,727618,727649,11
9495,117,8914,727649,727766,19
4203,285,8914,727766,728051,20
4527,65,8915,728050,728115,3
1525,165,8915,728115,728280,6
6074,39,8915,728280,728319,13
4086,18,8915,728319,728337,17
4034,216,8915,728337,728553,26
8154,126,8915,728553,728679,41
4275,30,8915,728679,728709,43
4718,220,8915,728709,728929,49
1938,97,8916,728928,729025,6
8758,143,8916,729025,729168,9
9515,215,8916,729168,729383,14
6272,52,8916,729383,729435,17
5775,108,8916,729435,729543,25
6842,155,8916,729543,729698,40
3902,127,8916,729698,729825,42
8775,218,8916,729825,730043,43
9380,109,8916,730043,730152,46
8114,83,8916,730152,730235,48
9970,249,8916,730235,730484,50
1948,203,8917,730483,730686,18
8383,296,8917,1461761,1462057,22
4487,92,8917,730821,730913,27
3139,87,8917,730913,731000,33
3984,246,8917,731000,731246,34
3764,205,8917,731246,731451,45
4807,195,8918,731450,731645,1
5210,14,8918,731645,731659,11
1540,156,8918,731659,731815,21
6119,1,8918,731815,731816,23
1493,82,8918,731816,731898,37
3838,39,8919,731897,731936,21
8260,27,8919,731936,731963,31
3664,108,8919,731963,732071,43
6113,163,8919,732071,732234,48
7624,248,8920,732233,732481,6
8382,34,8920,732481,732515,6
1260,239,8920,732515,732754,25
9556,284,8920,732754,733038,25
9412,252,8920,733038,733290,30
5295,45,8920,733290,733335,40
5906,21,8920,733335,733356,40
1936,55,8921,733355,733410,6
3044,44,8921,733410,733454,15
3693,217,8921,733454,733671,20
4975,64,8921,733671,733735,32
2676,101,8921,733735,733836,41
1555,93,8921,733836,733929,48
4498,242,8921,733929,734171,48
8689,195,8922,734170,734365,19
3422,44,8922,734365,734409,33
7970,284,8923,734408,734692,5
5970,192,8923,734692,734884,19
2568,47,8923,734884,734931,25
8945,257,8923,734931,735188,42
3278,113,8923,735188,735301,49
4074,79,8924,735300,735379,5
3521,51,8924,735379,735430,30
6163,85,8924,735430,735515,41
9938,194,8925,735514,735708,5
8459,264,8925,735708,735972,6
9648,128,8925,735972,736100,13
5930,167,8925,736100,736267,22
8691,162,8925,736267,736429,25
5910,257,8925,736429,736686,28
1633,184,8925,736686,736870,30
7230,239,8925,736870,737109,39
9992,23,8925,737109,737132,46
9593,221,8925,737132,737353,47
4766,220,8926,737352,737572,4
2577,111,8926,737572,737683,41
7779,31,8926,737683,737714,42
4204,44,8927,737713,737757,10
6080,89,8927,737757,737846,43
3945,34,8928,737845,737879,10
7168,15,8928,737879,737894,21
6209,62,8928,737894,737956,38
9427,55,8929,737955,738010,4
1353,254,8929,738010,738264,10
2381,279,8929,738264,738543,20
4623,8,8929,738543,738551,22
6632,198,8929,738551,738749,40
8940,84,8929,738749,738833,40
9541,77,8930,738832,738909,3
5054,269,8930,738909,739178,5
1999,57,8930,739178,739235,48
3138,288,8931,739234,739522,5
7314,193,8931,739522,739715,49
6342,298,8932,739714,740012,5
4242,221,8932,740012,740233,9
4438,228,8932,740233,740461,15
7576,218,8932,740461,740679,15
6102,253,8932,740679,740932,20
2049,9,8932,740932,740941,22
9334,233,8932,740941,741174,39
5379,88,8932,741174,741262,45
9846,79,8933,741261,741340,7
8582,253,8933,741340,741593,21
2805,181,8933,741593,741774,23
2004,228,8933,741774,742002,30
7770,150,8934,742001,742151,9
2258,139,8934,742151,742290,22
9251,216,8934,742290,742506,35
1047,258,8935,742505,742763,13
5216,135,8935,742763,742898,22
7497,8,8935,742898,742906,34
1206,158,8936,742905,743063,9
2812,2,8936,743063,743065,14
9134,277,8936,743065,743342,35
8840,235,8936,743342,743577,42
1965,266,8936,743577,743843,47
7995,164,8936,743843,744007,47
5886,112,8937,744006,744118,9
1202,222,8937,744118,744340,14
1504,25,8937,744340,744365,40
4840,173,8937,744365,744538,47
5057,172,8937,744538,744710,50
3248,114,8938,744709,744823,22
4506,76,8938,744823,744899,23
6051,130,8938,744899,745029,24
7183,36,8940,745027,745063,14
4079,208,8940,745063,745271,30
8752,89,8940,745271,745360,39
4795,279,8940,745360,745639,44
6428,175,8941,745638,745813,11
6611,139,8941,745813,745952,12
1900,283,8941,1461893,1462176,29
9736,29,8941,746092,746121,37
4054,214,8941,746121,746335,48
9014,196,8942,746334,746530,2
3095,149,8942,746530,746679,11
9210,32,8942,746679,746711,42
2915,104,8942,746711,746815,46
7766,284,8942,746815,747099,49
8086,15,8943,747098,747113,4
4337,243,8943,747113,747356,11
2646,274,8943,747356,747630,43
6107,52,8943,747630,747682,44
2140,127,8943,747682,747809,45
3024,222,8943,747809,748031,45
6515,132,8943,748031,748163,46
7598,247,8943,748163,748410,46
8814,196,8943,748410,748606,48
5271,250,8944,748605,748855,8
1151,297,8944,748855,749152,31
7808,283,8944,749152,749435,35
9783,168,8944,749435,749603,38
4400,17,8944,749603,749620,41
1596,130,8944,749620,749750,42
5666,240,8944,749750,749990,48
7878,280,8944,749990,750270,50
5625,54,8945,750269,750323,12
5758,198,8945,750323,750521,14
1404,200,8945,750521,750721,20
5249,222,8945,750721,750943,25
8842,121,8946,750942,751063,1
5258,259,8946,751063,751322,10
6427,133,8946,751322,751455,14
6171,247,8946,751455,751702,37
6514,3,8946,751702,751705,45
6742,198,8947,751704,751902,11
3150,295,8947,1462027,1462322,42
4372,48,8948,752044,752092,5
2572,137,8948,752092,752229,8
6142,263,8948,752229,752492,28
7162,294,8949,1462180,1462474,8
6872,59,8949,752631,752690,9
7055,17,8949,752690,752707,25
8134,89,8949,752707,752796,31
4977,231,8949,752796,753027,33
6513,246,8949,753027,753273,45
8387,249,8950,753272,753521,1
2512,242,8950,753521,753763,4
1215,40,8950,753763,753803,8
4962,96,8950,753803,753899,20
7985,249,8950,753899,754148,41
4979,163,8950,754148,754311,49
3676,287,8951,1462331,1462618,9
5582,66,8951,754451,754517,17
6135,143,8951,754517,754660,17
4360,293,8951,754660,754953,30
1646,263,8951,754953,755216,46
3966,99,8952,755215,755314,1
8348,33,8952,755314,755347,22
4782,285,8952,755347,755632,41
9304,109,8953,755631,755740,5
1500,240,8953,755740,755980,12
7722,72,8953,755980,756052,28
3557,63,8953,756052,756115,30
6935,164,8953,756115,756279,33
4240,223,8953,756279,756502,35
7971,118,8953,756502,756620,39
5549,102,8953,756620,756722,47
6106,46,8954,756721,756767,2
2269,214,8954,756767,756981,11
9761,230,8954,756981,757211,16
6882,238,8954,757211,757449,31
6181,14,8954,757449,757463,42
1782,32,8954,757463,757495,45
2146,249,8954,757495,757744,45
5365,121,8955,757743,757864,1
4391,140,8955,757864,758004,9
2865,89,8955,758004,758093,20
3495,51,8955,758093,758144,22
7394,29,8955,758144,758173,22
4095,51,8955,758173,758224,27
6314,256,8955,758224,758480,32
3712,24,8955,758480,758504,43
1956,32,8956,758503,758535,10
3737,72,8956,758535,758607,18
5785,50,8957,758606,758656,1
8004,157,8957,758656,758813,5
3430,172,8957,758813,758985,16
7053,191,8957,758985,759176,30
6375,242,8957,759176,759418,35
7354,116,8958,759417,759533,12
6133,254,8958,759533,759787,14
4737,208,8958,759787,759995,37
3115,149,8958,759995,760144,46
2665,41,8958,760144,760185,50
1187,205,8959,760184,760389,2
2662,131,8959,760389,760520,5
1039,112,8959,760520,760632,37
8624,296,8959,760632,760928,38
6832,113,8959,760928,761041,50
1015,185,8960,761040,761225,37
3749,46,8960,761225,761271,44
8033,85,8961,761270,761355,4
9752,91,8961,761355,761446,30
3561,134,8961,761446,761580,50
9124,90,8962,761579,761669,45
2961,255,8963,761668,761923,7
1811,253,8963,761923,762176,12
3794,21,8963,762176,762197,19
4675,251,8963,762197,762448,24
5021,19,8963,762448,762467,26
8968,256,8963,762467,762723,30
1074,100,8963,762723,762823,42
1388,158,8964,762822,762980,11
5711,240,8964,762980,763220,14
2062,160,8964,763220,763380,25
3036,174,8964,763380,763554,34
7057,1,8964,763554,763555,46
3357,229,8964,763555,763784,49
3929,151,8965,763783,763934,1
8406,47,8965,763934,763981,6
5511,48,8965,763981,764029,12
4972,231,8965,764029,764260,23
8298,135,8965,764260,764395,29
2602,55,8965,764395,764450,33
5255,32,8965,764450,764482,46
2821,92,8966,764481,764573,3
4373,78,8966,764573,764651,3
4971,70,8966,764651,764721,15
2150,274,8966,764721,764995,21
1371,204,8966,764995,765199,28
7239,223,8966,765199,765422,46
1490,166,8967,765421,765587,50
2467,34,8968,765586,765620,3
7827,15,8968,765620,765635,16
4614,179,8968,765635,765814,37
6792,66,8969,765813,765879,10
2913,161,8969,765879,766040,11
1282,156,8969,766040,766196,18
9168,30,8970,766195,766225,7
4751,47,8970,766225,766272,16
5395,28,8970,766272,766300,22
3895,2,8970,766300,766302,39
5234,3,8970,766302,766305,43
4140,144,8970,766305,766449,47
1857,218,8971,766448,766666,7
9806,154,8971,766666,766820,17
3596,174,8971,766820,766994,22
5917,76,8971,766994,767070,32
1305,218,8971,767070,767288,38
6057,192,8971,767288,767480,46
4456,223,8971,767480,767703,47
1530,160,8972,767702,767862,15
4604,243,8972,767862,768105,21
6453,203,8972,768105,768308,34
4318,250,8972,768308,768558,36
7344,18,8972,768558,768576,47
2005,39,8973,768575,768614,8
3016,288,8973,1462456,1462744,8
9023,65,8973,768754,768819,11
4776,34,8973,768819,768853,13
2626,65,8973,768853,768918,42
1855,152,8973,768918,769070,50
4453,295,8974,769069,769364,3
2093,174,8974,769364,769538,5
1821,80,8974,769538,769618,23
7506,295,8974,1462600,1462895,24
9165,280,8974,769761,770041,45
6242,150,8975,770040,770190,17
8203,244,8975,770190,770434,21
7564,48,8975,770434,770482,24
4050,128,8975,770482,770610,28
2013,11,8975,770610,770621,31
6176,214,8975,770621,770835,31
4417,210,8975,770835,771045,46
5574,231,8975,771045,771276,49
5667,149,8975,771276,771425,50
1572,39,8976,771424,771463,24
4036,157,8976,771463,771620,30
2849,235,8976,771620,771855,40
8327,171,8976,771855,772026,46
2521,113,8976,772026,772139,48
6900,157,8977,772138,772295,2
6035,68,8977,772295,772363,8
5091,283,8977,772363,772646,10
3689,277,8977,772646,772923,23
3825,292,8977,772923,773215,45
6036,55,8978,773214,773269,6
7045,289,8978,773269,773558,45
7508,288,8979,773557,773845,12
2943,125,8979,773845,773970,25
6765,119,8979,773970,774089,29
9471,166,8979,774089,774255,40
3239,123,8980,774254,774377,6
1934,121,8980,774377,774498,40
3787,61,8980,774498,774559,49
5196,85,8980,774559,774644,49
2139,232,8981,774643,774875,6
3376,165,8981,774875,775040,14
4427,247,8981,775040,775287,18
2981,93,8981,775287,775380,23
8606,283,8981,1462753,1463036,33
6768,203,8981,775515,775718,49
3930,90,8982,775717,775807,13
4486,183,8982,775807,775990,18
8845,161,8982,775990,776151,23
7025,282,8982,776151,776433,43
9076,96,8983,776432,776528,11
9253,132,8983,776528,776660,22
8005,197,8983,776660,776857,37
1391,125,8983,776857,776982,45
2734,155,8984,776981,777136,11
3677,277,8984,777136,777413,16
5013,177,8984,777413,777590,18
2248,211,8984,777590,777801,25
9056,27,8984,777801,777828,30
1386,151,8984,777828,777979,39
3789,299,8985,777978,778277,12
2518,1,8985,778277,778278,28
8876,269,8986,778277,778546,10
8633,234,8986,778546,778780,43
8069,70,8987,778779,778849,17
2380,37,8987,778849,778886,36
5673,170,8987,778886,779056,43
3101,131,8988,779055,779186,1
3077,116,8988,779186,779302,2
6897,180,8988,779302,779482,5
2231,20,8988,779482,779502,11
8471,285,8988,779502,779787,13
2856,299,8988,1462889,1463188,29
8944,80,8988,779927,780007,43
4138,7,8988,780007,780014,46
2480,205,8988,780014,780219,48
6659,276,8989,780218,780494,9
1338,245,8989,780494,780739,14
6443,95,8989,780739,780834,15
5386,220,8989,780834,781054,45
6140,54,8990,781053,781107,14
6540,79,8990,781107,781186,16
7125,127,8990,781186,781313,31
8249,293,8990,1463043,1463336,42
3109,165,8991,781455,781620,5
9665,137,8991,781620,781757,11
3617,88,8991,781757,781845,22
2609,79,8992,781844,781923,31
5697,281,8992,781923,782204,36
7944,181,8993,782203,782384,8
7860,108,8993,782384,782492,23
4728,151,8993,782492,782643,35
6584,298,8993,1463186,1463484,50
4460,75,8995,782788,782863,5
6724,63,8995,782863,782926,10
2361,29,8995,782926,782955,14
2322,158,8995,782955,783113,36
1689,134,8996,783112,783246,11
9332,278,8996,783246,783524,36
5119,181,8996,783524,783705,43
3807,263,8996,783705,783968,47
3913,36,8997,783967,784003,28
9019,47,8997,784003,784050,29
7051,99,8997,784050,784149,31
4347,278,8997,784149,784427,35
1945,232,8997,784427,784659,43
4915,57,8997,784659,784716,47
8540,22,8998,784715,784737,15
4310,16,8998,784737,784753,19
2992,149,8998,784753,784902,44
3529,127,8998,784902,785029,46
4132,46,8999,785028,785074,12
3195,68,8999,785074,785142,20
6628,283,8999,1463343,1463626,22
5786,202,8999,785277,785479,30
3144,244,8999,785479,785723,33
7326,225,9000,785722,785947,3
9704,159,9000,785947,786106,6
3582,27,9000,786106,786133,16
1883,236,9000,786133,786369,27
7247,106,9000,786369,786475,27
4740,84,9000,786475,786559,29
4224,144,9001,786558,786702,14
5493,230,9001,786702,786932,14
8425,207,9001,786932,787139,27
9805,182,9002,787138,787320,3
7903,162,9002,787320,787482,4
3218,127,9002,787482,787609,8
3184,40,9002,787609,787649,11
1604,233,9002,787649,787882,14
2485,234,9002,787882,788116,22
3798,125,9002,788116,788241,40
3650,111,9002,788241,788352,49
3423,126,9003,788351,788477,14
8128,235,9003,788477,788712,38
6976,247,9004,788711,788958,8
3313,129,9004,788958,789087,20
2174,300,9004,789087,789387,21
7717,30,9004,789387,789417,39
3482,73,9005,789416,789489,12
5087,151,9005,789489,789640,15
1299,134,9005,789640,789774,17
2672,160,9005,789774,789934,27
2617,145,9005,789934,790079,34
2881,290,9005,790079,790369,38
7964,164,9005,790369,790533,43
8693,183,9005,790533,790716,48
5010,187,9006,790715,790902,43
5202,83,9007,790901,790984,1
8655,140,9007,790984,791124,13
7759,126,9007,791124,791250,14
6416,66,9007,791250,791316,18
4271,277,9008,791315,791592,4
5801,247,9008,791592,791839,9
7834,235,9008,791839,792074,32
1134,293,9008,792074,792367,36
5002,192,9008,792367,792559,37
4611,268,9008,792559,792827,39
1564,290,9009,792826,793116,21
3147,29,9009,793116,793145,24
4122,227,9009,793145,793372,34
1314,236,9009,793372,793608,42
6069,159,9010,793607,793766,31
5987,43,9010,793766,793809,36
2379,73,9011,793808,793881,2
7881,195,9011,793881,794076,3
2400,97,9011,794076,794173,5
8673,121,9011,794173,794294,10
2541,60,9011,794294,794354,28
5690,72,9011,794354,794426,38
5133,118,9012,794425,794543,13
6403,119,9012,794543,794662,39
9362,278,9013,794661,794939,6
1933,160,9013,794939,795099,13
6687,112,9013,795099,795211,16
4822,96,9013,795211,795307,20
6839,129,9013,795307,795436,21
9680,20,9013,795436,795456,25
7526,81,9013,795456,795537,29
8225,281,9013,795537,795818,38
2126,142,9013,795818,795960,44
8248,249,9014,795959,796208,14
6631,274,9014,1463476,1463750,22
1463,52,9014,796343,796395,29
6973,65,9014,796395,796460,34
4647,65,9015,796459,796524,3
8285,215,9015,796524,796739,16
6237,162,9015,796739,796901,39
7018,229,9016,796900,797129,14
2643,125,9016,797129,797254,15
8900,49,9016,797254,797303,31
4749,252,9016,797303,797555,38
7541,72,9017,797554,797626,9
1930,221,9017,797626,797847,10
6987,136,9017,797847,797983,13
4601,84,9017,797983,798067,15
8137,150,9017,798067,798217,21
2745,216,9017,798217,798433,45
8122,54,9017,798433,798487,48
4200,55,9018,798486,798541,24
1815,111,9018,798541,798652,28
8974,47,9018,798652,798699,30
5481,212,9019,798698,798910,8
5965,99,9019,798910,799009,11
3037,285,9019,799009,799294,39
7194,207,9019,799294,799501,41
8414,94,9020,799500,799594,22
7161,24,9020,799594,799618,25
1315,15,9020,799618,799633,39
2829,128,9020,799633,799761,44
8389,181,9020,799761,799942,44
1792,56,9021,799941,799997,3
1717,235,9021,799997,800232,25
8079,233,9021,800232,800465,26
2564,158,9021,800465,800623,47
9045,73,9022,800622,800695,1
8062,212,9022,800695,800907,3
9499,222,9022,800907,801129,27
5298,81,9022,801129,801210,34
8316,35,9022,801210,801245,46
6378,126,9022,801245,801371,50
5540,233,9023,801370,801603,9
5309,24,9023,801603,801627,43
9060,10,9023,801627,801637,43
5304,206,9023,801637,801843,46
1416,236,9023,801843,802079,48
4954,44,9023,802079,802123,50
7668,73,9024,802122,802195,4
5835,39,9024,802195,802234,24
6460,215,9024,802234,802449,30
2550,22,9024,802449,802471,33
2403,31,9024,802471,802502,37
4931,155,9024,802502,802657,50
5981,142,9024,802657,802799,50
1424,282,9025,802798,803080,1
9569,55,9025,803080,803135,4
8111,171,9025,803135,803306,7
9912,290,9025,803306,803596,14
8638,179,9025,803596,803775,18
6238,43,9025,803775,803818,30
4392,271,9025,803818,804089,35
7957,48,9025,804089,804137,48
9913,162,9025,804137,804299,49
7917,26,9026,804298,804324,4
6664,72,9026,804324,804396,14
5751,271,9026,804396,804667,41
9437,238,9027,804666,804904,1
8549,253,9027,804904,805157,3
1110,149,9027,805157,805306,22
1423,205,9027,805306,805511,29
8929,282,9027,805511,805793,30
8718,285,9028,1463596,1463881,8
9065,134,9028,805932,806066,16
9183,47,9028,806066,806113,19
8562,3,9028,806113,806116,24
2478,175,9028,806116,806291,40
3527,245,9028,806291,806536,47
8678,108,9028,806536,806644,47
4834,110,9029,806643,806753,6
4051,223,9029,806753,806976,19
7551,246,9030,806975,807221,8
6661,131,9030,807221,807352,15
8831,29,9031,807351,807380,7
2535,247,9031,807380,807627,29
8595,174,9032,807626,807800,1
3050,98,9032,807800,807898,7
7186,176,9032,807898,808074,16
4233,296,9032,808074,808370,31
7562,91,9033,808369,808460,29
9640,113,9033,808460,808573,37
1753,207,9033,808573,808780,48
9034,214,9034,808779,808993,10
8207,130,9034,808993,809123,14
6601,128,9034,809123,809251,28
6672,247,9034,809251,809498,28
1012,264,9034,809498,809762,45
1033,251,9035,809761,810012,34
3388,126,9035,810012,810138,48
5285,151,9036,810137,810288,23
7297,98,9036,810288,810386,34
9208,135,9037,810385,810520,32
4929,285,9038,810519,810804,1
3394,22,9038,810804,810826,4
7952,19,9038,810826,810845,19
6042,97,9038,810845,810942,27
8805,67,9038,810942,811009,37
3090,152,9038,811009,811161,38
7080,197,9038,811161,811358,38
8971,170,9038,811358,811528,44
5335,213,9038,811528,811741,45
2339,16,9039,811740,811756,4
9801,45,9039,811756,811801,12
1276,244,9039,811801,812045,37
9681,26,9039,812045,812071,42
4596,182,9040,812070,812252,4
8342,39,9040,812252,812291,5
6164,187,9040,812291,812478,10
2649,213,9040,812478,812691,11
9951,169,9040,812691,812860,25
9722,117,9040,812860,812977,28
9050,216,9040,812977,813193,35
1520,198,9040,813193,813391,48
2487,203,9041,813390,813593,9
3071,107,9041,813593,813700,12
5168,127,9041,813700,813827,17
2431,21,9041,813827,813848,27
6523,269,9041,813848,814117,47
3920,142,9042,814116,814258,12
8851,1,9042,814258,814259,14
2778,132,9042,814259,814391,17
7431,83,9042,814391,814474,21
3962,284,9043,814473,814757,24
2885,280,9043,814757,815037,38
4210,288,9043,815037,815325,39
2852,17,9043,815325,815342,48
8777,133,9044,815341,815474,6
9583,20,9044,815474,815494,8
1433,197,9044,815494,815691,11
7338,71,9044,815691,815762,19
7784,135,9044,815762,815897,34
4343,74,9044,815897,815971,39
9686,53,9045,815970,816023,2
6235,26,9045,816023,816049,27
6431,197,9045,816049,816246,29
9148,152,9046,816245,816397,8
9436,168,9046,816397,816565,16
5526,210,9046,816565,816775,27
2376,139,9046,816775,816914,32
1084,281,9046,816914,817195,37
5563,57,9046,817195,817252,41
9001,254,9047,817251,817505,3
1363,281,9047,1463722,1464003,8
7304,31,9047,817645,817676,10
2976,162,9047,817676,817838,18
3565,93,9047,817838,817931,23
8556,13,9047,817931,817944,33
2594,53,9048,817943,817996,34
5883,118,9048,817996,818114,43
9530,178,9048,818114,818292,44
8235,103,9048,818292,818395,49
7795,246,9048,818395,818641,50
8322,288,9049,818640,818928,3
2076,273,9049,818928,819201,25
7117,295,9049,1463858,1464153,28
1258,140,9049,819344,819484,30
7980,185,9050,819483,819668,49
7005,123,9050,819668,819791,50
5183,202,9051,819790,819992,12
5491,150,9051,819992,820142,18
4145,86,9051,820142,820228,19
7121,8,9051,820228,820236,23
9644,279,9051,820236,820515,25
5179,213,9051,820515,820728,28
6206,87,9051,820728,820815,33
3578,295,9051,820815,821110,40
4818,247,9051,821110,821357,49
6373,105,9052,821356,821461,6
9415,206,9052,821461,821667,8
2620,295,9052,821667,821962,13
8747,159,9052,821962,822121,20
5400,39,9052,822121,822160,40
1751,5,9052,822160,822165,45
8748,121,9053,822164,822285,5
3165,298,9053,1464002,1464300,6
4258,152,9053,822432,822584,13
3818,202,9053,822584,822786,49
5239,89,9054,822785,822874,5
9811,101,9054,822874,822975,10
6077,94,9054,822975,823069,48
4148,12,9055,823068,823080,20
3586,285,9055,823080,823365,23
1987,269,9055,823365,823634,32
8220,33,9055,823634,823667,38
6365,182,9055,823667,823849,42
9658,19,9056,823848,823867,18
3310,169,9056,823867,824036,21
7715,216,9056,824036,824252,42
8281,13,9056,824252,824265,48
5489,250,9057,824264,824514,49
8890,88,9058,824513,824601,9
5033,210,9058,824601,824811,13
4961,243,9058,824811,825054,21
3439,86,9058,825054,825140,34
6910,155,9058,825140,825295,34
8668,59,9059,825294,825353,10
3407,155,9059,825353,825508,39
1736,201,9060,825507,825708,16
1231,210,9061,825707,825917,4
6398,277,9061,1464159,1464436,19
7961,236,9061,826050,826286,27
4048,122,9061,826286,826408,41
9898,139,9061,826408,826547,42
6641,278,9061,826547,826825,43
3187,71,9061,826825,826896,44
7574,170,9062,826895,827065,23
7085,123,9062,827065,827188,49
6530,219,9063,827187,827406,7
9496,202,9063,827406,827608,12
1032,208,9063,827608,827816,27
1266,178,9064,827815,827993,2
5704,143,9064,827993,828136,10
7282,233,9064,828136,828369,11
6323,62,9064,828369,828431,15
7364,272,9064,828431,828703,16
2030,72,9064,828703,828775,41
9462,268,9064,828775,829043,45
2788,212,9065,829042,829254,2
3717,107,9065,829254,829361,19
4918,289,9065,829361,829650,40
2965,214,9066,829649,829863,13
5908,171,9066,829863,830034,39
2055,271,9067,830033,830304,7
1183,155,9067,830304,830459,16
6972,193,9067,830459,830652,23
7135,62,9067,830652,830714,23
3572,69,9067,830714,830783,50
9616,138,9068,830782,830920,3
9336,69,9068,830920,830989,26
6619,156,9068,830989,831145,28
1421,132,9068,831145,831277,32
2027,177,9068,831277,831454,47
1544,202,9069,831453,831655,14
4288,62,9069,831655,831717,27
3579,173,9069,831717,831890,39
6605,269,9070,831889,832158,10
5543,17,9070,832158,832175,29
2625,193,9070,832175,832368,31
6771,298,9071,832367,832665,10
7500,172,9071,832665,832837,15
8347,65,9071,832837,832902,45
8629,153,9071,832902,833055,47
1784,225,9072,833054,833279,14
9126,194,9072,833279,833473,16
2875,165,9072,833473,833638,20
6850,134,9072,833638,833772,28
9421,298,9072,1464282,1464580,28
2470,230,9072,833915,834145,31
7208,91,9072,834145,834236,34
7607,223,9072,834236,834459,35
3999,51,9072,834459,834510,41
4609,51,9072,834510,834561,44
9598,62,9072,834561,834623,45
8796,246,9074,834621,834867,1
2707,11,9074,834867,834878,14
7899,118,9074,834878,834996,24
3389,128,9074,834996,835124,28
8273,245,9074,835124,835369,31
7563,70,9074,835369,835439,39
3120,136,9074,835439,835575,40
7703,198,9074,835575,835773,40
4645,20,9074,835773,835793,45
5218,276,9075,835792,836068,1
8410,208,9075,836068,836276,9
5723,56,9075,836276,836332,15
2392,26,9075,836332,836358,34
3451,242,9076,836357,836599,1
9192,98,9076,836599,836697,1
2580,83,9076,836697,836780,6
7404,290,9076,1464443,1464733,19
3240,82,9076,836913,836995,34
6763,1,9076,836995,836996,50
1778,33,9077,836995,837028,4
6522,26,9077,837028,837054,5
4535,108,9077,837054,837162,7
9397,262,9077,837162,837424,20
3648,52,9077,837424,837476,21
5561,274,9078,837475,837749,3
6451,203,9078,837749,837952,13
9939,234,9078,837952,838186,29
2611,90,9079,838185,838275,2
4171,49,9080,838274,838323,16
2389,73,9080,838323,838396,41
8852,253,9080,838396,838649,47
9596,160,9080,838649,838809,50
9420,256,9081,838808,839064,16
3008,133,9081,839064,839197,30
6551,101,9081,839197,839298,38
9466,111,9081,839298,839409,41
6426,298,9082,839408,839706,3
6111,206,9082,839706,839912,18
5088,25,9082,839912,839937,24
2468,279,9082,839937,840216,40
4846,10,9083,840215,840225,28
9352,249,9083,840225,840474,36
6560,146,9083,840474,840620,37
2427,73,9083,840620,840693,46
7954,252,9084,840692,840944,2
6412,229,9084,840944,841173,45
2736,120,9085,841172,841292,5
8505,243,9085,841292,841535,5
9676,277,9085,841535,841812,5
5452,250,9085,841812,842062,20
4743,202,9085,842062,842264,23
2460,249,9085,842264,842513,30
7974,113,9085,842513,842626,43
7982,91,9085,842626,842717,44
8017,159,9086,842716,842875,25
6300,185,9086,842875,843060,27
5783,133,9086,843060,843193,39
4385,73,9086,843193,843266,48
7176,126,9087,843265,843391,30
4533,76,9087,843391,843467,41
8109,49,9088,843466,843515,1
8707,70,9088,843515,843585,16
7544,228,9088,843585,843813,27
3277,104,9088,843813,843917,33
9375,139,9088,843917,844056,35
6808,30,9089,844055,844085,2
3729,30,9089,844085,844115,10
4141,81,9089,844115,844196,18
2924,217,9089,844196,844413,25
7395,72,9089,844413,844485,28
9608,239,9089,844485,844724,35
4298,145,9090,844723,844868,8
7100,109,9090,844868,844977,18
1357,202,9090,844977,845179,28
1474,200,9090,845179,845379,43
7374,50,9091,845378,845428,1
5167,204,9091,845428,845632,5
1148,108,9091,845632,845740,27
2586,172,9091,845740,845912,32
5900,99,9091,845912,846011,33
7396,104,9091,846011,846115,39
3293,144,9091,846115,846259,45
6250,126,9092,846258,846384,4
5670,28,9092,846384,846412,5
2832,179,9092,846412,846591,9
1850,195,9092,846591,846786,29
4934,54,9092,846786,846840,44
7340,151,9093,846839,846990,3
6966,214,9093,846990,847204,12
3856,265,9093,847204,847469,24
6681,116,9093,847469,847585,38
6085,10,9093,847585,847595,41
5497,296,9093,847595,847891,43
2481,95,9093,847891,847986,48
4483,49,9093,847986,848035,49
7016,125,9094,848034,848159,10
5187,160,9094,848159,848319,12
7518,116,9094,848319,848435,19
6622,224,9094,848435,848659,35
4087,171,9094,848659,848830,45
7463,163,9095,848829,848992,8
8730,300,9095,848992,849292,17
6851,190,9096,849291,849481,5
4806,40,9096,849481,849521,40
8774,299,9096,1464564,1464863,43
6809,88,9097,849669,849757,25
2869,243,9097,849757,850000,27
6262,20,9097,850000,850020,33
4005,15,9097,850020,850035,43
6726,244,9097,850035,850279,45
2329,135,9098,850278,850413,11
6774,206,9098,850413,850619,28
9282,105,9098,850619,850724,32
9553,202,9099,850723,850925,14
8813,57,9099,850925,850982,17
6049,248,9099,850982,851230,38
8791,54,9100,851229,851283,4
4968,279,9100,851283,851562,28
8140,44,9100,851562,851606,29
3563,186,9100,851606,851792,42
3644,45,9100,851792,851837,46
1977,125,9101,851836,851961,4
9976,219,9101,851961,852180,21
2782,298,9101,1464714,1465012,25
2464,254,9102,852323,852577,5
6065,97,9102,852577,852674,28
1916,118,9102,852674,852792,38
8705,172,9102,852792,852964,42
5343,234,9103,852963,853197,6
4933,185,9103,853197,853382,15
2696,275,9103,1464877,1465152,19
4093,28,9103,853515,853543,20
2803,245,9103,853543,853788,21
8266,141,9103,853788,853929,46
9394,43,9103,853929,853972,49
9371,203,9103,853972,854175,50
3878,206,9104,854174,854380,16
4710,242,9104,854380,854622,19
9270,206,9104,854622,854828,26
8975,277,9104,854828,855105,31
2794,166,9104,855105,855271,33
6145,113,9104,855271,855384,50
1027,221,9105,855383,855604,12
8894,125,9106,855603,855728,23
1765,207,9106,855728,855935,33
8171,225,9106,855935,856160,42
6956,271,9107,856159,856430,2
5413,146,9107,856430,856576,15
7888,216,9107,856576,856792,15
4061,88,9107,856792,856880,20
3417,75,9107,856880,856955,26
9388,150,9107,856955,857105,33
7708,80,9107,857105,857185,42
7725,173,9107,857185,857358,43
9123,289,9108,1465004,1465293,24
6579,197,9108,857500,857697,30
4361,268,9108,857697,857965,31
8995,34,9108,857965,857999,31
5712,23,9108,857999,858022,43
3250,115,9109,858021,858136,6
5166,260,9109,858136,858396,24
1843,280,9109,858396,858676,34
9463,38,9109,858676,858714,35
9789,93,9109,858714,858807,37
7345,211,9109,858807,859018,39
5038,176,9109,859018,859194,42
5189,62,9110,859193,859255,8
2295,219,9110,859255,859474,19
1197,114,9110,859474,859588,22
9289,36,9110,859588,859624,26
9772,283,9111,859623,859906,7
4732,109,9111,859906,860015,23
1004,231,9111,860015,860246,47
3914,106,9112,860245,860351,18
5623,92,9112,860351,860443,18
6488,260,9112,860443,860703,28
5105,5,9112,860703,860708,37
9919,274,9112,860708,860982,46
7315,242,9112,860982,861224,49
3300,124,9113,861223,861347,5
2847,166,9113,861347,861513,23
2998,122,9113,861513,861635,37
8175,229,9113,861635,861864,38
3670,12,9115,861862,861874,2
3641,158,9116,861873,862031,1
9036,249,9116,862031,862280,48
4085,232,9117,862279,862511,5
5739,291,9117,1465143,1465434,9
7043,266,9117,862652,862918,9
2187,123,9117,862918,863041,38
2060,227,9117,863041,863268,43
5092,249,9117,863268,863517,45
8311,248,9118,863516,863764,14
2721,296,9118,863764,864060,17
1974,121,9118,864060,864181,31
2282,10,9118,864181,864191,37
6942,269,9118,864191,864460,49
6974,46,9119,864459,864505,2
9653,89,9119,864505,864594,17
6538,18,9119,864594,864612,19
5288,174,9119,864612,864786,25
4705,47,9119,864786,864833,39
3674,101,9120,864832,864933,16
5455,275,9121,864932,865207,1
6479,241,9121,865207,865448,4
4966,266,9121,865448,865714,40
2691,154,9122,865713,865867,7
6156,152,9122,865867,866019,14
2313,252,9122,866019,866271,36
3998,157,9122,866271,866428,45
7501,192,9123,866427,866619,7
8565,195,9123,866619,866814,20
2430,34,9123,866814,866848,22
7402,287,9123,1465285,1465572,46
7869,233,9124,866990,867223,21
8838,164,9124,867223,867387,21
5274,230,9124,867387,867617,28
2667,140,9125,867616,867756,10
5909,205,9125,867756,867961,16
7258,201,9125,867961,868162,33
6298,66,9125,868162,868228,35
7729,91,9125,868228,868319,39
2442,121,9125,868319,868440,43
9632,264,9126,868439,868703,5
1056,157,9126,868703,868860,24
7764,88,9126,868860,868948,37
9095,88,9126,868948,869036,46
9330,97,9127,869035,869132,1
8989,285,9127,869132,869417,21
2180,283,9127,869417,869700,40
7720,299,9128,869699,869998,14
5337,16,9128,869998,870014,25
1639,147,9128,870014,870161,30
2220,295,9129,870160,870455,13
9905,178,9129,870455,870633,32
3176,84,9129,870633,870717,38
3730,171,9130,870716,870887,14
9881,179,9130,870887,871066,33
2902,260,9130,871066,871326,43
3937,93,9131,871325,871418,9
5290,295,9131,871418,871713,20
3496,112,9131,871713,871825,25
2554,279,9131,871825,872104,28
2453,19,9131,872104,872123,31
7289,155,9132,872122,872277,1
4082,170,9132,872277,872447,2
4853,275,9132,872447,872722,6
6274,288,9132,1465428,1465716,22
3593,260,9132,872857,873117,32
8032,217,9133,873116,873333,16
7960,22,9134,873332,873354,17
3301,129,9134,873354,873483,19
9057,2,9134,873483,873485,24
3001,25,9134,873485,873510,25
2234,258,9134,873510,873768,26
2763,59,9134,873768,873827,42
1255,208,9134,873827,874035,49
8141,181,9135,874034,874215,3
3799,226,9135,874215,874441,6
2558,236,9135,874441,874677,21
3285,248,9135,874677,874925,33
2692,262,9135,874925,875187,38
4299,185,9135,875187,875372,41
8121,286,9136,875371,875657,4
4769,46,9136,875657,875703,9
6210,59,9136,875703,875762,9
5474,201,9136,875762,875963,12
2280,222,9136,875963,876185,16
8720,114,9136,876185,876299,40
4634,206,9136,876299,876505,42
9546,292,9137,876504,876796,3
4898,260,9137,876796,877056,7
6006,197,9137,877056,877253,16
9053,206,9138,877252,877458,4
2850,120,9138,877458,877578,8
2196,9,9138,877578,877587,9
1546,3,9138,877587,877590,11
8783,242,9138,877590,877832,13
1277,203,9138,877832,878035,22
2873,244,9138,878035,878279,29
1980,193,9138,878279,878472,35
2294,293,9138,878472,878765,41
3743,154,9138,878765,878919,42
8713,242,9138,878919,879161,50
1961,128,9139,879160,879288,10
4011,292,9139,879288,879580,12
2095,122,9139,879580,879702,17
1065,20,9139,879702,879722,21
2970,215,9139,879722,879937,23
4622,226,9139,879937,880163,36
1829,292,9140,880162,880454,2
1899,35,9140,880454,880489,5
6343,195,9140,880489,880684,5
5217,75,9140,880684,880759,38
9876,255,9140,880759,881014,41
9957,219,9140,881014,881233,43
4713,279,9141,881232,881511,30
9291,271,9141,881511,881782,42
3019,69,9141,881782,881851,44
4068,29,9141,881851,881880,44
5806,125,9141,881880,882005,48
1937,192,9141,882005,882197,49
4584,127,9141,882197,882324,50
9610,93,9142,882323,882416,17
4550,177,9142,882416,882593,28
9857,108,9142,882593,882701,30
1430,182,9142,882701,882883,37
1923,3,9142,882883,882886,41
8468,167,9142,882886,883053,44
5459,62,9143,883052,883114,1
5342,163,9143,883114,883277,14
9917,37,9143,883277,883314,49
8802,180,9144,883313,883493,8
1685,291,9144,883493,883784,14
6858,161,9145,883783,883944,33
1146,125,9146,883943,884068,10
7774,93,9146,884068,884161,30
5431,187,9147,884160,884347,25
9758,150,9147,884347,884497,35
3427,264,9147,884497,884761,43
4045,202,9148,884760,884962,1
3045,5,9148,884962,884967,5
8501,129,9148,884967,885096,21
5873,131,9148,885096,885227,30
8259,242,9149,885226,885468,17
8795,56,9149,885468,885524,17
6747,278,9149,885524,885802,20
8690,116,9149,885802,885918,21
4621,8,9149,885918,885926,28
5979,60,9149,885926,885986,30
7713,295,9149,1465556,1465851,46
5820,15,9149,886129,886144,49
1037,40,9150,886143,886183,4
6994,160,9150,886183,886343,13
6020,59,9150,886343,886402,16
9355,283,9150,886402,886685,38
8080,227,9151,886684,886911,1
1180,73,9151,886911,886984,13
4407,108,9151,886984,887092,18
3345,20,9151,887092,887112,19
6162,226,9151,887112,887338,20
7316,32,9151,887338,887370,21
4279,249,9151,887370,887619,35
4430,151,9152,887618,887769,25
1348,65,9152,887769,887834,36
5805,255,9152,887834,888089,50
7366,272,9153,888088,888360,11
1529,237,9153,888360,888597,13
1325,101,9153,888597,888698,15
3865,5,9153,888698,888703,22
6289,289,9153,1465712,1466001,22
4798,78,9153,888838,888916,45
5412,223,9153,888916,889139,48
9672,49,9154,889138,889187,13
2360,292,9154,889187,889479,31
1787,243,9155,889478,889721,3
1191,285,9155,889721,890006,42
4130,54,9155,890006,890060,42
7099,268,9156,890059,890327,14
4420,71,9156,890327,890398,23
3757,11,9156,890398,890409,26
2355,274,9156,890409,890683,30
8442,296,9157,890682,890978,14
5877,291,9157,890978,891269,30
7355,177,9157,891269,891446,36
9756,220,9157,891446,891666,36
5467,164,9158,891665,891829,7
9272,181,9158,891829,892010,26
9697,119,9158,892010,892129,27
4965,258,9158,892129,892387,41
9113,271,9159,1465860,1466131,33
1157,64,9159,892521,892585,39
2483,53,9160,892584,892637,15
5004,142,9160,892637,892779,26
2316,24,9161,892778,892802,5
1016,90,9161,892802,892892,15
5529,236,9161,892892,893128,16
6255,107,9161,893128,893235,16
5499,144,9161,893235,893379,34
1345,54,9161,893379,893433,38
9645,254,9161,893433,893687,38
6725,121,9161,893687,893808,48
3923,250,9162,893807,894057,3
9712,16,9162,894057,894073,16
9888,172,9162,894073,894245,18
9041,40,9162,894245,894285,37
2328,165,9162,894285,894450,45
7173,27,9162,894450,894477,47
1408,199,9162,894477,894676,50
5545,130,9163,894675,894805,3
3532,222,9163,894805,895027,22
4472,40,9163,895027,895067,36
9446,263,9163,895067,895330,41
5283,38,9163,895330,895368,45
3672,175,9164,895367,895542,27
1170,173,9164,895542,895715,43
6528,129,9165,895714,895843,20
5297,299,9165,895843,896142,37
8448,100,9166,896141,896241,6
8984,1,9166,896241,896242,19
4589,242,9166,896242,896484,24
9886,120,9166,896484,896604,25
5326,175,9166,896604,896779,29
1125,266,9166,896779,897045,34
5454,127,9166,897045,897172,46
7769,200,9167,897171,897371,10
3658,140,9167,897371,897511,15
2175,213,9167,897511,897724,47
5644,176,9167,897724,897900,48
3419,138,9167,897900,898038,49
6600,142,9168,898037,898179,17
4692,268,9168,898179,898447,28
6829,82,9168,898447,898529,33
3175,246,9168,898529,898775,40
9839,65,9169,898774,898839,7
1740,193,9169,898839,899032,20
5256,49,9169,899032,899081,39
1825,271,9169,899081,899352,47
7221,20,9170,899351,899371,6
9940,169,9170,899371,899540,9
8789,279,9170,899540,899819,13
5566,218,9170,899819,900037,28
7765,248,9171,900036,900284,4
5515,111,9171,900284,900395,33
9485,65,9171,900395,900460,34
7089,154,9171,900460,900614,42
5934,192,9171,900614,900806,50
6844,65,9171,900806,900871,50
6234,254,9173,900869,901123,4
2536,231,9173,901123,901354,24
2106,283,9173,901354,901637,34
6804,81,9173,901637,901718,37
7649,194,9174,901717,901911,7
2731,17,9174,901911,901928,8
8771,210,9174,901928,902138,44
3821,223,9175,902137,902360,38
9162,245,9175,902360,902605,49
3360,113,9176,902604,902717,5
7918,118,9176,902717,902835,12
9493,37,9176,902835,902872,42
2956,87,9177,902871,902958,9
7978,62,9177,902958,903020,21
5955,226,9177,903020,903246,34
5812,183,9178,903245,903428,38
9924,46,9179,903427,903473,17
5620,169,9179,903473,903642,20
4152,291,9179,1465968,1466259,24
7833,11,9179,903785,903796,32
5553,192,9179,903796,903988,38
9226,144,9180,903987,904131,11
6346,189,9180,904131,904320,33
1728,218,9180,904320,904538,38
6348,177,9180,904538,904715,47
3339,154,9181,904714,904868,1
5663,148,9182,904867,905015,3
9024,76,9182,905015,905091,3
4301,256,9182,905091,905347,9
9216,130,9182,905347,905477,12
8973,96,9182,905477,905573,21
4512,64,9182,905573,905637,29
9211,63,9182,905637,905700,31
2148,210,9182,905700,905910,32
2681,218,9182,905910,906128,34
4534,290,9182,906128,906418,34
2363,134,9182,906418,906552,41
8571,72,9182,906552,906624,44
3104,69,9182,906624,906693,46
5368,68,9183,906692,906760,21
6602,40,9183,906760,906800,25
8415,32,9183,906800,906832,26
9306,115,9183,906832,906947,43
1763,153,9184,906946,907099,2
9051,84,9184,907099,907183,7
7306,178,9184,907183,907361,46
7678,93,9185,907360,907453,5
1380,17,9185,907453,907470,7
9141,198,9185,907470,907668,8
8536,78,9185,907668,907746,39
1320,213,9185,907746,907959,43
9301,99,9185,907959,908058,43
2817,106,9185,908058,908164,44
1184,289,9185,1466110,1466399,46
2530,37,9186,908306,908343,8
2393,98,9186,908343,908441,17
3548,88,9186,908441,908529,19
6570,107,9186,908529,908636,25
9738,28,9186,908636,908664,38
1831,272,9186,908664,908936,39
5292,298,9186,1466255,1466553,42
1267,114,9187,909078,909192,3
8570,292,9187,909192,909484,3
5679,183,9187,909484,909667,14
1352,283,9187,909667,909950,18
5790,204,9187,909950,910154,20
4892,36,9187,910154,910190,24
4676,66,9187,910190,910256,29
3072,163,9187,910256,910419,38
7461,71,9187,910419,910490,40
2633,214,9188,910489,910703,3
7731,170,9188,910703,910873,3
6470,136,9188,910873,911009,8
7267,184,9188,911009,911193,40
9621,228,9189,911192,911420,16
2465,25,9189,911420,911445,22
6914,60,9189,911445,911505,34
3852,250,9189,911505,911755,41
2988,40,9190,911754,911794,40
9154,48,9191,911793,911841,13
9027,156,9191,911841,911997,16
3354,227,9191,911997,912224,27
2336,81,9191,912224,912305,34
3759,159,9191,912305,912464,41
3055,114,9191,912464,912578,47
6173,138,9192,912577,912715,7
3438,18,9192,912715,912733,8
9823,185,9192,912733,912918,15
6723,11,9192,912918,912929,21
6580,127,9192,912929,913056,29
2967,72,9193,913055,913127,5
5964,205,9193,913127,913332,24
9122,99,9194,913331,913430,8
5583,232,9194,913430,913662,10
4010,210,9194,913662,913872,16
9536,112,9194,913872,913984,28
5032,55,9194,913984,914039,29
3620,195,9194,914039,914234,33
7922,227,9194,914234,914461,35
5870,31,9195,914460,914491,35
3649,154,9196,914490,914644,6
1607,156,9196,914644,914800,12
4406,107,9196,914800,914907,38
5067,79,9196,914907,914986,39
2712,214,9196,914986,915200,41
6737,163,9196,915200,915363,47
5779,193,9197,915362,915555,1
8765,124,9197,915555,915679,16
2177,240,9197,915679,915919,19
6308,252,9197,915919,916171,23
2469,210,9197,916171,916381,27
9852,279,9197,916381,916660,28
9841,218,9197,916660,916878,29
5630,17,9197,916878,916895,42
3241,157,9198,916894,917051,9
6028,144,9198,917051,917195,11
9150,107,9198,917195,917302,16
8915,72,9198,917302,917374,34
6916,140,9198,917374,917514,43
7367,95,9198,917514,917609,47
4950,215,9199,917608,917823,6
9039,162,9199,917823,917985,32
1102,271,9199,917985,918256,45
7675,68,9200,918255,918323,11
7139,45,9200,918323,918368,21
9189,190,9200,918368,918558,25
1447,29,9200,918558,918587,27
6598,206,9200,918587,918793,32
2922,52,9201,918792,918844,7
3126,17,9201,918844,918861,15
8329,145,9201,918861,919006,16
9490,268,9201,919006,919274,16
4525,24,9201,919274,919298,22
9643,25,9201,919298,919323,40
7236,219,9202,919322,919541,13
2668,102,9202,919541,919643,20
8820,189,9202,919643,919832,36
5912,76,9202,919832,919908,47
8440,109,9202,919908,920017,50
1250,146,9203,920016,920162,28
9184,123,9203,920162,920285,29
4503,147,9203,920285,920432,48
6018,43,9204,920431,920474,7
2202,230,9204,920474,920704,19
6268,185,9204,920704,920889,22
8490,136,9204,920889,921025,24
5733,261,9204,921025,921286,27
8411,50,9204,921286,921336,30
4133,135,9204,921336,921471,32
6385,201,9204,921471,921672,34
8344,184,9204,921672,921856,45
8474,259,9205,921855,922114,9
6594,244,9205,922114,922358,36
5212,110,9205,922358,922468,47
7669,107,9206,922467,922574,10
2785,264,9206,922574,922838,16
7170,103,9206,922838,922941,38
7933,53,9207,922940,922993,27
8829,280,9207,922993,923273,31
7148,43,9207,923273,923316,32
9813,183,9207,923316,923499,41
5502,273,9208,923498,923771,1
5716,79,9208,923771,923850,5
9447,97,9208,923850,923947,7
5992,201,9208,923947,924148,22
8081,194,9208,924148,924342,32
6995,205,9208,924342,924547,37
3883,300,9208,1466383,1466683,44
4143,105,9208,924695,924800,44
6503,13,9209,924799,924812,2
3445,81,9209,924812,924893,4
4980,262,9209,924893,925155,4
1683,157,9209,925155,925312,20
2183,281,9209,925312,925593,30
9245,248,9209,925593,925841,34
7743,191,9209,925841,926032,46
1594,59,9210,926031,926090,2
5685,68,9210,926090,926158,20
7992,262,9210,926158,926420,22
5857,233,9210,926420,926653,29
6369,27,9210,926653,926680,29
3916,178,9210,926680,926858,35
2861,143,9210,926858,927001,42
5377,147,9211,927000,927147,3
2526,131,9211,927147,927278,7
4823,227,9211,927278,927505,11
9683,192,9211,927505,927697,16
9698,257,9211,927697,927954,20
7091,284,9211,1466545,1466829,22
3208,50,9211,928089,928139,33
6265,23,9211,928139,928162,39
2834,210,9211,928162,928372,50
3708,210,9211,928372,928582,50
5952,54,9212,928581,928635,7
9239,74,9212,928635,928709,8
6615,253,9212,928709,928962,12
2724,126,9212,928962,929088,44
2820,186,9212,929088,929274,48
5095,58,9213,929273,929331,25
5469,229,9213,929331,929560,26
3573,161,9213,929560,929721,36
1209,130,9213,929721,929851,43
1464,169,9214,929850,930019,3
9850,212,9214,930019,930231,3
1117,54,9214,930231,930285,24
7478,195,9214,930285,930480,42
7138,121,9215,930479,930600,5
8328,284,9215,930600,930884,16
1556,91,9215,930884,930975,26
8797,112,9215,930975,931087,36
2937,252,9215,931087,931339,45
6903,19,9216,931338,931357,29
4504,109,9216,931357,931466,32
3484,193,9216,931466,931659,46
9896,258,9217,931658,931916,12
4411,9,9217,931916,931925,31
1876,245,9217,931925,932170,32
7006,188,9217,932170,932358,45
5316,83,9218,932357,932440,5
5048,283,9218,932440,932723,28
4815,116,9218,932723,932839,43
9166,82,9219,932838,932920,12
5656,74,9219,932920,932994,15
9478,77,9219,932994,933071,22
2191,12,9219,933071,933083,24
7270,54,9219,933083,933137,34
8020,161,9219,933137,933298,46
6877,289,9220,933297,933586,1
5748,277,9221,933585,933862,13
6407,267,9221,1466686,1466953,19
1370,201,9221,933995,934196,33
8620,6,9221,934196,934202,37
7530,71,9221,934202,934273,43
4816,293,9221,934273,934566,48
8310,64,9222,934565,934629,10
7990,183,9222,934629,934812,14
8642,72,9222,934812,934884,18
1869,73,9222,934884,934957,22
9927,200,9222,934957,935157,29
6048,21,9222,935157,935178,30
6578,17,9222,935178,935195,30
2705,240,9222,935195,935435,39
1261,252,9222,935435,935687,50
4042,192,9223,935686,935878,18
4459,126,9223,935878,936004,27
4433,9,9223,936004,936013,33
6958,195,9223,936013,936208,46
6411,72,9223,936208,936280,50
3080,118,9224,936279,936397,2
1087,116,9224,936397,936513,14
5329,64,9224,936513,936577,28
3379,294,9224,1466807,1467101,42
6392,278,9225,936719,936997,14
7753,36,9225,936997,937033,21
6296,136,9226,937032,937168,31
6728,272,9226,937168,937440,38
2498,172,9226,937440,937612,40
7816,167,9226,937612,937779,41
6483,46,9227,937778,937824,22
4306,283,9228,937823,938106,6
2699,261,9228,938106,938367,15
6019,271,9228,938367,938638,15
9229,278,9228,938638,938916,21
7123,59,9228,938916,938975,24
3307,228,9228,938975,939203,27
9714,254,9228,939203,939457,28
1401,288,9228,939457,939745,41
8981,167,9229,939744,939911,1
5985,201,9229,939911,940112,21
6067,97,9229,940112,940209,28
6366,19,9229,940209,940228,44
9299,36,9229,940228,940264,45
7996,192,9230,940263,940455,2
1526,206,9230,940455,940661,3
5240,242,9230,940661,940903,9
5999,72,9230,940903,940975,13
2884,290,9230,1466955,1467245,29
1547,126,9230,941115,941241,44
7962,117,9230,941241,941358,44
7435,58,9231,941357,941415,6
1156,118,9231,941415,941533,13
5372,192,9231,941533,941725,20
1412,155,9231,941725,941880,25
3137,63,9231,941880,941943,42
4699,41,9232,941942,941983,27
5101,102,9232,941983,942085,38
4863,92,9232,942085,942177,50
7873,6,9233,942176,942182,15
2704,56,9233,942182,942238,19
6376,237,9233,942238,942475,32
3763,277,9233,942475,942752,37
6695,299,9234,1467096,1467395,4
3590,157,9234,942896,943053,34
5885,196,9235,943052,943248,2
4753,50,9235,943248,943298,12
6477,59,9235,943298,943357,22
9862,176,9235,943357,943533,23
6500,66,9235,943533,943599,24
9673,111,9235,943599,943710,32
3813,1,9235,943710,943711,43
4641,180,9236,943710,943890,17
3266,94,9236,943890,943984,19
8130,63,9236,943984,944047,22
3858,102,9236,944047,944149,43
4334,295,9236,944149,944444,45
6202,2,9236,944444,944446,45
2894,96,9236,944446,944542,47
6738,137,9237,944541,944678,3
3673,181,9237,944678,944859,6
7928,281,9237,944859,945140,6
4691,167,9237,945140,945307,10
5823,31,9237,945307,945338,15
9695,284,9237,945338,945622,26
8493,167,9237,945622,945789,34
9581,133,9237,945789,945922,45
5332,265,9238,945921,946186,10
7166,280,9239,946185,946465,15
4445,185,9239,946465,946650,22
4158,4,9240,946649,946653,1
6167,224,9240,946653,946877,5
9993,57,9240,946877,946934,30
9359,281,9240,946934,947215,39
1662,45,9240,947215,947260,45
3702,156,9241,947259,947415,8
4124,24,9241,947415,947439,11
5860,50,9241,947439,947489,14
2349,149,9241,947489,947638,29
1262,186,9241,947638,947824,34
5622,75,9242,947823,947898,3
8083,192,9242,947898,948090,9
6712,128,9242,948090,948218,16
8054,84,9242,948218,948302,49
3403,72,9242,948302,948374,50
4660,228,9243,948373,948601,11
3092,170,9243,948601,948771,22
4642,131,9243,948771,948902,39
3754,178,9243,948902,949080,41
7639,34,9243,949080,949114,47
7803,60,9244,949113,949173,4
4693,295,9244,949173,949468,31
6397,293,9245,949467,949760,10
3845,220,9245,949760,949980,23
1545,76,9245,949980,950056,35
5651,178,9245,950056,950234,42
3264,184,9245,950234,950418,50
8354,123,9246,950417,950540,25
6052,49,9246,950540,950589,28
4102,260,9247,950588,950848,10
5494,191,9247,950848,951039,21
8856,249,9247,951039,951288,31
7457,214,9247,951288,951502,35
9965,48,9247,951502,951550,37
5982,170,9247,951550,951720,41
1175,131,9247,951720,951851,47
2663,36,9247,951851,951887,49
6105,40,9248,951886,951926,21
6888,115,9248,951926,952041,36
3583,55,9249,952040,952095,22
2215,297,9249,952095,952392,34
9068,170,9250,952391,952561,4
3038,259,9250,952561,952820,17
3860,262,9250,952820,953082,20
9267,70,9250,953082,953152,28
2041,67,9250,953152,953219,32
9262,122,9250,953219,953341,33
4787,174,9250,953341,953515,45
1875,36,9251,953514,953550,3
9573,295,9251,953550,953845,13
7175,213,9252,953844,954057,6
1301,155,9252,954057,954212,12
2630,254,9252,954212,954466,18
6304,144,9252,954466,954610,19
1469,66,9252,954610,954676,20
3442,186,9252,954676,954862,35
2693,268,9252,954862,955130,41
5126,29,9253,955129,955158,8
5188,214,9253,955158,955372,8
2110,206,9253,955372,955578,13
7026,89,9253,955578,955667,18
7024,289,9253,1467241,1467530,22
1718,277,9253,955802,956079,27
8215,276,9253,956079,956355,31
2713,166,9253,956355,956521,36
1445,266,9254,956520,956786,34
5936,123,9254,956786,956909,35
5899,195,9254,956909,957104,41
4175,231,9255,957103,957334,16
6894,98,9255,957334,957432,17
6617,294,9255,957432,957726,47
6487,104,9256,957725,957829,15
8527,186,9256,957829,958015,19
1924,255,9256,958015,958270,26
4598,125,9257,958269,958394,3
6593,284,9257,958394,958678,14
3209,11,9257,958678,958689,23
4662,50,9257,958689,958739,28
2092,212,9257,958739,958951,39
6246,27,9257,958951,958978,46
7049,29,9257,958978,959007,47
8397,58,9258,959006,959064,13
6565,14,9258,959064,959078,19
4909,156,9258,959078,959234,21
3862,241,9258,959234,959475,36
5376,14,9259,959474,959488,14
3382,144,9259,959488,959632,45
9140,180,9260,959631,959811,7
1678,206,9260,959811,960017,10
5990,124,9261,960016,960140,5
3237,175,9261,960140,960315,8
8506,172,9261,960315,960487,23
6395,143,9261,960487,960630,30
6213,147,9261,960630,960777,31
1332,175,9261,960777,960952,32
7695,199,9261,960952,961151,43
7663,36,9262,961150,961186,3
2229,86,9262,961186,961272,22
3308,64,9262,961272,961336,35
2300,222,9263,961335,961557,46
6469,122,9263,961557,961679,46
5976,41,9264,961678,961719,8
8165,67,9264,961719,961786,9
6655,13,9264,961786,961799,12
4672,300,9264,1467375,1467675,15
1446,123,9264,961943,962066,22
8891,32,9264,962066,962098,35
2454,292,9265,962097,962389,39
9986,116,9265,962389,962505,48
8027,7,9266,962504,962511,22
6788,212,9266,962511,962723,36
6800,181,9266,962723,962904,36
9531,10,9267,962903,962913,6
7088,131,9267,962913,963044,16
2172,120,9267,963044,963164,43
4581,224,9267,963164,963388,48
1620,152,9268,963387,963539,13
9026,9,9268,963539,963548,33
5852,2,9268,963548,963550,44
7741,65,9269,963549,963614,14
8588,178,9269,963614,963792,21
6537,197,9269,963792,963989,24
2216,13,9269,963989,964002,40
1099,136,9270,964001,964137,9
5418,227,9270,964137,964364,10
3361,172,9270,964364,964536,30
6886,241,9271,964535,964776,2
6284,82,9271,964776,964858,8
6489,63,9271,964858,964921,21
3791,261,9271,964921,965182,28
4402,110,9271,965182,965292,32
7212,62,9271,965292,965354,46
3096,187,9272,965353,965540,32
4450,27,9272,965540,965567,39
5302,139,9272,965567,965706,44
9757,3,9273,965705,965708,2
6777,56,9273,965708,965764,7
3682,283,9273,965764,966047,12
9594,108,9273,966047,966155,25
2808,70,9274,966154,966224,7
5980,262,9274,966224,966486,11
7863,94,9274,966486,966580,11
4978,159,9274,966580,966739,19
2291,250,9274,966739,966989,39
1403,213,9274,966989,967202,50
6347,68,9275,967201,967269,1
8828,86,9275,967269,967355,8
6666,104,9275,967355,967459,24
9224,258,9275,967459,967717,25
9489,9,9275,967717,967726,28
3174,226,9275,967726,967952,48
9687,201,9275,967952,968153,49
2111,12,9276,968152,968164,19
4785,149,9276,968164,968313,27
4817,133,9276,968313,968446,37
9300,277,9276,968446,968723,44
7044,211,9276,968723,968934,48
9201,298,9277,968933,969231,35
8946,143,9277,969231,969374,38
4289,234,9278,969373,969607,1
5209,213,9278,969607,969820,5
1172,135,9278,969820,969955,6
5945,5,9278,969955,969960,12
4566,195,9278,969960,970155,14
7032,300,9278,1467517,1467817,32
3982,168,9278,970299,970467,40
1046,228,9278,970467,970695,42
5588,180,9279,970694,970874,16
1789,98,9279,970874,970972,20
8481,255,9279,970972,971227,49
5450,115,9280,971226,971341,9
6899,161,9280,971341,971502,33
8716,255,9280,971502,971757,33
8124,292,9280,971757,972049,35
1435,175,9280,972049,972224,44
2866,232,9281,972223,972455,23
8517,130,9281,972455,972585,23
2372,9,9281,972585,972594,40
6155,149,9281,972594,972743,44
5082,276,9281,972743,973019,45
6291,2,9281,973019,973021,49
5776,22,9282,973020,973042,17
6330,75,9282,973042,973117,23
7442,211,9282,973117,973328,35
7994,2,9282,973328,973330,35
9767,287,9282,973330,973617,41
3366,86,9282,973617,973703,45
8970,51,9283,973702,973753,5
9003,2,9283,973753,973755,12
3932,59,9283,973755,973814,32
3507,109,9283,973814,973923,36
6630,28,9283,973923,973951,46
6678,190,9283,973951,974141,47
2399,166,9284,974140,974306,4
4890,127,9284,974306,974433,10
1505,155,9284,974433,974588,21
3272,161,9285,974587,974748,25
5599,263,9286,974747,975010,29
5724,33,9287,975009,975042,8
5184,53,9287,975042,975095,9
4159,123,9287,975095,975218,10
6961,22,9287,975218,975240,30
7237,46,9287,975240,975286,32
5933,49,9287,975286,975335,38
1791,266,9287,975335,975601,43
3481,16,9287,975601,975617,45
4560,197,9287,975617,975814,47
3519,63,9288,975813,975876,20
1107,146,9289,975875,976021,4
6287,67,9289,976021,976088,19
1713,265,9289,976088,976353,21
6714,176,9289,976353,976529,35
9818,76,9289,976529,976605,38
3833,241,9289,976605,976846,48
4121,215,9290,976845,977060,36
1910,282,9290,977060,977342,38
7793,135,9290,977342,977477,40
2384,125,9290,977477,977602,45
8214,224,9291,977601,977825,5
3375,172,9291,977825,977997,12
3874,134,9291,977997,978131,23
4262,114,9291,978131,978245,32
4831,210,9291,978245,978455,39
1304,105,9291,978455,978560,46
4470,158,9291,978560,978718,48
3454,225,9292,978717,978942,4
5219,12,9292,978942,978954,7
9825,254,9292,978954,979208,17
7352,267,9292,979208,979475,22
7400,252,9292,979475,979727,23
2741,248,9292,979727,979975,27
4866,233,9292,979975,980208,27
8292,265,9292,980208,980473,32
8637,59,9292,980473,980532,36
5824,164,9293,980531,980695,20
7389,262,9293,980695,980957,20
5349,107,9293,980957,981064,40
1297,191,9293,981064,981255,44
8025,254,9294,981254,981508,12
9092,224,9294,981508,981732,15
9323,160,9294,981732,981892,26
7796,55,9294,981892,981947,42
8895,220,9295,981946,982166,10
6536,40,9295,982166,982206,12
1575,118,9295,982206,982324,18
2402,90,9295,982324,982414,27
1615,58,9295,982414,982472,30
8888,293,9295,982472,982765,34
6396,159,9295,982765,982924,49
5649,147,9296,982923,983070,22
9261,105,9296,983070,983175,22
4396,283,9296,983175,983458,23
2266,68,9296,983458,983526,37
3334,67,9296,983526,983593,50
4192,248,9297,983592,983840,9
3221,260,9297,983840,984100,10
5121,252,9297,984100,984352,26
2843,81,9297,984352,984433,28
3983,294,9297,984433,984727,30
3348,228,9297,984727,984955,36
7815,215,9297,984955,985170,44
4974,216,9297,985170,985386,48
2806,49,9298,985385,985434,5
1162,209,9298,985434,985643,17
5215,274,9298,985643,985917,39
1236,77,9298,985917,985994,49
5573,158,9298,985994,986152,50
6050,61,9299,986151,986212,3
8129,223,9299,986212,986435,7
3263,250,9299,986435,986685,40
5185,10,9299,986685,986695,43
1906,201,9299,986695,986896,44
8177,41,9300,986895,986936,3
8581,289,9300,1467654,1467943,9
8923,89,9300,987077,987166,12
1417,166,9300,987166,987332,16
3922,281,9300,987332,987613,20
5458,17,9301,987612,987629,22
5781,296,9301,987629,987925,36
1358,195,9302,987924,988119,1
5077,298,9302,988119,988417,11
1603,214,9302,988417,988631,16
2046,39,9302,988631,988670,17
3289,132,9302,988670,988802,25
9799,40,9303,988801,988841,24
6920,252,9303,988841,989093,31
3303,290,9303,1467796,1468086,32
3180,187,9303,989237,989424,39
9125,105,9304,989423,989528,18
4989,115,9304,989528,989643,22
9048,199,9304,989643,989842,25
7290,198,9304,989842,990040,37
2898,174,9305,990039,990213,14
4308,80,9306,990212,990292,47
8232,97,9307,990291,990388,6
3068,197,9307,990388,990585,28
5165,134,9307,990585,990719,28
9069,176,9307,990719,990895,33
2652,213,9307,990895,991108,37
1274,280,9307,991108,991388,39
1711,86,9308,991387,991473,15
5680,127,9308,991473,991600,15
7242,172,9308,991600,991772,15
6432,34,9308,991772,991806,29
1161,141,9309,991805,991946,3
4154,279,9309,991946,992225,5
3634,190,9309,992225,992415,8
9963,54,9309,992415,992469,22
2199,249,9309,992469,992718,34
8836,84,9309,992718,992802,34
8677,98,9309,992802,992900,43
8679,156,9309,992900,993056,46
2011,76,9309,993056,993132,48
8098,292,9310,993131,993423,1
8914,278,9310,993423,993701,1
2256,152,9310,993701,993853,24
7864,150,9310,993853,994003,29
7017,201,9311,994002,994203,3
2333,59,9311,994203,994262,5
8150,239,9311,994262,994501,32
1106,171,9311,994501,994672,35
3217,178,9311,994672,994850,39
4208,272,9312,994849,995121,15
7144,274,9312,995121,995395,15
3182,131,9312,995395,995526,16
7384,65,9312,995526,995591,18
9274,291,9312,1467934,1468225,28
6880,205,9313,995733,995938,20
2462,164,9313,995938,996102,43
5331,33,9313,996102,996135,48
9444,50,9314,996134,996184,1
9265,36,9314,996184,996220,23
4618,172,9314,996220,996392,27
5301,110,9314,996392,996502,33
4629,12,9314,996502,996514,46
9555,154,9315,996513,996667,7
1986,144,9315,996667,996811,24
2236,264,9315,996811,997075,30
3342,243,9315,997075,997318,32
8010,44,9315,997318,997362,50
5853,248,9316,997361,997609,6
4300,76,9316,997609,997685,7
2409,11,9316,997685,997696,19
3679,186,9316,997696,997882,29
1851,192,9316,997882,998074,32
5125,137,9316,998074,998211,33
7565,227,9317,998210,998437,10
2669,101,9317,998437,998538,14
4284,143,9317,998538,998681,39
4908,251,9317,998681,998932,46
8910,222,9318,998931,999153,4
4661,4,9318,999153,999157,6
8091,266,9318,999157,999423,21
6791,202,9318,999423,999625,23
6380,156,9318,999625,999781,29
9539,31,9318,999781,999812,33
3951,252,9318,999812,1000064,35
3942,132,9318,1000064,1000196,42
2684,88,9318,1000196,1000284,48
1279,104,9319,1000283,1000387,4
1308,61,9319,1000387,1000448,11
2910,256,9319,1000448,1000704,15
8231,300,9319,1000704,1001004,23
4467,115,9319,1001004,1001119,28
7310,267,9319,1001119,1001386,30
4297,3,9319,1001386,1001389,34
6569,281,9319,1001389,1001670,40
9327,65,9320,1001669,1001734,10
5584,239,9320,1001734,1001973,13
6834,229,9321,1001972,1002201,4
6297,219,9321,1002201,1002420,14
8358,29,9321,1002420,1002449,45
6673,222,9322,1002448,1002670,5
7229,290,9322,1002670,1002960,11
5950,8,9322,1002960,1002968,14
5134,257,9322,1002968,1003225,16
1245,133,9322,1003225,1003358,35
7704,110,9322,1003358,1003468,35
5834,113,9323,1003467,1003580,7
3385,61,9323,1003580,1003641,26
3630,294,9323,1003641,1003935,26
4304,22,9323,1003935,1003957,33
2492,232,9323,1003957,1004189,47
9626,143,9324,1004188,1004331,1
1171,264,9324,1004331,1004595,10
2952,14,9324,1004595,1004609,44
1958,84,9325,1004608,1004692,2
4777,73,9325,1004692,1004765,15
4115,56,9325,1004765,1004821,34
5169,137,9325,1004821,1004958,35
1457,242,9325,1004958,1005200,49
5581,131,9326,1005199,1005330,3
2171,243,9326,1005330,1005573,4
8366,191,9326,1005573,1005764,24
2211,185,9326,1005764,1005949,34
9784,279,9326,1005949,1006228,44
1570,239,9326,1006228,1006467,49
3820,216,9327,1006466,1006682,5
6608,174,9327,1006682,1006856,10
2195,122,9327,1006856,1006978,16
6273,22,9327,1006978,1007000,19
4949,181,9327,1007000,1007181,23
8764,230,9327,1007181,1007411,26
4987,191,9327,1007411,1007602,31
6409,165,9328,1007601,1007766,30
3740,186,9328,1007766,1007952,34
6559,299,9328,1468062,1468361,50
9627,149,9329,1008098,1008247,12
1746,101,9329,1008247,1008348,26
1797,240,9329,1008348,1008588,26
3963,147,9329,1008588,1008735,48
5591,283,9330,1008734,1009017,2
2245,50,9330,1009017,1009067,18
5086,202,9330,1009067,1009269,30
9094,103,9331,1009268,1009371,6
8193,192,9331,1009371,1009563,7
3511,164,9331,1009563,1009727,18
9215,241,9331,1009727,1009968,25
6838,61,9331,1009968,1010029,26
3864,231,9333,1010027,1010258,4
7771,89,9333,1010258,1010347,4
7549,120,9333,1010347,1010467,15
8173,174,9333,1010467,1010641,22
9625,87,9333,1010641,1010728,28
5929,16,9334,1010727,1010743,7
2099,210,9334,1010743,1010953,14
3336,12,9334,1010953,1010965,26
7573,68,9335,1010964,1011032,3
1518,300,9335,1011032,1011332,14
4508,3,9335,1011332,1011335,27
3993,92,9336,1011334,1011426,14
4649,159,9337,1011425,1011584,4
8223,138,9337,1011584,1011722,12
9467,264,9337,1011722,1011986,26
5160,144,9338,1011985,1012129,1
6873,172,9338,1012129,1012301,2
5282,280,9338,1012301,1012581,4
3392,77,9338,1012581,1012658,33
8087,283,9338,1012658,1012941,34
6267,119,9338,1012941,1013060,39
7791,261,9338,1013060,1013321,44
7238,159,9339,1013320,1013479,7
7075,8,9339,1013479,1013487,29
3265,90,9339,1013487,1013577,31
1405,38,9339,1013577,1013615,40
3281,8,9339,1013615,1013623,42
4764,92,9340,1013622,1013714,5
4745,142,9340,1013714,1013856,13
2176,177,9340,1013856,1014033,28
7399,185,9340,1014033,1014218,47
7886,121,9341,1014217,1014338,6
8921,53,9341,1014338,1014391,10
7249,228,9341,1014391,1014619,14
8388,64,9341,1014619,1014683,16
1324,251,9341,1014683,1014934,30
1524,201,9341,1014934,1015135,37
8241,168,9342,1015134,1015302,1
5547,70,9342,1015302,1015372,7
6789,193,9342,1015372,1015565,9
8561,31,9342,1015565,1015596,25
9973,88,9342,1015596,1015684,40
2052,129,9343,1015683,1015812,5
9246,48,9344,1015811,1015859,6
5986,204,9344,1015859,1016063,10
2374,132,9344,1016063,1016195,15
7284,156,9344,1016195,1016351,31
4464,224,9344,1016351,1016575,41
6716,192,9344,1016575,1016767,50
6032,222,9345,1016766,1016988,5
9706,86,9345,1016988,1017074,22
1036,11,9345,1017074,1017085,35
5205,107,9346,1017084,1017191,2
6391,214,9346,1017191,1017405,28
3618,262,9346,1017405,1017667,45
9073,3,9347,1017666,1017669,4
1503,80,9347,1017669,1017749,21
6947,49,9347,1017749,1017798,28
8908,62,9347,1017798,1017860,34
8090,80,9347,1017860,1017940,40
3974,225,9347,1017940,1018165,50
9926,259,9348,1018164,1018423,2
1517,9,9348,1018423,1018432,16
7877,260,9348,1018432,1018692,20
6283,52,9348,1018692,1018744,35
7802,145,9348,1018744,1018889,37
6727,189,9348,1018889,1019078,41
5862,33,9349,1019077,1019110,2
7912,107,9349,1019110,1019217,6
7987,230,9349,1019217,1019447,28
8577,191,9350,1019446,1019637,19
2087,233,9350,1019637,1019870,35
5804,111,9350,1019870,1019981,40
5881,283,9350,1019981,1020264,41
2899,154,9350,1020264,1020418,42
7705,68,9350,1020418,1020486,50
1205,77,9351,1020485,1020562,9
7659,296,9351,1020562,1020858,20
3352,36,9351,1020858,1020894,28
9854,222,9351,1020894,1021116,42
2556,196,9352,1021115,1021311,3
9116,73,9352,1021311,1021384,9
6917,74,9352,1021384,1021458,17
7692,9,9352,1021458,1021467,22
3801,54,9352,1021467,1021521,33
8792,46,9352,1021521,1021567,44
8932,178,9352,1021567,1021745,47
6669,35,9353,1021744,1021779,16
2801,7,9353,1021779,1021786,22
5757,71,9353,1021786,1021857,29
4465,253,9353,1021857,1022110,30
9357,81,9353,1022110,1022191,40
3459,180,9354,1022190,1022370,3
5318,24,9354,1022370,1022394,4
3992,274,9354,1022394,1022668,17
5533,179,9354,1022668,1022847,17
1959,7,9354,1022847,1022854,25
8391,223,9354,1022854,1023077,26
8656,257,9354,1023077,1023334,45
2947,3,9354,1023334,1023337,49
3585,11,9355,1023336,1023347,3
7656,150,9355,1023347,1023497,11
1511,185,9355,1023497,1023682,27
3269,40,9355,1023682,1023722,32
6499,280,9355,1023722,1024002,45
2522,256,9356,1024001,1024257,15
4752,7,9356,1024257,1024264,20
5810,234,9356,1024264,1024498,35
5461,41,9356,1024498,1024539,38
9902,71,9356,1024539,1024610,42
5099,64,9356,1024610,1024674,45
2768,209,9357,1024673,1024882,1
7529,248,9357,1024882,1025130,2
8823,194,9357,1025130,1025324,13
5162,260,9357,1025324,1025584,20
8892,158,9357,1025584,1025742,23
5437,25,9357,1025742,1025767,41
5225,206,9358,1025766,1025972,20
6907,73,9358,1025972,1026045,22
1058,270,9358,1026045,1026315,23
7584,260,9358,1026315,1026575,36
2312,133,9358,1026575,1026708,40
7682,187,9358,1026708,1026895,40
3034,85,9359,1026894,1026979,4
6934,242,9359,1026979,1027221,14
2941,43,9359,1027221,1027264,19
8737,253,9359,1027264,1027517,28
1321,214,9360,1027516,1027730,3
8832,194,9360,1027730,1027924,5
1127,298,9360,1468181,1468479,44
3892,79,9360,1028072,1028151,47
9217,232,9361,1028150,1028382,13
3538,84,9361,1028382,1028466,15
7655,185,9361,1028466,1028651,15
1368,42,9361,1028651,1028693,19
4309,64,9361,1028693,1028757,26
2386,87,9361,1028757,1028844,30
6707,268,9361,1028844,1029112,42
4779,170,9362,1029111,1029281,12
5026,136,9362,1029281,1029417,24
2841,171,9362,1029417,1029588,32
5995,252,9362,1029588,1029840,44
1886,286,9362,1029840,1030126,47
8072,251,9363,1030125,1030376,7
3556,224,9363,1030376,1030600,11
9337,108,9363,1030600,1030708,17
1477,81,9363,1030708,1030789,18
1312,164,9363,1030789,1030953,44
5328,252,9364,1030952,1031204,17
7101,237,9365,1031203,1031440,15
5291,189,9365,1031440,1031629,16
6954,139,9365,1031629,1031768,21
8431,148,9365,1031768,1031916,25
8955,162,9365,1031916,1032078,34
3377,69,9365,1032078,1032147,46
5308,31,9366,1032146,1032177,22
5066,99,9367,1032176,1032275,9
9507,40,9367,1032275,1032315,23
5175,159,9367,1032315,1032474,25
8652,23,9367,1032474,1032497,25
1738,178,9367,1032497,1032675,44
3576,6,9367,1032675,1032681,46
2448,165,9368,1032680,1032845,7
1313,36,9368,1032845,1032881,9
6115,59,9368,1032881,1032940,17
9339,94,9368,1032940,1033034,19
1817,264,9368,1033034,1033298,36
1929,66,9368,1033298,1033364,36
3610,74,9368,1033364,1033438,48
5568,207,9369,1033437,1033644,17
7524,247,9370,1033643,1033890,11
8034,199,9371,1033889,1034088,22
1271,30,9372,1034087,1034117,7
9987,94,9372,1034117,1034211,30
4463,265,9372,1034211,1034476,33
7728,154,9372,1034476,1034630,38
1240,131,9373,1034629,1034760,7
3786,234,9373,1034760,1034994,10
7248,34,9373,1034994,1035028,21
3062,42,9373,1035028,1035070,33
3350,241,9373,1035070,1035311,35
4997,206,9373,1035311,1035517,44
1116,77,9374,1035516,1035593,9
2569,23,9374,1035593,1035616,34
3571,33,9375,1035615,1035648,8
1631,69,9375,1035648,1035717,12
5336,3,9375,1035717,1035720,38
1599,82,9376,1035719,1035801,14
5928,211,9376,1035801,1036012,27
9534,39,9377,1036011,1036050,10
4507,76,9377,1036050,1036126,12
2982,246,9377,1036126,1036372,20
2823,213,9377,1036372,1036585,27
2584,191,9377,1036585,1036776,28
5072,44,9377,1036776,1036820,40
9264,65,9377,1036820,1036885,42
2504,103,9378,1036884,1036987,4
8770,224,9378,1036987,1037211,29
2830,143,9378,1037211,1037354,33
1966,252,9378,1037354,1037606,37
4681,33,9379,1037605,1037638,34
4967,89,9379,1037638,1037727,38
3669,174,9379,1037727,1037901,42
7339,176,9380,1037900,1038076,19
7246,55,9380,1038076,1038131,29
8644,266,9380,1038131,1038397,34
9552,111,9380,1038397,1038508,42
7783,76,9381,1038507,1038583,12
9008,172,9381,1038583,1038755,33
1178,83,9381,1038755,1038838,40
5532,151,9382,1038837,1038988,2
3616,280,9382,1038988,1039268,4
5811,238,9382,1039268,1039506,35
3780,175,9383,1039505,1039680,12
1571,136,9383,1039680,1039816,20
3418,190,9383,1039816,1040006,31
1009,30,9383,1040006,1040036,45
2871,61,9384,1040035,1040096,6
8206,157,9384,1040096,1040253,17
3751,211,9384,1040253,1040464,44
2835,57,9385,1040463,1040520,21
5263,30,9385,1040520,1040550,21
1207,196,9385,1040550,1040746,26
3500,189,9385,1040746,1040935,30
8951,37,9385,1040935,1040972,44
2259,8,9385,1040972,1040980,49
4437,31,9386,1040979,1041010,3
4119,108,9386,1041010,1041118,7
5100,37,9386,1041118,1041155,28
2658,47,9386,1041155,1041202,29
2764,284,9387,1041201,1041485,13
7583,205,9387,1041485,1041690,27
6613,222,9387,1041690,1041912,34
9465,73,9387,1041912,1041985,34
8454,123,9387,1041985,1042108,44
7979,166,9388,1042107,1042273,19
5586,23,9389,1042272,1042295,1
1186,10,9389,1042295,1042305,19
4543,278,9389,1042305,1042583,47
7074,121,9389,1042583,1042704,50
2761,223,9390,1042703,1042926,3
1051,16,9390,1042926,1042942,18
7594,14,9390,1042942,1042956,21
2156,153,9390,1042956,1043109,38
3155,188,9390,1043109,1043297,43
8403,192,9390,1043297,1043489,43
1769,10,9390,1043489,1043499,49
5475,170,9391,1043498,1043668,20
2783,19,9391,1043668,1043687,27
4346,292,9392,1043686,1043978,20
1846,107,9392,1043978,1044085,34
7785,285,9392,1044085,1044370,34
9209,147,9393,1044369,1044516,14
1989,283,9393,1044516,1044799,32
9452,208,9393,1044799,1045007,40
8573,124,9394,1045006,1045130,5
9207,122,9394,1045130,1045252,18
3279,229,9394,1045252,1045481,20
8343,168,9394,1045481,1045649,36
8398,219,9394,1045649,1045868,37
7424,230,9394,1045868,1046098,38
6424,234,9394,1046098,1046332,40
1549,141,9394,1046332,1046473,48
5257,109,9394,1046473,1046582,50
1673,251,9395,1046581,1046832,18
6096,299,9395,1046832,1047131,39
6753,176,9396,1047130,1047306,12
1470,44,9396,1047306,1047350,15
1155,203,9396,1047350,1047553,32
7552,274,9396,1047553,1047827,46
9358,111,9396,1047827,1047938,47
9177,183,9397,1047937,1048120,2
7217,145,9397,1048120,1048265,16
1208,147,9397,1048265,1048412,26
5596,236,9397,1048412,1048648,36
6781,41,9397,1048648,1048689,36
3489,160,9397,1048689,1048849,45
4856,87,9398,1048848,1048935,1
5674,223,9398,1048935,1049158,13
8166,275,9398,1468308,1468583,19
7474,279,9398,1049291,1049570,21
3683,78,9398,1049570,1049648,31
8743,225,9398,1049648,1049873,33
7521,208,9399,1049872,1050080,20
3398,224,9399,1050080,1050304,36
7110,104,9399,1050304,1050408,38
2449,292,9399,1050408,1050700,48
8674,218,9400,1050699,1050917,4
6743,22,9400,1050917,1050939,11
6134,145,9400,1050939,1051084,16
7895,151,9400,1051084,1051235,17
2642,229,9400,1051235,1051464,37
1249,268,9400,1051464,1051732,38
1653,67,9400,1051732,1051799,40
9054,33,9400,1051799,1051832,42
5399,100,9400,1051832,1051932,47
3997,291,9401,1468440,1468731,8
5107,150,9401,1052071,1052221,17
3468,141,9402,1052220,1052361,10
5891,48,9402,1052361,1052409,19
6761,112,9402,1052409,1052521,26
4585,223,9402,1052521,1052744,45
6996,271,9403,1052743,1053014,34
8070,207,9403,1053014,1053221,38
7817,60,9403,1053221,1053281,42
4964,188,9403,1053281,1053469,49
1247,150,9404,1053468,1053618,11
3516,222,9404,1053618,1053840,35
3936,258,9404,1053840,1054098,38
7845,261,9404,1054098,1054359,43
8324,113,9405,1054358,1054471,8
5017,171,9405,1054471,1054642,36
4303,1,9406,1054641,1054642,5
2606,129,9406,1054642,1054771,19
2934,103,9407,1054770,1054873,7
4049,131,9407,1054873,1055004,23
6519,193,9407,1055004,1055197,31
4625,151,9407,1055197,1055348,40
6410,223,9408,1055347,1055570,20
6531,129,9408,1055570,1055699,27
8065,294,9408,1468589,1468883,33
2919,238,9408,1055834,1056072,39
1273,263,9409,1056071,1056334,35
3102,122,9411,1056332,1056454,1
2444,272,9411,1056454,1056726,2
5749,45,9411,1056726,1056771,6
8725,68,9411,1056771,1056839,7
9479,26,9411,1056839,1056865,19
2925,157,9411,1056865,1057022,23
3934,295,9411,1057022,1057317,36
9439,65,9411,1057317,1057382,43
7235,174,9411,1057382,1057556,44
9579,277,9411,1057556,1057833,47
6467,223,9412,1057832,1058055,1
9475,123,9413,1058054,1058177,32
7697,247,9413,1058177,1058424,37
2525,252,9413,1058424,1058676,47
2189,43,9413,1058676,1058719,50
5468,177,9414,1058718,1058895,29
6126,142,9415,1058894,1059036,26
9028,57,9415,1059036,1059093,32
2591,248,9415,1059093,1059341,35
5525,185,9415,1059341,1059526,40
5875,29,9415,1059526,1059555,46
4793,238,9416,1059554,1059792,19
5554,242,9417,1059791,1060033,10
9893,271,9417,1060033,1060304,27
1832,264,9417,1060304,1060568,35
1863,177,9417,1060568,1060745,50
5128,176,9418,1060744,1060920,2
9684,219,9418,1060920,1061139,11
5901,291,9418,1061139,1061430,17
7755,156,9418,1061430,1061586,28
8238,233,9418,1061586,1061819,46
2565,202,9419,1061818,1062020,2
7131,294,9419,1062020,1062314,20
8627,128,9419,1062314,1062442,24
5721,215,9419,1062442,1062657,50
9966,124,9420,1062656,1062780,10
4285,239,9420,1062780,1063019,11
1465,101,9420,1063019,1063120,13
8467,92,9420,1063120,1063212,22
1968,97,9420,1063212,1063309,35
7588,297,9421,1468730,1469027,8
8554,252,9421,1063448,1063700,19
7540,219,9421,1063700,1063919,25
1176,298,9421,1063919,1064217,26
1145,245,9421,1064217,1064462,27
8807,214,9421,1064462,1064676,44
4052,148,9422,1064675,1064823,1
6241,87,9422,1064823,1064910,2
8302,117,9422,1064910,1065027,12
6796,232,9422,1065027,1065259,19
7109,296,9422,1065259,1065555,21
8567,68,9422,1065555,1065623,43
6924,158,9423,1065622,1065780,6
3613,53,9423,1065780,1065833,14
6705,190,9423,1065833,1066023,19
8959,189,9423,1066023,1066212,23
6172,200,9423,1066212,1066412,25
9764,33,9423,1066412,1066445,28
3274,94,9423,1066445,1066539,35
4610,283,9424,1066538,1066821,11
2659,5,9424,1066821,1066826,28
9875,2,9424,1066826,1066828,47
9904,264,9425,1066827,1067091,7
7222,53,9425,1067091,1067144,9
9585,112,9425,1067144,1067256,23
1616,84,9425,1067256,1067340,29
6526,236,9426,1067339,1067575,7
9088,129,9426,1067575,1067704,14
8212,91,9426,1067704,1067795,34
3128,16,9426,1067795,1067811,35
6756,234,9426,1067811,1068045,42
5049,51,9427,1068044,1068095,44
4697,198,9429,1068093,1068291,25
9110,133,9429,1068291,1068424,47
7330,267,9430,1068423,1068690,1
5300,165,9430,1068690,1068855,22
2463,76,9431,1068854,1068930,9
8318,153,9431,1068930,1069083,12
2226,237,9431,1069083,1069320,15
3026,193,9431,1069320,1069513,48
5012,14,9432,1069512,1069526,1
5097,249,9432,1069526,1069775,4
6194,205,9432,1069775,1069980,4
1645,273,9432,1069980,1070253,13
5774,114,9432,1070253,1070367,16
8913,51,9432,1070367,1070418,26
6060,140,9432,1070418,1070558,35
6936,200,9432,1070558,1070758,42
9220,231,9432,1070758,1070989,43
8293,133,9433,1070988,1071121,10
9488,191,9433,1071121,1071312,10
2613,53,9433,1071312,1071365,14
4195,270,9433,1071365,1071635,23
3817,128,9433,1071635,1071763,27
5648,75,9433,1071763,1071838,28
6053,14,9434,1071837,1071851,8
9428,211,9434,1071851,1072062,11
7677,274,9434,1072062,1072336,14
1568,295,9434,1072336,1072631,44
8671,169,9434,1072631,1072800,50
9248,71,9434,1072800,1072871,50
3947,209,9435,1072870,1073079,8
8427,120,9435,1073079,1073199,39
1219,109,9435,1073199,1073308,43
1758,176,9435,1073308,1073484,46
4375,275,9436,1073483,1073758,28
7233,37,9436,1073758,1073795,28
2647,8,9436,1073795,1073803,42
1793,13,9436,1073803,1073816,48
9404,182,9437,1073815,1073997,49
6720,74,9438,1073996,1074070,2
8706,266,9438,1074070,1074336,15
5884,35,9438,1074336,1074371,27
3151,93,9438,1074371,1074464,28
7040,239,9438,1074464,1074703,33
9991,71,9438,1074703,1074774,37
2980,152,9438,1074774,1074926,39
7482,280,9438,1074926,1075206,44
7811,155,9440,1075204,1075359,17
3369,215,9441,1075358,1075573,25
2412,95,9441,1075573,1075668,36
8353,95,9441,1075668,1075763,43
7788,295,9442,1075762,1076057,3
5284,298,9442,1076057,1076355,5
7963,75,9442,1076355,1076430,15
9795,229,9442,1076430,1076659,21
3546,105,9443,1076658,1076763,2
6610,18,9443,1076763,1076781,9
2165,240,9443,1076781,1077021,14
8352,11,9443,1077021,1077032,15
3675,228,9443,1077032,1077260,20
3191,229,9443,1077260,1077489,24
1226,103,9443,1077489,1077592,32
6863,178,9443,1077592,1077770,34
9618,120,9444,1077769,1077889,4
6643,201,9444,1077889,1078090,11
9396,164,9444,1078090,1078254,37
3022,181,9444,1078254,1078435,39
8994,192,9444,1078435,1078627,43
6893,272,9444,1078627,1078899,47
4536,200,9445,1078898,1079098,6
1094,275,9445,1079098,1079373,8
8041,180,9445,1079373,1079553,8
7403,248,9445,1079553,1079801,25
7140,169,9445,1079801,1079970,47
8557,265,9445,1079970,1080235,47
5874,239,9446,1080234,1080473,22
7908,179,9446,1080473,1080652,34
9221,242,9446,1080652,1080894,41
5551,256,9447,1080893,1081149,30
9007,11,9447,1081149,1081160,38
2145,243,9447,1081160,1081403,47
6233,83,9448,1081402,1081485,2
8289,250,9448,1081485,1081735,16
3283,136,9448,1081735,1081871,40
7446,205,9448,1081871,1082076,50
2451,116,9449,1082075,1082191,1
3254,26,9449,1082191,1082217,14
8477,280,9449,1082217,1082497,48
8085,150,9450,1082496,1082646,28
3515,112,9450,1082646,1082758,47
1759,249,9451,1082757,1083006,14
4648,91,9451,1083006,1083097,47
3040,115,9452,1083096,1083211,1
8985,146,9452,1083211,1083357,8
7861,22,9452,1083357,1083379,22
8162,235,9452,1083379,1083614,24
8052,138,9452,1083614,1083752,34
4374,181,9452,1083752,1083933,35
3859,260,9452,1083933,1084193,38
7419,266,9453,1084192,1084458,19
3512,20,9453,1084458,1084478,50
2065,56,9454,1084477,1084533,29
6000,138,9454,1084533,1084671,36
1722,256,9454,1084671,1084927,37
3504,99,9454,1084927,1085026,46
8665,2,9455,1085025,1085027,4
4403,214,9455,1085027,1085241,38
5714,226,9455,1085241,1085467,42
5096,271,9456,1085466,1085737,5
5827,224,9456,1085737,1085961,8
5111,163,9456,1085961,1086124,9
3054,239,9456,1086124,1086363,13
8127,38,9456,1086363,1086401,19
5611,102,9456,1086401,1086503,25
8604,46,9456,1086503,1086549,28
2137,227,9456,1086549,1086776,45
9451,4,9457,1086775,1086779,20
6812,41,9457,1086779,1086820,30
6108,287,9457,1468848,1469135,42
7269,121,9458,1086962,1087083,11
4075,61,9458,1087083,1087144,13
6758,111,9458,1087144,1087255,16
6612,129,9458,1087255,1087384,23
9589,89,9458,1087384,1087473,49
1019,257,9459,1087472,1087729,23
3185,200,9459,1087729,1087929,34
4885,275,9459,1087929,1088204,36
9164,221,9459,1088204,1088425,38
7397,73,9460,1088424,1088497,29
3075,226,9460,1088497,1088723,34
8897,9,9460,1088723,1088732,42
4666,5,9460,1088732,1088737,49
7124,36,9461,1088736,1088772,6
5132,241,9461,1088772,1089013,31
1064,154,9462,1089012,1089166,3
4480,2,9462,1089166,1089168,15
6124,192,9462,1089168,1089360,23
8379,40,9463,1089359,1089399,2
1043,10,9463,1089399,1089409,16
4544,71,9463,1089409,1089480,23
9481,26,9463,1089480,1089506,24
4094,27,9463,1089506,1089533,31
4386,104,9463,1089533,1089637,48
2038,242,9464,1089636,1089878,4
7597,106,9464,1089878,1089984,16
2590,156,9464,1089984,1090140,23
9661,258,9465,1090139,1090397,13
1592,180,9465,1090397,1090577,16
7000,114,9465,1090577,1090691,37
6266,171,9465,1090691,1090862,41
7266,172,9466,1090861,1091033,2
7805,231,9466,1091033,1091264,26
1364,12,9466,1091264,1091276,40
9884,128,9467,1091275,1091403,9
1730,281,9467,1091403,1091684,47
2425,170,9468,1091683,1091853,36
3550,80,9468,1091853,1091933,47
3349,116,9469,1091932,1092048,4
7751,99,9469,1092048,1092147,5
2769,118,9469,1092147,1092265,7
5672,175,9469,1092265,1092440,33
6592,67,9469,1092440,1092507,47
4650,17,9469,1092507,1092524,48
2780,242,9470,1092523,1092765,10
7023,164,9470,1092765,1092929,15
6319,25,9470,1092929,1092954,27
6204,223,9470,1092954,1093177,44
3452,261,9470,1093177,1093438,49
9870,233,9470,1093438,1093671,50
1664,173,9471,1093670,1093843,7
9980,60,9471,1093843,1093903,26
3086,186,9471,1093903,1094089,35
4315,274,9471,1094089,1094363,41
8592,7,9472,1094362,1094369,6
6450,111,9472,1094369,1094480,7
3736,55,9472,1094480,1094535,8
9709,102,9472,1094535,1094637,42
5947,108,9472,1094637,1094745,43
5278,234,9473,1094744,1094978,8
7906,210,9473,1094978,1095188,16
9259,94,9473,1095188,1095282,16
9590,208,9473,1095282,1095490,28
9235,45,9473,1095490,1095535,33
4425,2,9474,1095534,1095536,32
6708,148,9474,1095536,1095684,32
2318,174,9474,1095684,1095858,35
4127,256,9474,1095858,1096114,38
6146,234,9474,1096114,1096348,43
3065,182,9474,1096348,1096530,47
6524,101,9475,1096529,1096630,2
9605,71,9475,1096630,1096701,11
8043,248,9475,1096701,1096949,16
8300,61,9476,1096948,1097009,9
9348,113,9476,1097009,1097122,22
4899,51,9476,1097122,1097173,27
2032,165,9476,1097173,1097338,47
3017,2,9478,1097336,1097338,1
7472,113,9478,1097338,1097451,5
6790,293,9478,1468970,1469263,15
4981,272,9478,1097595,1097867,18
3953,176,9478,1097867,1098043,33
4163,117,9479,1098042,1098159,18
1905,120,9479,1098159,1098279,20
6898,81,9479,1098279,1098360,21
3704,183,9480,1098359,1098542,22
3761,124,9480,1098542,1098666,27
9547,102,9480,1098666,1098768,33
6363,62,9480,1098768,1098830,37
6902,72,9480,1098830,1098902,42
3927,297,9480,1098902,1099199,45
8826,204,9480,1099199,1099403,45
4880,76,9481,1099402,1099478,32
8602,231,9481,1099478,1099709,41
3643,54,9482,1099708,1099762,6
4694,243,9482,1099762,1100005,16
2009,34,9482,1100005,1100039,19
3533,117,9482,1100039,1100156,29
7550,61,9482,1100156,1100217,31
9519,102,9482,1100217,1100319,41
5896,224,9482,1100319,1100543,45
5222,255,9483,1100542,1100797,5
3371,252,9483,1100797,1101049,20
2346,258,9483,1101049,1101307,27
8719,286,9483,1101307,1101593,34
2674,41,9483,1101593,1101634,40
4383,158,9483,1101634,1101792,44
4500,204,9484,1101791,1101995,12
6352,238,9484,1101995,1102233,41
2019,174,9485,1102232,1102406,2
1414,35,9485,1102406,1102441,25
4562,209,9485,1102441,1102650,31
6055,5,9486,1102649,1102654,11
6402,125,9486,1102654,1102779,27
5361,69,9486,1102779,1102848,48
1406,242,9487,1102847,1103089,3
4101,263,9487,1103089,1103352,17
5436,261,9487,1103352,1103613,27
3611,282,9487,1469119,1469401,33
7143,93,9487,1103748,1103841,33
4802,96,9487,1103841,1103937,44
5763,158,9488,1103936,1104094,24
9867,70,9488,1104094,1104164,30
9947,224,9488,1104164,1104388,32
1932,202,9488,1104388,1104590,36
8044,285,9488,1104590,1104875,43
5769,140,9489,1104874,1105014,11
5516,226,9489,1105014,1105240,18
8101,218,9490,1105239,1105457,36
9276,88,9491,1105456,1105544,15
2210,15,9492,1105543,1105558,1
6700,283,9492,1105558,1105841,4
8869,142,9492,1105841,1105983,10
1808,50,9492,1105983,1106033,16
5015,136,9492,1106033,1106169,16
5207,38,9492,1106169,1106207,18
7645,256,9492,1106207,1106463,19
5371,207,9492,1106463,1106670,38
8313,230,9492,1106670,1106900,40
3255,255,9492,1106900,1107155,44
7169,172,9493,1107154,1107326,20
5339,242,9493,1107326,1107568,23
6306,175,9493,1107568,1107743,38
8597,243,9493,1107743,1107986,48
9040,219,9494,1107985,1108204,1
5321,145,9494,1108204,1108349,7
2230,212,9494,1108349,1108561,8
5325,56,9494,1108561,1108617,11
7039,62,9494,1108617,1108679,17
6711,128,9494,1108679,1108807,34
5238,71,9494,1108807,1108878,36
4002,53,9494,1108878,1108931,38
9810,78,9495,1108930,1109008,9
3042,242,9495,1109008,1109250,22
8116,189,9495,1109250,1109439,23
9258,80,9495,1109439,1109519,42
3252,171,9496,1109518,1109689,2
1233,161,9496,1109689,1109850,3
7469,11,9496,1109850,1109861,4
4215,292,9496,1109861,1110153,10
7079,112,9496,1110153,1110265,15
4791,28,9496,1110265,1110293,17
9309,30,9496,1110293,1110323,18
2931,26,9496,1110323,1110349,22
9511,63,9496,1110349,1110412,29
3887,139,9496,1110412,1110551,30
4413,6,9496,1110551,1110557,36
6331,272,9496,1110557,1110829,47
5717,281,9497,1110828,1111109,1
1375,183,9497,1111109,1111292,9
6007,205,9497,1111292,1111497,22
2971,191,9497,1111497,1111688,32
9723,78,9497,1111688,1111766,34
9316,219,9497,1111766,1111985,42
4567,230,9498,1111984,1112214,10
5129,295,9498,1469246,1469541,25
5089,62,9498,1112358,1112420,36
6964,146,9498,1112420,1112566,46
8881,245,9499,1112565,1112810,6
5083,268,9499,1112810,1113078,49
8132,218,9499,1113078,1113296,49
7153,45,9500,1113295,1113340,7
6041,147,9500,1113340,1113487,11
9907,54,9501,1113486,1113540,8
2096,261,9501,1113540,1113801,15
2143,66,9501,1113801,1113867,28
2706,173,9501,1113867,1114040,33
4078,210,9501,1114040,1114250,35
4513,281,9502,1114249,1114530,2
3555,44,9502,1114530,1114574,26
7907,51,9502,1114574,1114625,36
8800,132,9503,1114624,1114756,16
3088,20,9503,1114756,1114776,30
7885,142,9503,1114776,1114918,31
5787,183,9503,1114918,1115101,41
8744,132,9503,1115101,1115233,46
1820,3,9503,1115233,1115236,48
5641,28,9504,1115235,1115263,15
8523,122,9504,1115263,1115385,39
4644,245,9504,1115385,1115630,50
1335,270,9505,1115629,1115899,10
2261,67,9505,1115899,1115966,29
5345,294,9505,1115966,1116260,34
8977,183,9505,1116260,1116443,34
9159,211,9505,1116443,1116654,37
5204,110,9505,1116654,1116764,44
7662,87,9506,1116763,1116850,6
2524,136,9506,1116850,1116986,22
9455,60,9506,1116986,1117046,38
7385,231,9506,1117046,1117277,44
1185,92,9507,1117276,1117368,33
6104,196,9507,1117368,1117564,39
2628,146,9507,1117564,1117710,46
2929,211,9508,1117709,1117920,5
1229,7,9508,1117920,1117927,24
5798,188,9508,1117927,1118115,37
8301,57,9509,1118114,1118171,3
7884,166,9509,1118171,1118337,5
8404,26,9509,1118337,1118363,8
2542,4,9509,1118363,1118367,12
9487,271,9509,1118367,1118638,16
4238,99,9509,1118638,1118737,30
8574,45,9509,1118737,1118782,36
6521,80,9509,1118782,1118862,45
9241,203,9510,1118861,1119064,12
1322,220,9510,1119064,1119284,31
1757,250,9510,1119284,1119534,33
7158,245,9510,1119534,1119779,45
2184,114,9510,1119779,1119893,47
8466,239,9511,1119892,1120131,4
9778,30,9511,1120131,1120161,10
8699,225,9511,1120161,1120386,27
8593,243,9511,1120386,1120629,49
1629,245,9512,1120628,1120873,11
9693,249,9512,1120873,1121122,25
7617,37,9512,1121122,1121159,44
6258,153,9513,1121158,1121311,38
7015,94,9513,1121311,1121405,43
2097,137,9513,1121405,1121542,46
3295,106,9514,1121541,1121647,1
1715,107,9514,1121647,1121754,12
4991,5,9514,1121754,1121759,23
1034,30,9515,1121758,1121788,9
8475,153,9515,1121788,1121941,21
4046,255,9515,1121941,1122196,29
8228,230,9515,1122196,1122426,30
9083,224,9515,1122426,1122650,45
2250,52,9516,1122649,1122701,4
2994,8,9516,1122701,1122709,6
9314,298,9516,1122709,1123007,7
1359,141,9516,1123007,1123148,14
2164,64,9516,1123148,1123212,29
3541,260,9516,1123212,1123472,30
9508,51,9516,1123472,1123523,50
1655,62,9517,1123522,1123584,20
9503,14,9517,1123584,1123598,21
6393,182,9517,1123598,1123780,34
2516,267,9517,1123780,1124047,35
4717,98,9517,1124047,1124145,36
8533,105,9517,1124145,1124250,42
4212,102,9518,1124249,1124351,7
8420,46,9518,1124351,1124397,16
8402,295,9518,1124397,1124692,38
8016,183,9519,1124691,1124874,23
4998,256,9519,1124874,1125130,26
2732,296,9519,1125130,1125426,31
1584,294,9519,1469377,1469671,42
6702,148,9519,1125569,1125717,47
3826,218,9520,1125716,1125934,1
8495,12,9520,1125934,1125946,7
3837,201,9520,1125946,1126147,15
6225,87,9520,1126147,1126234,27
6663,159,9520,1126234,1126393,48
1684,56,9521,1126392,1126448,4
6063,95,9521,1126448,1126543,31
9969,232,9521,1126543,1126775,35
1468,171,9521,1126775,1126946,41
2378,29,9522,1126945,1126974,20
7063,188,9522,1126974,1127162,26
7901,290,9522,1127162,1127452,30
9770,72,9522,1127452,1127524,39
5243,137,9522,1127524,1127661,41
4563,218,9522,1127661,1127879,42
1641,256,9522,1127879,1128135,48
8430,39,9523,1128134,1128173,4
9512,68,9523,1128173,1128241,22
4531,134,9523,1128241,1128375,25
3135,34,9523,1128375,1128409,36
3783,194,9523,1128409,1128603,38
1135,176,9523,1128603,1128779,41
9510,206,9524,1128778,1128984,9
5443,251,9524,1128984,1129235,28
8222,134,9524,1129235,1129369,29
9509,31,9524,1129369,1129400,38
3623,53,9524,1129400,1129453,47
1800,147,9524,1129453,1129600,50
1632,147,9525,1129599,1129746,5
3194,125,9525,1129746,1129871,27
6950,45,9525,1129871,1129916,32
2461,288,9525,1129916,1130204,36
4090,131,9526,1130203,1130334,22
4558,63,9527,1130333,1130396,19
1502,274,9527,1130396,1130670,20
9803,237,9527,1130670,1130907,24
7295,269,9527,1130907,1131176,26
1328,10,9527,1131176,1131186,30
4345,292,9527,1469520,1469812,46
1970,300,9528,1131328,1131628,11
5765,233,9528,1131628,1131861,18
7309,173,9528,1131861,1132034,27
9085,37,9528,1132034,1132071,34
1045,124,9528,1132071,1132195,46
1153,253,9528,1132195,1132448,46
5695,71,9528,1132448,1132519,46
5144,199,9529,1132518,1132717,3
2081,265,9529,1132717,1132982,8
5429,23,9529,1132982,1133005,11
5267,111,9529,1133005,1133116,16
4362,64,9529,1133116,1133180,23
5916,98,9529,1133180,1133278,26
2996,219,9529,1133278,1133497,32
3800,180,9529,1133497,1133677,40
3692,185,9530,1133676,1133861,5
1444,75,9530,1133861,1133936,44
5348,282,9530,1133936,1134218,49
8194,168,9531,1134217,1134385,1
4018,284,9531,1134385,1134669,28
6940,206,9531,1134669,1134875,35
6986,211,9531,1134875,1135086,35
2751,257,9531,1135086,1135343,36
2457,240,9531,1135343,1135583,38
6090,297,9531,1135583,1135880,41
4457,186,9532,1135879,1136065,19
6097,29,9532,1136065,1136094,45
8108,148,9533,1136093,1136241,25
6505,192,9533,1136241,1136433,50
9464,9,9534,1136432,1136441,1
4781,273,9534,1136441,1136714,6
7762,194,9534,1136714,1136908,25
9405,158,9534,1136908,1137066,28
5334,37,9535,1137065,1137102,26
4551,292,9535,1469660,1469952,32
3697,293,9535,1137246,1137539,39
2614,293,9535,1137539,1137832,40
2759,70,9535,1137832,1137902,46
8030,282,9535,1137902,1138184,47
2491,43,9536,1138183,1138226,4
6321,287,9536,1138226,1138513,26
8157,29,9536,1138513,1138542,29
9286,178,9536,1138542,1138720,36
1316,48,9536,1138720,1138768,46
8202,104,9537,1138767,1138871,3
9734,29,9537,1138871,1138900,37
8224,276,9538,1138899,1139175,3
8384,224,9538,1139175,1139399,4
1458,237,9538,1139399,1139636,13
3012,240,9538,1139636,1139876,28
3134,31,9538,1139876,1139907,33
5681,3,9538,1139907,1139910,33
9324,121,9539,1139909,1140030,23
3276,104,9539,1140030,1140134,36
9887,262,9539,1140134,1140396,40
3977,278,9539,1140396,1140674,43
7113,178,9539,1140674,1140852,45
6486,60,9539,1140852,1140912,50
7320,181,9540,1140911,1141092,1
4201,120,9540,1141092,1141212,16
8270,256,9540,1141212,1141468,36
6221,204,9541,1141467,1141671,14
5904,260,9541,1141671,1141931,26
9387,194,9541,1141931,1142125,28
9453,230,9541,1142125,1142355,36
9408,4,9541,1142355,1142359,37
1651,228,9541,1142359,1142587,38
6058,138,9542,1142586,1142724,8
8773,154,9542,1142724,1142878,21
7889,103,9542,1142878,1142981,24
4001,94,9542,1142981,1143075,28
8822,102,9542,1143075,1143177,50
7362,231,9543,1143176,1143407,3
1119,93,9543,1143407,1143500,15
4462,211,9543,1143500,1143711,16
2398,211,9543,1143711,1143922,18
9353,80,9543,1143922,1144002,22
5503,199,9543,1144002,1144201,29
1010,23,9543,1144201,1144224,31
8039,152,9543,1144224,1144376,33
6377,186,9543,1144376,1144562,35
8009,287,9543,1144562,1144849,39
8704,211,9544,1144848,1145059,12
3560,218,9544,1145059,1145277,24
8031,177,9544,1145277,1145454,30
6448,227,9544,1145454,1145681,34
4873,27,9544,1145681,1145708,38
4418,122,9545,1145707,1145829,24
6054,99,9546,1145828,1145927,3
4794,178,9546,1145927,1146105,13
8063,138,9546,1146105,1146243,21
9753,205,9546,1146243,1146448,30
3244,138,9547,1146447,1146585,29
4716,79,9547,1146585,1146664,44
7539,288,9547,1146664,1146952,45
6327,221,9548,1146951,1147172,4
3332,13,9548,1147172,1147185,7
9077,202,9548,1147185,1147387,24
3476,135,9548,1147387,1147522,31
5484,201,9549,1147521,1147722,12
6830,103,9549,1147722,1147825,23
4857,268,9549,1147825,1148093,30
7174,14,9549,1148093,1148107,49
5887,193,9550,1148106,1148299,3
5692,196,9550,1148299,1148495,17
6751,81,9550,1148495,1148576,18
1838,54,9550,1148576,1148630,21
9816,70,9550,1148630,1148700,28
8284,159,9550,1148700,1148859,39
5357,95,9550,1148859,1148954,41
1644,106,9550,1148954,1149060,43
1381,118,9550,1149060,1149178,49
4226,280,9551,1149177,1149457,14
6302,47,9551,1149457,1149504,20
2551,94,9551,1149504,1149598,21
6417,193,9551,1149598,1149791,27
4491,72,9552,1149790,1149862,7
4600,210,9552,1149862,1150072,18
8939,150,9552,1150072,1150222,18
1976,208,9552,1150222,1150430,39
5084,6,9553,1150429,1150435,3
8646,70,9553,1150435,1150505,39
8147,282,9553,1150505,1150787,41
8941,188,9554,1150786,1150974,2
2740,3,9554,1150974,1150977,27
3446,91,9554,1150977,1151068,29
1093,95,9554,1151068,1151163,44
6478,24,9555,1151162,1151186,11
1224,215,9555,1151186,1151401,13
1663,12,9555,1151401,1151413,15
5557,157,9555,1151413,1151570,15
4320,177,9555,1151570,1151747,16
3954,206,9555,1151747,1151953,18
1076,161,9555,1151953,1152114,26
6388,260,9556,1152113,1152373,1
2723,84,9556,1152373,1152457,3
7133,154,9556,1152457,1152611,5
6182,14,9556,1152611,1152625,10
2069,179,9556,1152625,1152804,22
1818,204,9556,1152804,1153008,37
9923,127,9556,1153008,1153135,40
1008,87,9557,1153134,1153221,5
5968,51,9557,1153221,1153272,9
5683,245,9557,1153272,1153517,22
9540,91,9557,1153517,1153608,39
7640,189,9557,1153608,1153797,42
9564,260,9557,1153797,1154057,49
4837,202,9558,1154056,1154258,16
1198,272,9558,1154258,1154530,29
2447,258,9558,1154530,1154788,45
4040,159,9558,1154788,1154947,50
4855,220,9559,1154946,1155166,14
3367,158,9559,1155166,1155324,33
5127,244,9559,1155324,1155568,50
4371,125,9560,1155567,1155692,10
3462,231,9560,1155692,1155923,16
2253,102,9560,1155923,1156025,18
4571,145,9560,1156025,1156170,18
6383,146,9560,1156170,1156316,28
9996,292,9561,1156315,1156607,39
4286,151,9561,1156607,1156758,50
9097,67,9562,1156757,1156824,12
7561,196,9562,1156824,1157020,23
7730,56,9563,1157019,1157075,14
9932,180,9563,1157075,1157255,17
8096,205,9563,1157255,1157460,21
5962,181,9563,1157460,1157641,29
6554,32,9563,1157641,1157673,49
2766,93,9564,1157672,1157765,3
8243,250,9564,1157765,1158015,30
4635,143,9564,1158015,1158158,36
4419,203,9565,1158157,1158360,20
2747,35,9565,1158360,1158395,30
3444,110,9565,1158395,1158505,32
8833,2,9565,1158505,1158507,35
2893,122,9565,1158507,1158629,39
1456,121,9565,1158629,1158750,44
5170,75,9565,1158750,1158825,44
9741,35,9566,1158824,1158859,3
5640,5,9566,1158859,1158864,19
3213,16,9566,1158864,1158880,22
5994,244,9566,1158880,1159124,33
8983,31,9566,1159124,1159155,33
9175,218,9567,1159154,1159372,11
7392,235,9567,1159372,1159607,12
6003,123,9567,1159607,1159730,13
5023,291,9567,1159730,1160021,21
2108,38,9567,1160021,1160059,22
8135,264,9567,1160059,1160323,23
8516,42,9568,1160322,1160364,2
2503,181,9568,1160364,1160545,7
5957,266,9568,1160545,1160811,7
5319,12,9568,1160811,1160823,24
5007,248,9568,1160823,1161071,29
4180,89,9568,1161071,1161160,33
6828,291,9568,1161160,1161451,35
5062,62,9569,1161450,1161512,25
8400,141,9569,1161512,1161653,26
6684,49,9569,1161653,1161702,37
8510,150,9569,1161702,1161852,43
7062,109,9569,1161852,1161961,48
9506,230,9570,1161960,1162190,4
1543,159,9570,1162190,1162349,14
2639,190,9571,1162348,1162538,17
6482,183,9571,1162538,1162721,23
3824,286,9571,1162721,1163007,26
7436,280,9571,1163007,1163287,47
7328,105,9571,1163287,1163392,48
4514,253,9572,1163391,1163644,10
3492,38,9572,1163644,1163682,37
9873,207,9572,1163682,1163889,47
6071,128,9573,1163888,1164016,13
8338,94,9573,1164016,1164110,24
1580,200,9573,1164110,1164310,26
3722,48,9573,1164310,1164358,35
3171,14,9574,1164357,1164371,10
6455,166,9574,1164371,1164537,13
8504,108,9574,1164537,1164645,30
9935,45,9574,1164645,1164690,32
5430,64,9574,1164690,1164754,47
6818,223,9575,1164753,1164976,11
1601,29,9575,1164976,1165005,25
7444,136,9575,1165005,1165141,39
4447,39,9575,1165141,1165180,40
6216,109,9575,1165180,1165289,44
7691,15,9576,1165288,1165303,9
1242,240,9576,1165303,1165543,10
5971,274,9576,1165543,1165817,15
6372,66,9576,1165817,1165883,21
4735,113,9576,1165883,1165996,23
8924,272,9576,1165996,1166268,29
9906,206,9576,1166268,1166474,32
5700,93,9576,1166474,1166567,38
2523,264,9577,1166566,1166830,4
5604,122,9577,1166830,1166952,9
2876,33,9577,1166952,1166985,12
6212,138,9577,1166985,1167123,12
5244,153,9577,1167123,1167276,19
5253,192,9577,1167276,1167468,20
5972,23,9577,1167468,1167491,41
4185,61,9578,1167490,1167551,3
2406,18,9578,1167551,1167569,6
1448,273,9578,1167569,1167842,35
7156,283,9578,1167842,1168125,39
4062,2,9579,1168124,1168126,13
1963,286,9579,1168126,1168412,24
7037,172,9579,1168412,1168584,42
4451,266,9579,1168584,1168850,43
7880,252,9579,1168850,1169102,48
1822,11,9580,1169101,1169112,10
3031,204,9580,1169112,1169316,45
8958,45,9581,1169315,1169360,23
8274,131,9581,1169360,1169491,41
2323,144,9582,1169490,1169634,2
3543,174,9582,1169634,1169808,7
2641,181,9582,1169808,1169989,26
6901,53,9582,1169989,1170042,27
8312,126,9582,1170042,1170168,41
1159,259,9583,1170167,1170426,25
9250,156,9583,1170426,1170582,29
4272,56,9583,1170582,1170638,36
7022,137,9583,1170638,1170775,46
3756,19,9584,1170774,1170793,3
6165,164,9584,1170793,1170957,4
1810,49,9584,1170957,1171006,9
2338,294,9584,1469762,1470056,9
7449,141,9584,1171147,1171288,10
3386,168,9584,1171288,1171456,39
4381,173,9584,1171456,1171629,39
4780,164,9585,1171628,1171792,3
4469,179,9585,1171792,1171971,27
3107,257,9585,1171971,1172228,48
5951,232,9586,1172227,1172459,5
9004,65,9586,1172459,1172524,8
2094,289,9586,1469910,1470199,15
1337,163,9586,1172668,1172831,20
7081,143,9586,1172831,1172974,21
9859,66,9586,1172974,1173040,39
7657,54,9586,1173040,1173094,50
8912,239,9587,1173093,1173332,7
8368,191,9587,1173332,1173523,9
3431,282,9587,1173523,1173805,10
4561,289,9587,1173805,1174094,14
7813,67,9587,1174094,1174161,27
1849,98,9588,1174160,1174258,1
2936,71,9588,1174258,1174329,28
5025,207,9589,1174328,1174535,19
4800,221,9589,1174535,1174756,22
8458,160,9589,1174756,1174916,24
4790,89,9589,1174916,1175005,42
4587,297,9590,1175004,1175301,1
1772,189,9590,1175301,1175490,11
4225,108,9590,1175490,1175598,11
3296,300,9590,1470062,1470362,19
3544,267,9590,1175731,1175998,23
2315,268,9590,1175998,1176266,26
4251,265,9590,1176266,1176531,43
3009,109,9590,1176531,1176640,44
6652,63,9590,1176640,1176703,49
9728,1,9591,1176702,1176703,5
3742,163,9591,1176703,1176866,9
1773,188,9591,1176866,1177054,18
4557,271,9591,1177054,1177325,38
5684,47,9591,1177325,1177372,50
7210,66,9592,1177371,1177437,15
2807,28,9592,1177437,1177465,16
6706,41,9592,1177465,1177506,20
1841,141,9592,1177506,1177647,22
4084,40,9592,1177647,1177687,27
4405,195,9592,1177687,1177882,32
9920,274,9592,1177882,1178156,38
2074,227,9593,1178155,1178382,1
6892,219,9593,1178382,1178601,16
5627,76,9593,1178601,1178677,37
8040,150,9593,1178677,1178827,38
8064,205,9593,1178827,1179032,42
1538,220,9594,1179031,1179251,6
2975,270,9594,1179251,1179521,6
4994,30,9594,1179521,1179551,13
8092,33,9594,1179551,1179584,26
4196,138,9594,1179584,1179722,43
8295,133,9595,1179721,1179854,3
5961,239,9595,1179854,1180093,22
3168,148,9595,1180093,1180241,31
4951,74,9596,1180240,1180314,4
7532,61,9596,1180314,1180375,12
3918,227,9596,1180375,1180602,15
2560,241,9596,1180602,1180843,22
1741,89,9596,1180843,1180932,32
1491,123,9596,1180932,1181055,34
1023,115,9596,1181055,1181170,39
9591,12,9597,1181169,1181181,7
4952,243,9597,1181181,1181424,22
9558,25,9597,1181424,1181449,23
9237,257,9597,1181449,1181706,39
5051,152,9598,1181705,1181857,9
5230,26,9598,1181857,1181883,21
1235,125,9598,1181883,1182008,27
2193,26,9598,1182008,1182034,28
5438,169,9598,1182034,1182203,32
5652,140,9598,1182203,1182343,37
2983,218,9599,1182342,1182560,3
3337,18,9599,1182560,1182578,14
2331,200,9599,1182578,1182778,15
2622,143,9599,1182778,1182921,20
4859,214,9599,1182921,1183135,29
5764,145,9599,1183135,1183280,33
6509,295,9599,1183280,1183575,45
1847,125,9600,1183574,1183699,34
3785,293,9600,1470209,1470502,46
7308,85,9601,1183841,1183926,9
7835,48,9601,1183926,1183974,19
5247,186,9601,1183974,1184160,24
9312,2,9601,1184160,1184162,34
8662,22,9601,1184162,1184184,48
1834,83,9601,1184184,1184267,49
7365,173,9602,1184266,1184439,3
3316,75,9602,1184439,1184514,5
9729,239,9603,1184513,1184752,6
3739,135,9603,1184752,1184887,11
1113,184,9603,1184887,1185071,17
5080,166,9603,1185071,1185237,48
7925,195,9603,1185237,1185432,50
8784,153,9604,1185431,1185584,5
8850,237,9604,1185584,1185821,17
7452,155,9604,1185821,1185976,29
4643,211,9604,1185976,1186187,35
3078,55,9604,1186187,1186242,36
8077,270,9604,1186242,1186512,50
2637,31,9605,1186511,1186542,48
3123,287,9605,1186542,1186829,48
8615,80,9606,1186828,1186908,47
6651,122,9606,1186908,1187030,48
2883,40,9606,1187030,1187070,50
3149,255,9607,1187069,1187324,11
7547,206,9607,1187324,1187530,12
2490,119,9607,1187530,1187649,24
9376,15,9607,1187649,1187664,29
9361,98,9607,1187664,1187762,38
4919,116,9607,1187762,1187878,46
8889,292,9608,1187877,1188169,11
3552,262,9608,1188169,1188431,34
3931,216,9609,1188430,1188646,1
7559,38,9609,1188646,1188684,17
9021,172,9609,1188684,1188856,26
3268,77,9609,1188856,1188933,41
2270,36,9610,1188932,1188968,23
8877,130,9610,1188968,1189098,24
3163,10,9610,1189098,1189108,33
4845,167,9610,1189108,1189275,33
5022,231,9611,1189274,1189505,4
8998,246,9611,1189505,1189751,11
2100,164,9611,1189751,1189915,28
4295,251,9611,1189915,1190166,31
3441,119,9611,1190166,1190285,37
6129,189,9611,1190285,1190474,39
1985,88,9612,1190473,1190561,32
4421,299,9612,1470347,1470646,42
9102,102,9612,1190704,1190806,50
1466,140,9613,1190805,1190945,15
9730,179,9613,1190945,1191124,24
7386,78,9613,1191124,1191202,46
9899,274,9613,1191202,1191476,48
8916,154,9614,1191475,1191629,4
8048,156,9614,1191629,1191785,5
9234,175,9614,1191785,1191960,8
2689,142,9614,1191960,1192102,11
9930,264,9614,1192102,1192366,19
6355,110,9614,1192366,1192476,30
8286,8,9614,1192476,1192484,30
4341,100,9614,1192484,1192584,42
9093,150,9615,1192583,1192733,5
9197,212,9615,1192733,1192945,5
7468,232,9615,1192945,1193177,9
4110,228,9615,1193177,1193405,26
4108,199,9616,1193404,1193603,14
8867,122,9616,1193603,1193725,21
9572,282,9616,1193725,1194007,34
5181,123,9616,1194007,1194130,36
9238,121,9616,1194130,1194251,39
8444,147,9616,1194251,1194398,43
3755,258,9617,1194397,1194655,2
2101,288,9617,1194655,1194943,7
2635,46,9617,1194943,1194989,15
8363,237,9617,1194989,1195226,17
1946,81,9617,1195226,1195307,28
3320,37,9617,1195307,1195344,29
5701,116,9617,1195344,1195460,36
6271,78,9617,1195460,1195538,43
3828,110,9619,1195536,1195646,39
3491,218,9619,1195646,1195864,43
2836,17,9619,1195864,1195881,45
3587,226,9620,1195880,1196106,22
9031,162,9620,1196106,1196268,23
6066,225,9620,1196268,1196493,39
8636,15,9620,1196493,1196508,48
3292,206,9621,1196507,1196713,3
1253,154,9621,1196713,1196867,6
7334,31,9621,1196867,1196898,48
8190,265,9622,1196897,1197162,1
3351,186,9622,1197162,1197348,6
5713,234,9622,1197348,1197582,6
8607,112,9622,1197582,1197694,23
5894,268,9622,1197694,1197962,39
6889,81,9622,1197962,1198043,43
7875,89,9623,1198042,1198131,19
1879,106,9623,1198131,1198237,20
5076,297,9623,1470492,1470789,24
1671,48,9624,1198379,1198427,1
9343,282,9624,1198427,1198709,14
7606,41,9624,1198709,1198750,18
4789,247,9624,1198750,1198997,24
7709,169,9624,1198997,1199166,44
5830,212,9624,1199166,1199378,47
6166,78,9625,1199377,1199455,1
8073,161,9625,1199455,1199616,9
7086,9,9625,1199616,1199625,12
7430,264,9625,1199625,1199889,16
5882,232,9625,1199889,1200121,47
4928,161,9626,1200120,1200281,3
7932,149,9626,1200281,1200430,3
9174,152,9626,1200430,1200582,31
8126,42,9627,1200581,1200623,3
7234,44,9627,1200623,1200667,36
7329,298,9628,1470640,1470938,25
5490,272,9628,1200810,1201082,29
2851,20,9628,1201082,1201102,30
7754,106,9628,1201102,1201208,37
6439,223,9628,1201208,1201431,38
5226,168,9629,1201430,1201598,17
3119,279,9629,1201598,1201877,23
9260,4,9629,1201877,1201881,48
8853,246,9630,1201880,1202126,3
6023,289,9630,1202126,1202415,17
1060,61,9630,1202415,1202476,37
8899,109,9630,1202476,1202585,38
4494,84,9630,1202585,1202669,49
5809,173,9631,1202668,1202841,4
5223,268,9631,1202841,1203109,9
3961,244,9631,1203109,1203353,12
2040,24,9631,1203353,1203377,32
1472,53,9631,1203377,1203430,46
9204,45,9632,1203429,1203474,11
5472,167,9632,1203474,1203641,14
3840,152,9632,1203641,1203793,36
9624,170,9633,1203792,1203962,9
6094,91,9633,1203962,1204053,11
3869,58,9633,1204053,1204111,21
7634,263,9633,1204111,1204374,29
6815,159,9633,1204374,1204533,40
7494,254,9633,1204533,1204787,47
4003,266,9634,1204786,1205052,12
9532,260,9634,1205052,1205312,23
7466,195,9634,1205312,1205507,24
7858,31,9634,1205507,1205538,28
3170,55,9635,1205537,1205592,47
4626,35,9635,1205592,1205627,47
7837,230,9636,1205626,1205856,6
4161,47,9636,1205856,1205903,30
4924,110,9636,1205903,1206013,30
1467,223,9636,1206013,1206236,34
7635,266,9636,1206236,1206502,39
4404,5,9636,1206502,1206507,45
6813,52,9636,1206507,1206559,49
1668,69,9637,1206558,1206627,6
4088,36,9637,1206627,1206663,22
9111,37,9637,1206663,1206700,27
4439,178,9637,1206700,1206878,32
5391,129,9637,1206878,1207007,43
6458,82,9638,1207006,1207088,3
5120,255,9638,1207088,1207343,37
7680,175,9638,1207343,1207518,45
1283,212,9639,1207517,1207729,9
1309,148,9639,1207729,1207877,21
3888,295,9639,1470783,1471078,25
4914,184,9639,1208021,1208205,25
2949,38,9639,1208205,1208243,34
4416,222,9639,1208243,1208465,34
5031,46,9639,1208465,1208511,41
5354,107,9639,1208511,1208618,45
2544,160,9640,1208617,1208777,5
9787,167,9640,1208777,1208944,15
1088,136,9640,1208944,1209080,22
4943,70,9640,1209080,1209150,22
4580,294,9640,1209150,1209444,35
5963,115,9640,1209444,1209559,40
4282,102,9640,1209559,1209661,44
5658,157,9641,1209660,1209817,11
7127,121,9641,1209817,1209938,19
8507,290,9641,1209938,1210228,36
1638,201,9641,1210228,1210429,40
9400,261,9642,1210428,1210689,5
9851,176,9642,1210689,1210865,8
6008,208,9642,1210865,1211073,19
7324,228,9642,1211073,1211301,32
8688,29,9643,1211300,1211329,11
6089,211,9643,1211329,1211540,13
2891,191,9643,1211540,1211731,16
2600,143,9643,1211731,1211874,38
5815,267,9644,1211873,1212140,6
6201,239,9644,1212140,1212379,21
7920,224,9645,1212378,1212602,9
5659,31,9645,1212602,1212633,33
6970,99,9645,1212633,1212732,37
8268,289,9645,1212732,1213021,50
9000,175,9646,1213020,1213195,18
2867,254,9646,1213195,1213449,30
8168,49,9646,1213449,1213498,47
4489,101,9647,1213497,1213598,15
1495,130,9647,1213598,1213728,18
6757,262,9647,1213728,1213990,23
7332,224,9647,1213990,1214214,36
6943,171,9647,1214214,1214385,41
9331,73,9648,1214384,1214457,9
8169,176,9648,1214457,1214633,27
7503,229,9648,1214633,1214862,40
2006,258,9648,1214862,1215120,47
8151,98,9649,1215119,1215217,5
1548,244,9649,1215217,1215461,20
5203,58,9649,1215461,1215519,21
3502,152,9649,1215519,1215671,23
1654,229,9649,1215671,1215900,28
1801,265,9649,1215900,1216165,31
3228,171,9649,1216165,1216336,39
7413,128,9649,1216336,1216464,49
3177,192,9649,1216464,1216656,50
9525,300,9650,1216655,1216955,2
8074,119,9650,1216955,1217074,18
9879,299,9650,1217074,1217373,23
4444,211,9650,1217373,1217584,31
6337,258,9651,1217583,1217841,6
2091,41,9651,1217841,1217882,9
5956,35,9651,1217882,1217917,28
5460,278,9651,1217917,1218195,37
6998,197,9651,1218195,1218392,41
8287,300,9651,1218392,1218692,45
6408,101,9652,1218691,1218792,28
5755,114,9652,1218792,1218906,32
7758,257,9652,1218906,1219163,42
3231,119,9652,1219163,1219282,43
7036,202,9652,1219282,1219484,48
4369,56,9652,1219484,1219540,49
9385,90,9653,1219539,1219629,5
6588,247,9653,1219629,1219876,10
6752,289,9653,1219876,1220165,17
8572,252,9653,1220165,1220417,22
5932,278,9653,1220417,1220695,28
9834,9,9653,1220695,1220704,28
1656,72,9653,1220704,1220776,29
4938,173,9653,1220776,1220949,41
6660,228,9653,1220949,1221177,45
5931,85,9654,1221176,1221261,3
4992,137,9654,1221261,1221398,45
8511,194,9655,1221397,1221591,21
8265,14,9655,1221591,1221605,33
2238,277,9655,1221605,1221882,45
6928,275,9656,1221881,1222156,1
3721,147,9656,1222156,1222303,2
8264,105,9656,1222303,1222408,6
7525,263,9656,1222408,1222671,12
7298,193,9657,1222670,1222863,12
9070,4,9657,1222863,1222867,14
8131,215,9657,1222867,1223082,24
1804,42,9657,1223082,1223124,26
8351,270,9657,1223124,1223394,34
7787,159,9657,1223394,1223553,37
8788,225,9657,1223553,1223778,39
7600,281,9657,1223778,1224059,43
8530,288,9657,1470917,1471205,46
8778,190,9657,1224202,1224392,50
7422,164,9658,1224391,1224555,4
1949,273,9658,1224555,1224828,9
8598,107,9658,1224828,1224935,16
4559,282,9658,1471069,1471351,22
7651,23,9658,1225070,1225093,23
8628,276,9658,1471216,1471492,33
4542,250,9658,1225228,1225478,36
1676,20,9659,1225477,1225497,29
5922,102,9659,1225497,1225599,30
5482,6,9659,1225599,1225605,43
4291,25,9659,1225605,1225630,46
4690,279,9660,1225629,1225908,16
5287,242,9660,1225908,1226150,24
7116,266,9660,1226150,1226416,35
6923,142,9661,1226415,1226557,17
6960,231,9661,1226557,1226788,20
9498,295,9661,1471349,1471644,29
4921,228,9661,1226928,1227156,47
5822,141,9662,1227155,1227296,24
3192,255,9662,1227296,1227551,31
4033,104,9662,1227551,1227655,39
9749,191,9663,1227654,1227845,13
6640,48,9663,1227845,1227893,19
1101,54,9663,1227893,1227947,32
5541,277,9663,1227947,1228224,36
4189,1,9663,1228224,1228225,38
7084,293,9663,1228225,1228518,43
2155,134,9663,1228518,1228652,46
2124,221,9664,1228651,1228872,3
8457,163,9664,1228872,1229035,20
8255,283,9664,1229035,1229318,28
1030,32,9664,1229318,1229350,31
4805,106,9664,1229350,1229456,33
8911,164,9664,1229456,1229620,46
4606,206,9665,1229619,1229825,20
6932,182,9665,1229825,1230007,37
1533,87,9665,1230007,1230094,41
7427,101,9665,1230094,1230195,42
7522,4,9666,1230194,1230198,17
2123,131,9666,1230198,1230329,27
6195,160,9666,1230329,1230489,35
8733,94,9666,1230489,1230583,39
2582,90,9666,1230583,1230673,42
6207,96,9666,1230673,1230769,49
2728,4,9666,1230769,1230773,50
5664,16,9667,1230772,1230788,31
9662,204,9667,1230788,1230992,45
6582,300,9668,1230991,1231291,1
8195,156,9668,1231291,1231447,3
3784,100,9668,1231447,1231547,8
2296,142,9668,1231547,1231689,24
3635,124,9668,1231689,1231813,30
8909,87,9668,1231813,1231900,42
6658,279,9669,1231899,1232178,23
6745,4,9669,1232178,1232182,32
7942,26,9669,1232182,1232208,48
3059,221,9669,1232208,1232429,50
2870,151,9670,1232428,1232579,30
3827,74,9670,1232579,1232653,32
6125,193,9671,1232652,1232845,8
5560,84,9671,1232845,1232929,11
5958,235,9671,1232929,1233164,27
2033,45,9671,1233164,1233209,41
1223,217,9672,1233208,1233425,3
1954,123,9672,1233425,1233548,16
7745,103,9672,1233548,1233651,24
6816,224,9672,1233651,1233875,30
7752,202,9672,1233875,1234077,36
1103,168,9673,1234076,1234244,8
7812,70,9673,1234244,1234314,8
4882,168,9673,1234314,1234482,20
7853,150,9673,1234482,1234632,20
1565,60,9674,1234631,1234691,2
3153,207,9674,1234691,1234898,4
1293,232,9674,1234898,1235130,9
8059,85,9674,1235130,1235215,9
4293,57,9674,1235215,1235272,26
6457,101,9674,1235272,1235373,45
6449,269,9675,1235372,1235641,7
1476,204,9675,1235641,1235845,42
7738,234,9675,1235845,1236079,42
6232,209,9676,1236078,1236287,17
9351,9,9676,1236287,1236296,19
1590,68,9676,1236296,1236364,28
1719,88,9676,1236364,1236452,29
9366,217,9676,1236452,1236669,40
6938,87,9676,1236669,1236756,44
3103,60,9677,1236755,1236815,12
1522,102,9677,1236815,1236917,19
3897,137,9677,1236917,1237054,21
4053,160,9677,1237054,1237214,48
9804,209,9678,1237213,1237422,5
4109,154,9678,1237422,1237576,16
4134,25,9678,1237576,1237601,25
7693,50,9678,1237601,1237651,27
2995,217,9678,1237651,1237868,42
7211,260,9679,1237867,1238127,5
9390,33,9679,1238127,1238160,17
2012,25,9679,1238160,1238185,34
1951,206,9679,1238185,1238391,44
4759,295,9679,1471479,1471774,49
4698,247,9680,1238537,1238784,26
8049,156,9680,1238784,1238940,27
6859,193,9681,1238939,1239132,15
4983,17,9681,1239132,1239149,18
6247,254,9681,1239149,1239403,32
3013,70,9682,1239402,1239472,1
6121,122,9682,1239472,1239594,4
1410,240,9682,1239594,1239834,20
6345,181,9682,1239834,1240015,28
8843,58,9682,1240015,1240073,32
1001,204,9682,1240073,1240277,35
9080,50,9682,1240277,1240327,36
5427,221,9683,1240326,1240547,6
8037,204,9683,1240547,1240751,18
9763,2,9683,1240751,1240753,20
8769,267,9683,1240753,1241020,21
5464,72,9683,1241020,1241092,24
7134,224,9683,1241092,1241316,35
9524,200,9683,1241316,1241516,37
2710,117,9684,1241515,1241632,1
1723,36,9684,1241632,1241668,6
2770,219,9684,1241668,1241887,8
9147,190,9684,1241887,1242077,30
9914,108,9684,1242077,1242185,32
3114,4,9684,1242185,1242189,42
3819,285,9685,1242188,1242473,50
5888,18,9686,1242472,1242490,1
9091,196,9686,1242490,1242686,24
1038,227,9686,1242686,1242913,38
1672,192,9686,1242913,1243105,38
1953,110,9686,1243105,1243215,43
6362,129,9686,1243215,1243344,45
3033,97,9686,1243344,1243441,46
8846,83,9687,1243440,1243523,4
3052,24,9687,1243523,1243547,6
2960,249,9687,1243547,1243796,21
2811,226,9687,1243796,1244022,22
3640,194,9687,1244022,1244216,24
8491,124,9687,1244216,1244340,26
2477,258,9687,1244340,1244598,29
9989,186,9687,1244598,1244784,36
4098,6,9687,1244784,1244790,41
2272,53,9687,1244790,1244843,43
2356,132,9687,1244843,1244975,49
8001,98,9688,1244974,1245072,42
4638,81,9689,1245071,1245152,15
7956,182,9689,1245152,1245334,27
3969,100,9689,1245334,1245434,39
2701,207,9689,1245434,1245641,45
8056,143,9690,1245640,1245783,8
4838,284,9690,1245783,1246067,20
6826,120,9690,1246067,1246187,35
6670,139,9690,1246187,1246326,47
6556,169,9691,1246325,1246494,5
5428,180,9691,1246494,1246674,9
5435,50,9691,1246674,1246724,47
8676,180,9691,1246724,1246904,49
5476,4,9692,1246903,1246907,5
5595,170,9692,1246907,1247077,37
7423,171,9693,1247076,1247247,3
9416,119,9693,1247247,1247366,7
2188,47,9693,1247366,1247413,15
3686,90,9693,1247413,1247503,15
9494,261,9693,1247503,1247764,38
5404,288,9693,1247764,1248052,39
4888,242,9694,1248051,1248293,19
2838,70,9694,1248293,1248363,40
7947,35,9694,1248363,1248398,42
7923,116,9695,1248397,1248513,16
3030,71,9695,1248513,1248584,17
6835,45,9695,1248584,1248629,17
7768,150,9695,1248629,1248779,17
9344,100,9695,1248779,1248879,32
8435,189,9695,1248879,1249068,46
2414,4,9695,1249068,1249072,47
8619,121,9695,1249072,1249193,47
2497,280,9696,1249192,1249472,20
7685,32,9696,1249472,1249504,20
9775,175,9697,1249503,1249678,3
5768,138,9697,1249678,1249816,20
1216,17,9697,1249816,1249833,46
1454,279,9698,1249832,1250111,15
7650,70,9698,1250111,1250181,42
3359,87,9698,1250181,1250268,44
6895,275,9699,1250267,1250542,21
7489,300,9699,1250542,1250842,26
3948,135,9699,1250842,1250977,42
4434,159,9699,1250977,1251136,44
4668,56,9700,1251135,1251191,6
4221,223,9700,1251191,1251414,9
7052,157,9700,1251414,1251571,16
1461,299,9700,1471609,1471908,25
9072,269,9701,1251714,1251983,4
9378,64,9701,1251983,1252047,12
2276,167,9701,1252047,1252214,13
7859,11,9701,1252214,1252225,13
7054,160,9701,1252225,1252385,44
1828,200,9702,1252384,1252584,7
3461,27,9702,1252584,1252611,17
9030,149,9702,1252611,1252760,35
7356,290,9702,1471763,1472053,46
1085,95,9702,1252903,1252998,48
1845,53,9703,1252997,1253050,24
6896,40,9703,1253050,1253090,25
1044,150,9703,1253090,1253240,48
9411,255,9704,1253239,1253494,16
2054,148,9704,1253494,1253642,18
4847,137,9704,1253642,1253779,20
8870,98,9704,1253779,1253877,24
8378,242,9704,1253877,1254119,27
8335,102,9704,1254119,1254221,46
8377,166,9705,1254220,1254386,2
8712,120,9705,1254386,1254506,19
3857,74,9705,1254506,1254580,21
7890,275,9705,1254580,1254855,34
1760,212,9705,1254855,1255067,50
2756,37,9706,1255066,1255103,2
8684,31,9706,1255103,1255134,7
8337,222,9706,1255134,1255356,12
7542,123,9706,1255356,1255479,31
4941,209,9706,1255479,1255688,37
2612,100,9707,1255687,1255787,10
7432,151,9707,1255787,1255938,39
9718,227,9707,1255938,1256165,40
2113,226,9707,1256165,1256391,45
1005,166,9708,1256390,1256556,7
8456,159,9708,1256556,1256715,9
1331,186,9708,1256715,1256901,15
4944,79,9708,1256901,1256980,32
4599,284,9708,1256980,1257264,37
7596,4,9708,1257264,1257268,48
5131,13,9709,1257267,1257280,4
4415,297,9709,1257280,1257577,26
4080,190,9709,1257577,1257767,29
9486,106,9710,1257766,1257872,16
3517,214,9710,1257872,1258086,21
4006,240,9710,1258086,1258326,24
8535,178,9710,1258326,1258504,24
3872,258,9710,1258504,1258762,26
7009,59,9710,1258762,1258821,35
2267,282,9710,1258821,1259103,41
7187,23,9711,1259102,1259125,5
6506,122,9711,1259125,1259247,15
7119,206,9711,1259247,1259453,20
8992,265,9711,1259453,1259718,34
4081,224,9711,1259718,1259942,40
1827,300,9711,1471901,1472201,46
8528,289,9712,1260084,1260373,6
7218,22,9712,1260373,1260395,10
3409,106,9712,1260395,1260501,26
5650,152,9712,1260501,1260653,28
7673,135,9712,1260653,1260788,45
4044,47,9713,1260787,1260834,35
9675,209,9714,1260833,1261042,5
8630,203,9714,1261042,1261245,13
5924,95,9714,1261245,1261340,15
4089,11,9714,1261340,1261351,20
4778,212,9714,1261351,1261563,23
1374,204,9714,1261563,1261767,37
9206,49,9714,1261767,1261816,39
4166,221,9714,1261816,1262037,42
7688,49,9715,1262036,1262085,1
6857,174,9715,1262085,1262259,4
7357,63,9715,1262259,1262322,7
7798,11,9715,1262322,1262333,12
2510,211,9715,1262333,1262544,45
9279,1,9715,1262544,1262545,48
9342,138,9715,1262545,1262683,48
6667,230,9716,1262682,1262912,12
1866,15,9716,1262912,1262927,15
5784,267,9716,1262927,1263194,16
3188,285,9716,1263194,1263479,20
7781,45,9716,1263479,1263524,41
4564,129,9717,1263523,1263652,7
8164,151,9717,1263652,1263803,15
6087,2,9717,1263803,1263805,16
4454,21,9717,1263805,1263826,24
1721,116,9717,1263826,1263942,32
2142,1,9717,1263942,1263943,42
9903,8,9718,1263942,1263950,5
3554,196,9718,1263950,1264146,10
5629,57,9718,1264146,1264203,21
4848,164,9718,1264203,1264367,41
7104,24,9719,1264366,1264390,14
3343,207,9719,1264390,1264597,16
6220,2,9719,1264597,1264599,17
8772,223,9719,1264599,1264822,20
6160,136,9719,1264822,1264958,31
1112,215,9719,1264958,1265173,46
2023,132,9719,1265173,1265305,49
3539,74,9720,1265304,1265378,19
5000,255,9720,1265378,1265633,35
5116,24,9721,1265632,1265656,1
3471,156,9721,1265656,1265812,25
8756,236,9721,1265812,1266048,29
2237,212,9721,1266048,1266260,41
8525,230,9721,1266260,1266490,49
8142,144,9722,1266489,1266633,1
7891,259,9722,1266633,1266892,6
2268,106,9722,1266892,1266998,7
6913,279,9722,1266998,1267277,11
3615,126,9722,1267277,1267403,17
4875,46,9722,1267403,1267449,24
9587,268,9722,1267449,1267717,26
6277,106,9722,1267717,1267823,44
7706,252,9723,1267822,1268074,1
7830,140,9723,1268074,1268214,7
6153,106,9723,1268214,1268320,9
6016,23,9723,1268320,1268343,14
4232,238,9723,1268343,1268581,19
6820,9,9723,1268581,1268590,38
4824,37,9724,1268589,1268626,11
4903,93,9724,1268626,1268719,16
4230,139,9724,1268719,1268858,26
1220,274,9724,1268858,1269132,27
3410,286,9724,1269132,1269418,31
7287,262,9724,1269418,1269680,43
5011,242,9725,1269679,1269921,17
6026,123,9725,1269921,1270044,36
6787,176,9725,1270044,1270220,44
6625,275,9725,1270220,1270495,49
2127,149,9726,1270494,1270643,25
8645,103,9726,1270643,1270746,43
2897,187,9727,1270745,1270932,6
9149,190,9727,1270932,1271122,20
7516,232,9727,1271122,1271354,23
7393,287,9727,1271354,1271641,39
2752,120,9728,1271640,1271760,31
1354,112,9728,1271760,1271872,33
5039,292,9728,1271872,1272164,43
1132,2,9728,1272164,1272166,46
4869,289,9729,1272165,1272454,5
1561,272,9729,1272454,1272726,6
7313,78,9729,1272726,1272804,6
6490,131,9729,1272804,1272935,13
7021,266,9729,1272935,1273201,23
7721,149,9729,1273201,1273350,29
6056,21,9730,1273349,1273370,4
4377,88,9730,1273370,1273458,11
9160,244,9730,1273458,1273702,28
1098,202,9730,1273702,1273904,43
1576,66,9730,1273904,1273970,45
5140,52,9730,1273970,1274022,46
8812,203,9731,1274021,1274224,6
9379,12,9731,1274224,1274236,7
6501,205,9731,1274236,1274441,18
7609,96,9731,1274441,1274537,18
2042,255,9732,1274536,1274791,22
7163,108,9732,1274791,1274899,24
1669,26,9732,1274899,1274925,26
6546,193,9732,1274925,1275118,27
1725,20,9732,1275118,1275138,47
9458,278,9732,1275138,1275416,48
4317,299,9733,1472035,1472334,25
5250,221,9733,1275559,1275780,34
3286,237,9734,1275779,1276016,2
8545,2,9734,1276016,1276018,18
5146,64,9734,1276018,1276082,26
5252,266,9734,1276082,1276348,36
4422,252,9734,1276348,1276600,42
7750,221,9734,1276600,1276821,42
1136,284,9734,1276821,1277105,49
7499,277,9735,1472199,1472476,19
9384,20,9735,1277237,1277257,21
8066,118,9735,1277257,1277375,41
2297,248,9735,1277375,1277623,48
2509,288,9736,1277622,1277910,1
5192,69,9736,1277910,1277979,9
1042,203,9736,1277979,1278182,12
1521,105,9736,1278182,1278287,13
6576,45,9736,1278287,1278332,13
3782,122,9736,1278332,1278454,16
6029,272,9736,1278454,1278726,41
9232,200,9737,1278725,1278925,4
4651,28,9737,1278925,1278953,28
1455,35,9738,1278952,1278987,8
2725,97,9738,1278987,1279084,14
9699,84,9738,1279084,1279168,16
4922,240,9738,1279168,1279408,17
4103,183,9738,1279408,1279591,39
4750,229,9738,1279591,1279820,40
9891,187,9739,1279819,1280006,2
6081,192,9739,1280006,1280198,15
5248,109,9739,1280198,1280307,17
8242,157,9739,1280307,1280464,30
9922,225,9739,1280464,1280689,35
6200,66,9739,1280689,1280755,40
1018,179,9740,1280754,1280933,13
2935,202,9740,1280933,1281135,24
1771,139,9740,1281135,1281274,44
7702,172,9741,1281273,1281445,13
5359,132,9741,1281445,1281577,16
6827,281,9741,1281577,1281858,21
8216,10,9741,1281858,1281868,26
8600,10,9741,1281868,1281878,26
3047,36,9741,1281878,1281914,42
5448,284,9741,1281914,1282198,50
5151,163,9742,1282197,1282360,11
6118,79,9742,1282360,1282439,21
1891,167,9742,1282439,1282606,30
4905,128,9742,1282606,1282734,43
6912,27,9742,1282734,1282761,45
2853,69,9743,1282760,1282829,15
7846,278,9743,1282829,1283107,18
3602,179,9743,1283107,1283286,22
9689,222,9743,1283286,1283508,32
1003,240,9743,1283508,1283748,45
1743,202,9744,1283747,1283949,14
3355,86,9744,1283949,1284035,14
4608,37,9744,1284035,1284072,37
8987,257,9744,1284072,1284329,40
5814,182,9745,1284328,1284510,5
6326,257,9745,1284510,1284767,18
9059,22,9745,1284767,1284789,20
7448,239,9745,1284789,1285028,26
6865,100,9745,1285028,1285128,37
8804,296,9746,1285127,1285423,1
9785,265,9746,1285423,1285688,2
9607,61,9746,1285688,1285749,6
9655,49,9746,1285749,1285798,29
5699,252,9747,1285797,1286049,7
1063,155,9747,1286049,1286204,17
3169,152,9748,1286203,1286355,21
5969,227,9748,1286355,1286582,32
4312,142,9748,1286582,1286724,35
8011,6,9748,1286724,1286730,47
8350,85,9749,1286729,1286814,3
7213,153,9749,1286814,1286967,7
9340,174,9749,1286967,1287141,10
3955,285,9749,1287141,1287426,11
5600,93,9749,1287426,1287519,11
2818,274,9749,1287519,1287793,25
4022,27,9749,1287793,1287820,32
2746,34,9749,1287820,1287854,45
4768,276,9750,1287853,1288129,17
5055,72,9750,1288129,1288201,25
1232,180,9750,1288201,1288381,26
5743,205,9750,1288381,1288586,29
9016,98,9751,1288585,1288683,8
4891,74,9751,1288683,1288757,14
1955,206,9751,1288757,1288963,33
1579,196,9751,1288963,1289159,34
2583,189,9752,1289158,1289347,2
7470,191,9752,1289347,1289538,29
7303,93,9752,1289538,1289631,32
10000,118,9752,1289631,1289749,35
1265,192,9752,1289749,1289941,38
1485,144,9753,1289940,1290084,10
1884,207,9753,1290084,1290291,11
7434,146,9753,1290291,1290437,11
3374,233,9753,1290437,1290670,13
5227,287,9753,1290670,1290957,16
3633,263,9753,1290957,1291220,20
7641,184,9753,1291220,1291404,20
7281,239,9753,1291404,1291643,35
1873,28,9753,1291643,1291671,43
3996,197,9753,1291671,1291868,48
9711,172,9754,1291867,1292039,26
8669,246,9754,1292039,1292285,27
2939,185,9754,1292285,1292470,31
4055,279,9755,1292469,1292748,2
4664,167,9755,1292748,1292915,27
5989,292,9755,1472313,1472605,28
7224,182,9755,1293058,1293240,31
9636,156,9755,1293240,1293396,41
8367,12,9755,1293396,1293408,49
1306,16,9756,1293407,1293423,7
1442,227,9756,1293423,1293650,9
2687,13,9756,1293650,1293663,22
2695,174,9756,1293663,1293837,22
2855,12,9756,1293837,1293849,33
9807,139,9756,1293849,1293988,45
8275,191,9757,1293987,1294178,23
4264,123,9757,1294178,1294301,33
6989,270,9757,1294301,1294571,33
7926,92,9757,1294571,1294663,36
7268,265,9757,1294663,1294928,40
9967,157,9758,1294927,1295084,14
4613,122,9758,1295084,1295206,24
8949,148,9758,1295206,1295354,24
8498,213,9758,1295354,1295567,25
5198,104,9758,1295567,1295671,37
7319,253,9759,1295670,1295923,3
3210,273,9759,1295923,1296196,48
3950,166,9760,1296195,1296361,15
4792,73,9760,1296361,1296434,19
2726,21,9760,1296434,1296455,41
4473,4,9760,1296455,1296459,43
2645,16,9760,1296459,1296475,45
5378,130,9760,1296475,1296605,47
8635,209,9761,1296604,1296813,1
9889,104,9761,1296813,1296917,8
3911,218,9761,1296917,1297135,28
1716,266,9761,1297135,1297401,30
2169,239,9761,1297401,1297640,32
9218,4,9762,1297639,1297643,2
4217,190,9762,1297643,1297833,37
9779,258,9762,1297833,1298091,40
2488,3,9763,1298090,1298093,1
1319,274,9763,1298093,1298367,6
8834,25,9763,1298367,1298392,10
9649,256,9763,1298392,1298648,17
2428,221,9763,1298648,1298869,28
8345,98,9763,1298869,1298967,32
8948,9,9763,1298967,1298976,39
7589,59,9763,1298976,1299035,47
7734,194,9764,1299034,1299228,1
5389,264,9764,1299228,1299492,42
1799,296,9764,1472453,1472749,46
6281,227,9765,1299634,1299861,16
7098,184,9766,1299860,1300044,4
8898,280,9766,1300044,1300324,12
8068,197,9766,1300324,1300521,14
1659,145,9766,1300521,1300666,23
9943,196,9766,1300666,1300862,23
2432,104,9766,1300862,1300966,31
7838,254,9766,1300966,1301220,35
9335,109,9766,1301220,1301329,35
2912,298,9766,1472599,1472897,44
1513,269,9766,1301477,1301746,50
4495,290,9767,1301745,1302035,1
9584,120,9767,1302035,1302155,6
1288,89,9767,1302155,1302244,13
7459,31,9767,1302244,1302275,41
2632,207,9767,1302275,1302482,48
2909,123,9767,1302482,1302605,49
4488,254,9768,1302604,1302858,2
5506,244,9768,1302858,1303102,30
8252,298,9768,1303102,1303400,35
1660,74,9768,1303400,1303474,38
3229,59,9768,1303474,1303533,40
1193,10,9768,1303533,1303543,49
5753,200,9769,1303542,1303742,7
6968,295,9769,1472754,1473049,8
7872,3,9769,1303882,1303885,14
3589,277,9769,1303885,1304162,44
7618,97,9769,1304162,1304259,45
4568,290,9770,1304258,1304548,12
1853,265,9770,1304548,1304813,14
8330,146,9770,1304813,1304959,28
9727,142,9770,1304959,1305101,44
2799,57,9770,1305101,1305158,48
6870,295,9771,1472900,1473195,6
6256,209,9772,1305303,1305512,6
4686,50,9772,1305512,1305562,24
4953,251,9772,1305562,1305813,26
7325,256,9772,1305813,1306069,39
3087,60,9772,1306069,1306129,40
3091,178,9773,1306128,1306306,7
6564,130,9773,1306306,1306436,19
9682,100,9773,1306436,1306536,23
7775,272,9773,1306536,1306808,40
8931,48,9773,1306808,1306856,42
6313,287,9773,1306856,1307143,45
6803,94,9774,1307142,1307236,11
9195,201,9774,1307236,1307437,13
9948,190,9774,1307437,1307627,14
9017,73,9774,1307627,1307700,39
8544,231,9774,1307700,1307931,42
7949,147,9775,1307930,1308077,3
4179,180,9775,1308077,1308257,7
6925,216,9775,1308257,1308473,31
8902,265,9775,1308473,1308738,32
5686,68,9775,1308738,1308806,35
4556,161,9775,1308806,1308967,45
6059,80,9776,1308966,1309046,4
7112,156,9776,1309046,1309202,8
7380,42,9776,1309202,1309244,40
4595,100,9776,1309244,1309344,46
5462,130,9777,1309343,1309473,14
5534,243,9777,1309473,1309716,15
2886,134,9777,1309716,1309850,21
8178,148,9777,1309850,1309998,32
8793,160,9777,1309998,1310158,33
3183,226,9778,1310157,1310383,3
5442,36,9778,1310383,1310419,17
3455,251,9778,1310419,1310670,26
3181,4,9778,1310670,1310674,39
9252,232,9778,1310674,1310906,46
2531,236,9780,1310904,1311140,18
3603,35,9781,1311139,1311174,2
3771,47,9781,1311174,1311221,25
5913,206,9781,1311221,1311427,28
4429,46,9781,1311427,1311473,31
1805,184,9781,1311473,1311657,49
3020,64,9782,1311656,1311720,32
5147,12,9782,1311720,1311732,49
6131,266,9782,1311732,1311998,49
8333,34,9783,1311997,1312031,15
3809,84,9783,1312031,1312115,16
5696,47,9783,1312115,1312162,24
5731,100,9783,1312162,1312262,39
8095,287,9783,1312262,1312549,41
9127,62,9783,1312549,1312611,42
4255,124,9784,1312610,1312734,4
1128,259,9784,1312734,1312993,17
3121,288,9784,1312993,1313281,23
4333,46,9784,1313281,1313327,33
8239,280,9784,1313327,1313607,34
3302,39,9784,1313607,1313646,49
8962,269,9784,1313646,1313915,49
2275,138,9785,1313914,1314052,16
2837,254,9785,1314052,1314306,29
8174,183,9785,1314306,1314489,37
6338,217,9786,1314488,1314705,1
3358,106,9786,1314705,1314811,3
3463,44,9786,1314811,1314855,15
4047,149,9786,1314855,1315004,29
2064,162,9787,1315003,1315165,5
8694,33,9787,1315165,1315198,7
5880,179,9787,1315198,1315377,11
4063,65,9787,1315377,1315442,21
6929,258,9787,1315442,1315700,28
9108,189,9787,1315700,1315889,36
5737,285,9787,1315889,1316174,44
2138,201,9788,1316173,1316374,29
2872,45,9788,1316374,1316419,36
5634,142,9788,1316419,1316561,39
5085,126,9788,1316561,1316687,50
5380,160,9788,1316687,1316847,50
1057,276,9789,1316846,1317122,26
5872,276,9789,1317122,1317398,43
9671,121,9790,1317397,1317518,36
5275,274,9790,1317518,1317792,44
9269,12,9790,1317792,1317804,48
3201,113,9790,1317804,1317917,50
4029,129,9791,1317916,1318045,33
8857,199,9791,1318045,1318244,36
4235,264,9792,1318243,1318507,8
4925,56,9792,1318507,1318563,19
1978,260,9792,1318563,1318823,29
2501,37,9792,1318823,1318860,44
5609,58,9793,1318859,1318917,1
4843,40,9793,1318917,1318957,6
4019,223,9793,1318957,1319180,16
9418,185,9793,1319180,1319365,25
3625,38,9793,1319365,1319403,34
9566,6,9794,1319402,1319408,1
9666,266,9794,1319408,1319674,3
6476,149,9794,1319674,1319823,9
9975,157,9794,1319823,1319980,16
5898,269,9794,1473039,1473308,19
5619,167,9794,1320113,1320280,26
6638,23,9794,1320280,1320303,27
9296,153,9795,1320302,1320455,19
8013,296,9795,1320455,1320751,26
3651,2,9795,1320751,1320753,29
8553,207,9795,1320753,1320960,32
3981,275,9795,1320960,1321235,45
2043,268,9795,1321235,1321503,49
5613,240,9796,1321502,1321742,18
7993,278,9796,1321742,1322020,27
2017,5,9797,1322019,1322024,6
5742,8,9797,1322024,1322032,11
8521,43,9797,1322032,1322075,13
9445,236,9797,1322075,1322311,29
5137,97,9797,1322311,1322408,30
6116,29,9797,1322408,1322437,39
1904,27,9797,1322437,1322464,41
1693,259,9798,1322463,1322722,9
4173,225,9798,1322722,1322947,15
5833,61,9798,1322947,1323008,16
7777,197,9798,1323008,1323205,18
3322,122,9798,1323205,1323327,31
8441,25,9798,1323327,1323352,44
4351,95,9798,1323352,1323447,49
8187,223,9798,1323447,1323670,49
7839,257,9799,1323669,1323926,7
7763,161,9799,1323926,1324087,16
3067,254,9799,1324087,1324341,17
9287,276,9799,1324341,1324617,48
6637,109,9800,1324616,1324725,5
9409,3,9800,1324725,1324728,15
9606,253,9800,1324728,1324981,25
6093,248,9800,1324981,1325229,26
4820,163,9800,1325229,1325392,30
7937,83,9800,1325392,1325475,40
8515,297,9801,1473155,1473452,18
2973,276,9801,1325620,1325896,37
2708,214,9803,1325894,1326108,18
9739,39,9803,1326108,1326147,20
4246,153,9803,1326147,1326300,24
8695,146,9803,1326300,1326446,35
9422,289,9804,1326445,1326734,13
9615,250,9804,1326734,1326984,14
3267,247,9804,1326984,1327231,16
4811,18,9804,1327231,1327249,22
7792,169,9804,1327249,1327418,41
4573,72,9805,1327417,1327489,12
5789,135,9805,1327489,1327624,40
9527,138,9806,1327623,1327761,1
3448,237,9806,1327761,1327998,2
2314,49,9806,1327998,1328047,11
1602,259,9806,1328047,1328306,13
8502,239,9806,1328306,1328545,41
2605,20,9807,1328544,1328564,4
6871,20,9807,1328564,1328584,33
6749,223,9807,1328584,1328807,37
1982,4,9808,1328806,1328810,19
4280,208,9808,1328810,1329018,23
4683,289,9808,1329018,1329307,26
2798,284,9808,1329307,1329591,46
9824,13,9809,1329590,1329603,19
6922,156,9809,1329603,1329759,28
7130,134,9809,1329759,1329893,42
4515,24,9809,1329893,1329917,44
6466,98,9809,1329917,1330015,49
6244,80,9810,1330014,1330094,6
9063,202,9810,1330094,1330296,13
1072,226,9810,1330296,1330522,15
5311,12,9810,1330522,1330534,21
8661,109,9810,1330534,1330643,27
8623,95,9811,1330642,1330737,20
3775,176,9811,1330737,1330913,39
3219,110,9812,1330912,1331022,4
4872,99,9812,1331022,1331121,6
3401,189,9812,1331121,1331310,11
8862,98,9812,1331310,1331408,14
3750,176,9812,1331408,1331584,28
6979,66,9813,1331583,1331649,35
6764,266,9813,1331649,1331915,42
1626,126,9813,1331915,1332041,50
2375,250,9814,1332040,1332290,3
7502,185,9814,1332290,1332475,11
2604,132,9814,1332475,1332607,17
6219,276,9814,1332607,1332883,27
2567,24,9814,1332883,1332907,29
9370,206,9814,1332907,1333113,29
5647,86,9814,1333113,1333199,41
2888,284,9814,1333199,1333483,50
1287,194,9815,1333482,1333676,4
9395,54,9815,1333676,1333730,35
3863,281,9816,1473302,1473583,22
1483,197,9816,1333864,1334061,44
4389,18,9817,1334060,1334078,6
2080,217,9817,1334078,1334295,7
9981,146,9817,1334295,1334441,7
8763,185,9817,1334441,1334626,10
1298,270,9817,1334626,1334896,23
4829,114,9817,1334896,1335010,29
5024,224,9817,1335010,1335234,42
4708,140,9818,1335233,1335373,49
7416,7,9819,1335372,1335379,1
6445,263,9819,1335379,1335642,31
7735,57,9819,1335642,1335699,48
6098,50,9820,1335698,1335748,20
8858,289,9820,1335748,1336037,21
5405,296,9820,1473439,1473735,29
5709,189,9820,1336177,1336366,29
5172,139,9820,1336366,1336505,32
9322,139,9820,1336505,1336644,47
7285,196,9821,1336643,1336839,8
7807,60,9821,1336839,1336899,10
8486,216,9821,1336899,1337115,10
9263,78,9821,1337115,1337193,17
4547,41,9821,1337193,1337234,32
8608,113,9821,1337234,1337347,34
6208,50,9821,1337347,1337397,36
6566,158,9821,1337397,1337555,36
5001,292,9822,1337554,1337846,1
5708,275,9822,1337846,1338121,2
6864,109,9822,1338121,1338230,3
9609,145,9822,1338230,1338375,10
3429,80,9822,1338375,1338455,23
5008,199,9822,1338455,1338654,26
4632,215,9822,1338654,1338869,30
1114,78,9822,1338869,1338947,33
8522,183,9822,1338947,1339130,45
2543,235,9823,1339129,1339364,13
3200,53,9823,1339364,1339417,24
7929,103,9823,1339417,1339520,31
9308,140,9823,1339520,1339660,46
4150,131,9824,1339659,1339790,6
2903,160,9824,1339790,1339950,9
7145,292,9824,1339950,1340242,21
3154,68,9824,1340242,1340310,24
5606,63,9824,1340310,1340373,40
5698,84,9824,1340373,1340457,42
3043,169,9825,1340456,1340625,10
5382,42,9825,1340625,1340667,22
3522,44,9825,1340667,1340711,26
2186,1,9825,1340711,1340712,42
9843,297,9826,1340711,1341008,5
3688,49,9826,1341008,1341057,38
7581,259,9827,1341056,1341315,6
9389,209,9827,1341315,1341524,10
9497,15,9827,1341524,1341539,15
8186,198,9827,1341539,1341737,17
5907,140,9827,1341737,1341877,21
3497,296,9827,1341877,1342173,26
1024,199,9827,1342173,1342372,39
8237,247,9827,1342372,1342619,49
7661,211,9828,1342618,1342829,1
9548,136,9828,1342829,1342965,23
5479,87,9829,1342964,1343051,26
6983,93,9829,1343051,1343144,37
1356,217,9829,1343144,1343361,42
7515,237,9830,1343360,1343597,1
4727,169,9830,1343597,1343766,4
8321,95,9830,1343766,1343861,25
7369,131,9830,1343861,1343992,35
2321,266,9830,1343992,1344258,47
8103,47,9831,1344257,1344304,2
2616,186,9831,1344304,1344490,23
1528,90,9831,1344490,1344580,30
1935,17,9831,1344580,1344597,33
2304,84,9832,1344596,1344680,21
1427,168,9832,1344680,1344848,29
8702,106,9832,1344848,1344954,31
3383,188,9832,1344954,1345142,42
1142,100,9832,1345142,1345242,44
8534,70,9832,1345242,1345312,49
7341,178,9832,1345312,1345490,50
8686,184,9833,1345489,1345673,1
7445,23,9833,1345673,1345696,4
1812,35,9833,1345696,1345731,12
2578,35,9834,1345730,1345765,21
7228,52,9834,1345765,1345817,24
2475,239,9834,1345817,1346056,34
1606,201,9834,1346056,1346257,48
5850,143,9835,1346256,1346399,18
6248,95,9835,1346399,1346494,18
9294,160,9835,1346494,1346654,20
9817,173,9835,1346654,1346827,23
8854,70,9836,1346826,1346896,12
9044,279,9836,1346896,1347175,28
1055,117,9836,1347175,1347292,43
5728,92,9837,1347291,1347383,14
1129,289,9837,1473575,1473864,24
4239,46,9837,1347526,1347572,41
4631,178,9838,1347571,1347749,23
1586,66,9838,1347749,1347815,26
7216,113,9838,1347815,1347928,32
8499,87,9838,1347928,1348015,39
8886,110,9839,1348014,1348124,6
7849,214,9839,1348124,1348338,26
3558,5,9839,1348338,1348343,35
3480,134,9839,1348343,1348477,45
3081,40,9840,1348476,1348516,4
5949,87,9840,1348516,1348603,38
8734,132,9841,1348602,1348734,13
8875,86,9841,1348734,1348820,27
9595,149,9841,1348820,1348969,31
6755,221,9841,1348969,1349190,32
7484,112,9841,1349190,1349302,33
6168,136,9842,1349301,1349437,3
7966,245,9842,1349437,1349682,12
1964,14,9843,1349681,1349695,4
6507,242,9843,1349695,1349937,7
1699,119,9843,1349937,1350056,9
4665,21,9843,1350056,1350077,17
7828,95,9843,1350077,1350172,19
3889,24,9844,1350171,1350195,3
5601,96,9844,1350195,1350291,14
4328,94,9844,1350291,1350385,18
1894,164,9844,1350385,1350549,21
6668,54,9844,1350549,1350603,34
4889,216,9844,1350603,1350819,38
5578,129,9845,1350818,1350947,10
9071,265,9845,1350947,1351212,32
8926,123,9846,1351211,1351334,33
7898,68,9846,1351334,1351402,34
3978,231,9847,1351401,1351632,23
2819,210,9847,1351632,1351842,36
8848,56,9847,1351842,1351898,47
9762,191,9847,1351898,1352089,48
1786,281,9848,1352088,1352369,13
7517,43,9848,1352369,1352412,16
2242,271,9848,1352412,1352683,45
2671,277,9849,1352682,1352959,12
4703,77,9849,1352959,1353036,12
1398,214,9849,1353036,1353250,20
1967,293,9849,1353250,1353543,35
9295,23,9849,1353543,1353566,43
6120,263,9850,1353565,1353828,3
1257,279,9850,1353828,1354107,9
1574,71,9850,1354107,1354178,11
4844,220,9850,1354178,1354398,14
2529,195,9850,1354398,1354593,24
2634,275,9850,1354593,1354868,34
8341,154,9851,1354867,1355021,21
6324,88,9851,1355021,1355109,46
1138,12,9852,1355108,1355120,1
2765,23,9852,1355120,1355143,16
5799,282,9852,1355143,1355425,16
7699,7,9852,1355425,1355432,39
5879,4,9853,1355431,1355435,19
2022,277,9854,1355434,1355711,38
7940,295,9854,1355711,1356006,44
5694,193,9854,1356006,1356199,45
7142,167,9855,1356198,1356365,17
8560,204,9855,1356365,1356569,21
5633,230,9855,1356569,1356799,24
3205,151,9855,1356799,1356950,30
2413,228,9855,1356950,1357178,32
8658,9,9855,1357178,1357187,47
5449,219,9856,1357186,1357405,7
5518,282,9856,1473705,1473987,8
7437,266,9856,1357545,1357811,11
5752,165,9856,1357811,1357976,15
5836,102,9856,1357976,1358078,28
1415,248,9856,1358078,1358326,40
7479,149,9856,1358326,1358475,46
5639,188,9856,1358475,1358663,49
4976,235,9857,1358662,1358897,9
3005,186,9857,1358897,1359083,32
7587,299,9858,1359082,1359381,14
9500,153,9858,1359381,1359534,47
3531,289,9859,1473840,1474129,25
6379,106,9859,1359677,1359783,32
3884,217,9859,1359783,1360000,46
8672,33,9860,1359999,1360032,4
6148,294,9860,1360032,1360326,5
8153,256,9860,1360326,1360582,7
4471,269,9860,1360582,1360851,20
3904,21,9860,1360851,1360872,46
2566,300,9861,1473980,1474280,6
3503,54,9861,1361018,1361072,25
7905,274,9861,1361072,1361346,47
2737,212,9861,1361346,1361558,49
9401,132,9862,1361557,1361689,7
6697,216,9862,1361689,1361905,11
2571,130,9862,1361905,1362035,29
5522,50,9862,1362035,1362085,34
3097,166,9862,1362085,1362251,42
9169,103,9862,1362251,1362354,43
1280,196,9862,1362354,1362550,45
4256,72,9862,1362550,1362622,49
6386,259,9862,1362622,1362881,49
8371,181,9863,1362880,1363061,7
4296,89,9864,1363060,1363149,18
5492,279,9864,1363149,1363428,26
6014,38,9864,1363428,1363466,40
2868,98,9864,1363466,1363564,44
6891,13,9865,1363563,1363576,15
8872,69,9865,1363576,1363645,21
8423,230,9865,1363645,1363875,23
9865,137,9865,1363875,1364012,36
3365,29,9865,1364012,1364041,38
8038,282,9865,1364041,1364323,42
3684,205,9865,1364323,1364528,43
6229,173,9865,1364528,1364701,50
2365,262,9866,1364700,1364962,7
9551,234,9866,1364962,1365196,26
7256,207,9866,1365196,1365403,39
2223,81,9867,1365402,1365483,7
7736,96,9867,1365483,1365579,7
3842,54,9867,1365579,1365633,8
7724,139,9867,1365633,1365772,21
6083,230,9867,1365772,1366002,36
3879,254,9868,1366001,1366255,1
1947,147,9868,1366255,1366402,27
7305,224,9868,1366402,1366626,27
6252,203,9868,1366626,1366829,42
5110,212,9869,1366828,1367040,39
5946,218,9869,1367040,1367258,41
2720,171,9870,1367257,1367428,11
2179,170,9870,1367428,1367598,28
3605,149,9870,1367598,1367747,31
8139,206,9870,1367747,1367953,46
2555,111,9871,1367952,1368063,15
5313,178,9871,1368063,1368241,17
2494,79,9871,1368241,1368320,20
3814,191,9871,1368320,1368511,36
4896,91,9872,1368510,1368601,11
4836,81,9872,1368601,1368682,15
4353,226,9872,1368682,1368908,18
2944,212,9872,1368908,1369120,22
3597,65,9872,1369120,1369185,24
8210,195,9872,1369185,1369380,45
9737,175,9872,1369380,1369555,45
1499,293,9872,1474126,1474419,46
6254,78,9872,1369698,1369776,50
8871,184,9873,1369775,1369959,4
8541,221,9873,1369959,1370180,12
8816,182,9873,1370180,1370362,14
3141,186,9873,1370362,1370548,19
1650,150,9873,1370548,1370698,20
3710,161,9873,1370698,1370859,26
5677,242,9874,1370858,1371100,26
8612,222,9874,1371100,1371322,44
7111,237,9874,1371322,1371559,45
9012,63,9875,1371558,1371621,15
5505,165,9875,1371621,1371786,22
2415,8,9875,1371786,1371794,33
2082,281,9875,1371794,1372075,37
9329,217,9875,1372075,1372292,43
2822,127,9876,1372291,1372418,5
7654,204,9876,1372418,1372622,6
4455,117,9876,1372622,1372739,33
9702,166,9876,1372739,1372905,36
2718,2,9876,1372905,1372907,45
4169,278,9876,1372907,1373185,49
8519,56,9877,1373184,1373240,3
2441,250,9877,1373240,1373490,7
7042,269,9877,1373490,1373759,8
8308,206,9877,1373759,1373965,17
6748,252,9877,1373965,1374217,24
1149,295,9877,1474279,1474574,33
5920,217,9877,1374352,1374569,40
7028,219,9877,1374569,1374788,41
8218,202,9878,1374787,1374989,9
5381,44,9878,1374989,1375033,19
8664,69,9878,1375033,1375102,42
9794,88,9878,1375102,1375190,44
2664,11,9878,1375190,1375201,50
4957,49,9878,1375201,1375250,50
1768,52,9879,1375249,1375301,8
4774,289,9879,1375301,1375590,21
2364,142,9879,1375590,1375732,33
4135,218,9880,1375731,1375949,18
4186,15,9880,1375949,1375964,20
5063,273,9880,1375964,1376237,21
9774,109,9880,1376237,1376346,42
1140,28,9881,1376345,1376373,18
7943,299,9882,1376372,1376671,3
4803,278,9882,1376671,1376949,39
3131,153,9882,1376949,1377102,49
5407,82,9882,1377102,1377184,49
4738,245,9883,1377183,1377428,11
6586,203,9883,1377428,1377631,25
7244,127,9883,1377631,1377758,25
8603,290,9883,1377758,1378048,27
5498,36,9883,1378048,1378084,31
6767,225,9883,1378084,1378309,32
2158,275,9883,1378309,1378584,35
2181,142,9884,1378583,1378725,9
9231,140,9884,1378725,1378865,11
6782,168,9884,1378865,1379033,31
7191,17,9884,1379033,1379050,36
6132,209,9884,1379050,1379259,37
7480,114,9885,1379258,1379372,11
2954,57,9885,1379372,1379429,15
9104,264,9885,1379429,1379693,31
6741,69,9885,1379693,1379762,43
4111,244,9885,1379762,1380006,46
8008,204,9886,1380005,1380209,5
8798,218,9886,1380209,1380427,6
3453,140,9886,1380427,1380567,20
7633,256,9886,1380567,1380823,37
6575,118,9886,1380823,1380941,40
9196,52,9886,1380941,1380993,43
1527,226,9887,1380992,1381218,39
8933,189,9888,1381217,1381406,4
1737,261,9888,1381406,1381667,7
2090,90,9888,1381667,1381757,33
9459,265,9888,1381757,1382022,38
6915,206,9888,1382022,1382228,39
3695,29,9888,1382228,1382257,40
7718,57,9888,1382257,1382314,42
2552,285,9889,1382313,1382598,15
1749,35,9889,1382598,1382633,47
9275,9,9890,1382632,1382641,8
5590,67,9890,1382641,1382708,9
6311,58,9890,1382708,1382766,15
4497,31,9890,1382766,1382797,16
9132,58,9890,1382797,1382855,22
9107,89,9890,1382855,1382944,23
3112,10,9890,1382944,1382954,29
2161,105,9890,1382954,1383059,45
2496,278,9891,1383058,1383336,3
9318,98,9891,1383336,1383434,18
9311,6,9891,1383434,1383440,25
9885,149,9891,1383440,1383589,25
5846,9,9891,1383589,1383598,26
5059,139,9892,1383597,1383736,3
9953,214,9892,1383736,1383950,8
2859,135,9892,1383950,1384085,35
4721,258,9892,1384085,1384343,39
3335,178,9892,1384343,1384521,41
1687,231,9893,1384520,1384751,3
3713,31,9893,1384751,1384782,20
7510,75,9893,1384782,1384857,22
4688,53,9893,1384857,1384910,28
7862,135,9893,1384910,1385045,29
6154,257,9893,1385045,1385302,30
5585,199,9893,1385302,1385501,32
7066,176,9893,1385501,1385677,36
5691,28,9893,1385677,1385705,43
8518,288,9894,1385704,1385992,5
4656,246,9894,1385992,1386238,10
5770,2,9894,1386238,1386240,14
4342,274,9894,1386240,1386514,15
1383,146,9894,1386514,1386660,27
5433,288,9894,1386660,1386948,39
3604,178,9894,1386948,1387126,41
8736,224,9894,1387126,1387350,45
7114,45,9895,1387349,1387394,23
6677,227,9895,1387394,1387621,31
1393,18,9895,1387621,1387639,39
2279,228,9895,1387639,1387867,41
2502,283,9896,1387866,1388149,1
7665,8,9896,1388149,1388157,5
2574,233,9896,1388157,1388390,11
8622,200,9896,1388390,1388590,28
1806,29,9896,1388590,1388619,29
3690,185,9896,1388619,1388804,30
2167,8,9896,1388804,1388812,33
1361,88,9897,1388811,1388899,4
2098,240,9897,1388899,1389139,5
7832,79,9897,1389139,1389218,7
7847,47,9897,1389218,1389265,26
5305,70,9897,1389265,1389335,46
7871,12,9897,1389335,1389347,50
9035,298,9898,1474412,1474710,9
3328,184,9898,1389487,1389671,26
2940,191,9898,1389671,1389862,50
7426,220,9899,1389861,1390081,22
2938,286,9899,1390081,1390367,25
9345,130,9899,1390367,1390497,50
2001,209,9900,1390496,1390705,1
3258,180,9900,1390705,1390885,7
2443,217,9900,1390885,1391102,13
9285,187,9900,1391102,1391289,24
9950,29,9900,1391289,1391318,43
9450,269,9901,1391317,1391586,1
3211,215,9901,1391586,1391801,16
4436,111,9901,1391801,1391912,42
5662,87,9902,1391911,1391998,12
7188,240,9902,1391998,1392238,42
1727,10,9903,1392237,1392247,1
1089,272,9903,1392247,1392519,30
9307,25,9903,1392519,1392544,31
7214,51,9903,1392544,1392595,41
2408,24,9903,1392595,1392619,45
3053,169,9904,1392618,1392787,16
3805,37,9904,1392787,1392824,40
5602,71,9905,1392823,1392894,9
3726,35,9905,1392894,1392929,13
4588,156,9905,1392929,1393085,15
9328,59,9905,1393085,1393144,18
1021,37,9905,1393144,1393181,36
6224,101,9905,1393181,1393282,39
6493,240,9906,1393281,1393521,4
6315,34,9906,1393521,1393555,12
2537,257,9906,1393555,1393812,26
3475,87,9906,1393812,1393899,27
4247,228,9906,1393899,1394127,30
6517,126,9906,1394127,1394253,34
1562,205,9907,1394252,1394457,15
8849,166,9907,1394457,1394623,29
4452,278,9907,1394623,1394901,36
7825,46,9907,1394901,1394947,49
2405,298,9908,1394946,1395244,3
7566,126,9908,1395244,1395370,28
7687,81,9908,1395370,1395451,36
9842,286,9908,1395451,1395737,38
8451,43,9908,1395737,1395780,44
3880,267,9909,1395779,1396046,14
8717,229,9909,1396046,1396275,40
6988,151,9909,1396275,1396426,50
4461,237,9910,1396425,1396662,11
8419,208,9910,1396662,1396870,16
7824,236,9910,1396870,1397106,22
8601,54,9910,1397106,1397160,25
5044,53,9910,1397160,1397213,31
9377,224,9911,1397212,1397436,9
7251,229,9911,1397436,1397665,29
6852,152,9911,1397665,1397817,40
7568,140,9911,1397817,1397957,48
5344,64,9912,1397956,1398020,8
3079,133,9912,1398020,1398153,10
4711,1,9912,1398153,1398154,24
9705,66,9912,1398154,1398220,27
1141,195,9912,1398220,1398415,33
7513,26,9913,1398414,1398440,24
2341,283,9914,1474553,1474836,9
3893,35,9914,1398580,1398615,39
3242,74,9914,1398615,1398689,43
2153,110,9915,1398688,1398798,15
7433,103,9915,1398798,1398901,36
1848,257,9916,1398900,1399157,5
3850,249,9916,1399157,1399406,21
4628,16,9916,1399406,1399422,28
8361,177,9916,1399422,1399599,33
5788,72,9917,1399598,1399670,5
2353,285,9917,1399670,1399955,13
8263,23,9917,1399955,1399978,41
4107,151,9918,1399977,1400128,2
2446,47,9918,1400128,1400175,25
1182,48,9919,1400174,1400222,5
8376,255,9919,1400222,1400477,15
8650,131,9919,1400477,1400608,15
5398,41,9919,1400608,1400649,23
2342,285,9919,1400649,1400934,28
9533,29,9919,1400934,1400963,36
5414,289,9920,1400962,1401251,17
2945,13,9920,1401251,1401264,31
2711,270,9920,1401264,1401534,38
7893,270,9920,1401534,1401804,46
4181,153,9921,1401803,1401956,1
4712,105,9921,1401956,1402061,5
2057,140,9921,1402061,1402201,6
3486,60,9921,1402201,1402261,7
9861,66,9921,1402261,1402327,10
7443,135,9921,1402327,1402462,22
7155,190,9921,1402462,1402652,23
7031,37,9921,1402652,1402689,29
9430,108,9921,1402689,1402797,30
1120,100,9921,1402797,1402897,49
3567,130,9922,1402896,1403026,13
6433,57,9922,1403026,1403083,19
3570,34,9922,1403083,1403117,24
2882,113,9922,1403117,1403230,26
6541,183,9922,1403230,1403413,27
7171,296,9922,1474684,1474980,32
3457,275,9922,1403557,1403832,34
4761,249,9922,1403832,1404081,38
3580,65,9922,1404081,1404146,50
6279,257,9923,1404145,1404402,2
4424,37,9923,1404402,1404439,10
9152,98,9923,1404439,1404537,23
2735,122,9923,1404537,1404659,27
9578,40,9923,1404659,1404699,30
4714,195,9923,1404699,1404894,31
5520,3,9923,1404894,1404897,40
4142,86,9923,1404897,1404983,42
8023,196,9924,1404982,1405178,2
6642,118,9924,1405178,1405296,4
2842,134,9924,1405296,1405430,10
4630,103,9924,1405430,1405533,28
3093,269,9924,1405533,1405802,30
8825,208,9924,1405802,1406010,36
9491,129,9925,1406009,1406138,37
3720,75,9926,1406137,1406212,19
6170,135,9926,1406212,1406347,19
1419,165,9926,1406347,1406512,40
6759,153,9926,1406512,1406665,41
9915,264,9927,1406664,1406928,17
4496,211,9928,1406927,1407138,40
3162,185,9928,1407138,1407323,48
1814,204,9928,1407323,1407527,50
5043,204,9929,1407526,1407730,26
8198,195,9929,1407730,1407925,29
5538,149,9930,1407924,1408073,28
6607,261,9930,1408073,1408334,34
4030,222,9930,1408334,1408556,36
6021,85,9930,1408556,1408641,36
5998,71,9930,1408641,1408712,42
3048,293,9930,1408712,1409005,48
7637,73,9931,1409004,1409077,8
5174,145,9931,1409077,1409222,12
5156,78,9931,1409222,1409300,28
6797,267,9931,1409300,1409567,35
3294,157,9931,1409567,1409724,45
4970,6,9931,1409724,1409730,49
6307,157,9932,1409729,1409886,3
7441,177,9932,1409886,1410063,30
8226,273,9932,1474835,1475108,33
2278,12,9933,1410197,1410209,25
4393,154,9933,1410209,1410363,29
8568,39,9933,1410363,1410402,29
2028,169,9934,1410401,1410570,6
9880,61,9934,1410570,1410631,29
7622,165,9934,1410631,1410796,32
4314,48,9934,1410796,1410844,33
5657,179,9934,1410844,1411023,33
3058,213,9934,1411023,1411236,42
1041,59,9935,1411235,1411294,15
1701,272,9935,1474972,1475244,19
8768,240,9935,1411427,1411667,25
3373,11,9935,1411667,1411678,26
9800,164,9935,1411678,1411842,33
9468,296,9936,1411841,1412137,14
4616,101,9936,1412137,1412238,18
1710,68,9936,1412238,1412306,27
2890,198,9936,1412306,1412504,34
6946,74,9937,1412503,1412577,15
9588,249,9937,1412577,1412826,31
4064,29,9937,1412826,1412855,40
5445,124,9938,1412854,1412978,12
7253,19,9938,1412978,1412997,12
3271,215,9938,1412997,1413212,32
3854,99,9938,1413212,1413311,39
9797,118,9938,1413311,1413429,39
7671,267,9938,1413429,1413696,48
6340,253,9939,1413695,1413948,8
7259,26,9939,1413948,1413974,12
6282,235,9940,1413973,1414208,1
4586,31,9940,1414208,1414239,22
6068,45,9940,1414239,1414284,43
7850,149,9940,1414284,1414433,48
7716,280,9941,1414432,1414712,11
3426,263,9941,1414712,1414975,15
3994,165,9941,1414975,1415140,16
9516,280,9941,1415140,1415420,18
6043,108,9941,1415420,1415528,22
2877,246,9941,1415528,1415774,23
4685,246,9941,1415774,1416020,25
5612,154,9941,1416020,1416174,26
5242,219,9941,1416174,1416393,27
4511,20,9941,1416393,1416413,45
2426,236,9941,1416413,1416649,48
5323,72,9942,1416648,1416720,2
5426,77,9942,1416720,1416797,5
3886,121,9942,1416797,1416918,29
2860,186,9942,1416918,1417104,46
4323,245,9943,1417103,1417348,20
1340,26,9944,1417347,1417373,14
4250,253,9944,1417373,1417626,30
1029,224,9945,1417625,1417849,6
9847,139,9945,1417849,1417988,7
8408,148,9945,1417988,1418136,12
4249,205,9945,1418136,1418341,20
7797,90,9945,1418341,1418431,22
7630,197,9945,1418431,1418628,34
5925,87,9945,1418628,1418715,36
3411,234,9945,1418715,1418949,47
6657,284,9946,1418948,1419232,3
7335,62,9946,1419232,1419294,5
4958,95,9946,1419294,1419389,11
4354,206,9946,1419389,1419595,12
4639,108,9946,1419595,1419703,13
6985,275,9946,1419703,1419978,20
8531,182,9946,1419978,1420160,24
3074,189,9946,1420160,1420349,32
3733,205,9946,1420349,1420554,35
3760,174,9947,1420553,1420727,9
5206,131,9947,1420727,1420858,10
8785,60,9948,1420857,1420917,2
1661,29,9948,1420917,1420946,31
4522,56,9949,1420945,1421001,5
8972,58,9949,1421001,1421059,5
3612,191,9949,1421059,1421250,6
4128,135,9949,1421250,1421385,26
1702,149,9950,1421384,1421533,14
3465,46,9950,1421533,1421579,20
2058,49,9950,1421579,1421628,22
2166,8,9950,1421628,1421636,23
8315,13,9950,1421636,1421649,26
4523,183,9950,1421649,1421832,47
3172,43,9950,1421832,1421875,48
4066,192,9951,1421874,1422066,1
4376,287,9951,1422066,1422353,4
9838,85,9951,1422353,1422438,9
6382,74,9951,1422438,1422512,48
6203,15,9952,1422511,1422526,11
9667,96,9952,1422526,1422622,11
3108,157,9952,1422622,1422779,20
3142,130,9952,1422779,1422909,23
1558,38,9952,1422909,1422947,27
9504,216,9952,1422947,1423163,29
6419,142,9952,1423163,1423305,34
7904,31,9952,1423305,1423336,41
7199,106,9953,1423335,1423441,29
9708,59,9953,1423441,1423500,46
8057,52,9953,1423500,1423552,50
2262,74,9954,1423551,1423625,1
1943,136,9954,1423625,1423761,9
5261,218,9954,1423761,1423979,12
6149,26,9954,1423979,1424005,21
5705,74,9954,1424005,1424079,22
6978,88,9954,1424079,1424167,27
6939,148,9954,1424167,1424315,42
6694,281,9954,1424315,1424596,43
6874,120,9954,1424596,1424716,47
5889,76,9955,1424715,1424791,3
7534,220,9955,1424791,1425011,23
7265,37,9956,1425010,1425047,20
9638,4,9956,1425047,1425051,47
4799,67,9957,1425050,1425117,30
1169,29,9958,1425116,1425145,16
4032,14,9958,1425145,1425159,16
7077,284,9958,1425159,1425443,27
2827,42,9958,1425443,1425485,35
6012,171,9959,1425484,1425655,2
9633,201,9959,1425655,1425856,24
7381,169,9959,1425856,1426025,38
1069,135,9959,1426025,1426160,39
1095,151,9960,1426159,1426310,45
6339,15,9961,1426309,1426324,9
4985,43,9961,1426324,1426367,25
7003,126,9962,1426366,1426492,1
1050,43,9962,1426492,1426535,16
8485,269,9962,1426535,1426804,29
9476,194,9963,1426803,1426997,33
5942,168,9963,1426997,1427165,47
8099,122,9964,1427164,1427286,3
3943,140,9964,1427286,1427426,4
8381,95,9964,1427426,1427521,11
6618,55,9964,1427521,1427576,14
2307,48,9964,1427576,1427624,22
2657,65,9964,1427624,1427689,35
5537,248,9964,1427689,1427937,40
8209,213,9964,1427937,1428150,41
5281,184,9964,1428150,1428334,42
4254,85,9965,1428333,1428418,21
4428,45,9965,1428418,1428463,24
5892,109,9965,1428463,1428572,43
6494,46,9965,1428572,1428618,47
2271,300,9965,1475067,1475367,49
9284,98,9966,1428764,1428862,2
2455,170,9966,1428862,1429032,5
3808,32,9966,1429032,1429064,38
9398,217,9967,1429063,1429280,14
7342,201,9967,1429280,1429481,16
6817,7,9967,1429481,1429488,22
6731,147,9967,1429488,1429635,25
2367,24,9967,1429635,1429659,32
4706,76,9967,1429659,1429735,38
1285,169,9967,1429735,1429904,42
6471,51,9967,1429904,1429955,45
1681,9,9967,1429955,1429964,50
3015,59,9968,1429963,1430022,8
8279,181,9968,1430022,1430203,49
7220,14,9969,1430202,1430216,10
2908,299,9969,1475220,1475519,24
6729,75,9970,1430358,1430433,4
8159,151,9970,1430433,1430584,28
1836,272,9970,1430584,1430856,30
1131,128,9970,1430856,1430984,34
3010,268,9971,1430983,1431251,38
7150,253,9971,1431251,1431504,48
3524,234,9972,1431503,1431737,11
5411,30,9972,1431737,1431767,21
1865,104,9972,1431767,1431871,22
6239,70,9972,1431871,1431941,24
7818,297,9972,1431941,1432238,37
9431,165,9973,1432237,1432402,1
2557,136,9973,1432402,1432538,13
9710,4,9973,1432538,1432542,45
6223,216,9975,1432540,1432756,2
6733,49,9975,1432756,1432805,3
3189,134,9975,1432805,1432939,8
5041,218,9975,1432939,1433157,11
1068,231,9975,1433157,1433388,14
3143,140,9975,1433388,1433528,43
4773,231,9976,1433527,1433758,8
1770,300,9976,1433758,1434058,17
4993,91,9976,1434058,1434149,17
3542,87,9976,1434149,1434236,26
5997,245,9976,1434236,1434481,30
9925,36,9976,1434481,1434517,45
7575,63,9977,1434516,1434579,25
5444,73,9977,1434579,1434652,43
1680,278,9978,1434651,1434929,7
5676,202,9978,1434929,1435131,9
3513,154,9978,1435131,1435285,17
6511,21,9978,1435285,1435306,20
9744,248,9978,1435306,1435554,50
9549,34,9979,1435553,1435587,16
4065,20,9979,1435587,1435607,19
8380,102,9979,1435607,1435709,41
4701,256,9979,1435709,1435965,45
2714,150,9979,1435965,1436115,49
9137,113,9979,1436115,1436228,49
2814,95,9979,1436228,1436323,50
3099,106,9979,1436323,1436429,50
1971,282,9980,1436428,1436710,48
6845,162,9981,1436709,1436871,3
8436,81,9981,1436871,1436952,8
7605,155,9981,1436952,1437107,31
9364,94,9981,1437107,1437201,37
8258,201,9981,1437201,1437402,39
6606,117,9982,1437401,1437518,27
2493,280,9982,1437518,1437798,43
9613,254,9983,1437797,1438051,4
6128,22,9983,1438051,1438073,7
5056,204,9983,1438073,1438277,12
6158,225,9983,1438277,1438502,30
5149,231,9983,1438502,1438733,42
2284,148,9984,1438732,1438880,4
6031,192,9984,1438880,1439072,8
8754,228,9984,1439072,1439300,9
7273,100,9984,1439300,1439400,23
4591,79,9985,1439399,1439478,9
4120,239,9985,1439478,1439717,36
4612,7,9985,1439717,1439724,44
2767,128,9986,1439723,1439851,11
4755,198,9986,1439851,1440049,11
1560,220,9986,1440049,1440269,26
5831,136,9986,1440269,1440405,36
9792,218,9986,1440405,1440623,36
4973,115,9986,1440623,1440738,38
8675,169,9986,1440738,1440907,40
5941,40,9986,1440907,1440947,47
1724,205,9987,1440946,1441151,13
7192,236,9987,1441151,1441387,13
4276,46,9987,1441387,1441433,37
2192,278,9988,1441432,1441710,2
8446,49,9988,1441710,1441759,4
6095,132,9988,1441759,1441891,8
1013,246,9988,1441891,1442137,9
1497,268,9988,1442137,1442405,10
5730,163,9988,1442405,1442568,10
6535,167,9988,1442568,1442735,11
1203,228,9988,1442735,1442963,15
7852,240,9988,1442963,1443203,16
1914,25,9988,1443203,1443228,19
6025,191,9988,1443228,1443419,38
5118,222,9988,1443419,1443641,43
8283,245,9989,1443640,1443885,22
4519,65,9989,1443885,1443950,27
9567,293,9989,1443950,1444243,37
7989,94,9990,1444242,1444336,1
5079,234,9990,1444336,1444570,11
7930,162,9990,1444570,1444732,12
9406,36,9990,1444732,1444768,26
2197,151,9990,1444768,1444919,37
7263,26,9990,1444919,1444945,43
7916,217,9991,1444944,1445161,43
9968,276,9992,1445160,1445436,15
8703,12,9992,1445436,1445448,33
7087,225,9992,1445448,1445673,37
3167,142,9992,1445673,1445815,43
3474,230,9992,1445815,1446045,44
3406,47,9993,1446044,1446091,3
5224,190,9993,1446091,1446281,4
9305,165,9993,1446281,1446446,14
6473,181,9993,1446446,1446627,16
2420,122,9993,1446627,1446749,35
8681,246,9993,1446749,1446995,36
9483,121,9993,1446995,1447116,39
2809,157,9993,1447116,1447273,40
4281,54,9993,1447273,1447327,49
1922,108,9994,1447326,1447434,11
5019,89,9994,1447434,1447523,14
2686,26,9994,1447523,1447549,17
5152,133,9994,1447549,1447682,20
9460,15,9994,1447682,1447697,35
9999,104,9994,1447697,1447801,37
8256,52,9995,1447800,1447852,8
8529,171,9995,1447852,1448023,15
1248,23,9995,1448023,1448046,16
3744,91,9995,1448046,1448137,21
2685,149,9995,1448137,1448286,45
8918,30,9996,1448285,1448315,29
2846,32,9996,1448315,1448347,31
8230,30,9996,1448347,1448377,31
1376,22,9996,1448377,1448399,33
1707,81,9996,1448399,1448480,37
1856,25,9996,1448480,1448505,45
2507,152,9997,1448504,1448656,15
6945,280,9997,1448656,1448936,15
8508,46,9997,1448936,1448982,19
1188,130,9997,1448982,1449112,21
1864,74,9997,1449112,1449186,38
8104,22,9997,1449186,1449208,38
8089,55,9998,1449207,1449262,6
1608,61,9998,1449262,1449323,8
7271,143,9998,1449323,1449466,15
7667,186,9998,1449466,1449652,18
4248,19,9998,1449652,1449671,25
1104,19,9998,1449671,1449690,43
6590,70,9999,1449689,1449759,25
7616,99,9999,1449759,1449858,36
7288,167,9999,1449858,1450025,42
1109,95,9999,1450025,1450120,47

Average Waiting Time = 724967

Average Turn Around Time = 725115
