Process,Burst Time,Arrival Time,Waiting Time,Turn Around Time,Priority
38,15,1,0,15,3
30,46,1,15,61,5
1,18,2,60,78,1
24,16,3,77,93,2
22,15,4,92,107,1
93,44,4,107,151,1
11,4,7,148,152,5
88,41,7,152,193,5
32,29,9,191,220,3
41,1,11,218,219,1
21,40,12,3285,3325,2
72,45,12,3286,3331,3
20,46,13,292,338,1
17,20,14,337,357,2
3,26,16,355,381,5
65,29,16,381,410,5
57,26,17,409,435,2
100,29,17,435,464,4
25,47,18,3289,3336,2
14,1,19,498,499,3
23,36,18,500,536,3
67,3,19,535,538,5
2,27,20,537,564,1
47,29,21,563,592,1
16,38,20,593,631,1
51,26,21,630,656,2
26,44,22,3296,3340,4
34,16,23,690,706,2
58,37,23,706,743,3
86,20,24,742,762,1
66,18,24,762,780,4
96,26,24,780,806,5
55,28,25,805,833,3
12,19,25,833,852,4
29,2,27,850,852,1
84,29,27,852,881,3
10,16,27,881,897,5
80,30,27,897,927,5
63,40,29,925,965,5
18,28,31,963,991,3
81,11,31,991,1002,5
37,9,32,1001,1010,3
90,36,33,1009,1045,4
7,8,34,1044,1052,5
27,27,34,1052,1079,5
44,31,35,1078,1109,3
28,1,36,1108,1109,2
15,43,38,3288,3331,4
36,35,40,1141,1176,1
35,45,42,3288,3333,3
8,30,43,1212,1242,4
59,40,45,1276,1316,1
85,44,45,1316,1360,1
40,48,44,3295,3343,2
4,16,49,1356,1372,2
95,20,49,1372,1392,4
71,35,49,1392,1427,5
912,148,50,1426,1574,23
79,39,51,3300,3339,2
110,183,52,3229,3412,1
5,9,52,1717,1726,2
857,10,53,1725,1735,37
50,21,54,1734,1755,2
64,39,54,1755,1794,3
68,23,55,1793,1816,2
54,47,56,3369,3416,3
542,264,56,1854,2118,29
477,145,56,2118,2263,32
442,48,56,2263,2311,36
70,16,58,2309,2325,2
94,24,58,2325,2349,4
375,88,58,2349,2437,41
899,191,58,2437,2628,44
985,170,58,3275,3445,46
33,19,59,2766,2785,1
60,22,59,2785,2807,1
612,65,60,3398,3463,5
811,241,60,2851,3092,17
809,132,60,3092,3224,39
489,49,62,3222,3271,46
46,5,63,3460,3465,3
623,130,63,3465,3595,49
97,49,64,3594,3643,3
83,15,64,3643,3658,5
207,287,64,123405,123692,24
39,23,65,3874,3897,2
61,48,65,3897,3945,2
456,271,65,123475,123746,45
53,41,66,4160,4201,2
69,36,66,4201,4237,4
9,3,67,4236,4239,1
49,16,67,4239,4255,2
87,29,67,4255,4284,3
539,107,67,4284,4391,36
183,37,67,4391,4428,40
74,7,68,4427,4434,3
78,7,69,4433,4440,3
76,35,69,4440,4475,4
196,213,69,4475,4688,25
45,36,70,4687,4723,1
729,75,70,4723,4798,22
577,110,70,4798,4908,37
717,87,70,4908,4995,48
217,13,71,4994,5007,39
121,143,72,5006,5149,8
126,290,73,123540,123830,1
75,2,73,5346,5348,3
77,36,74,5347,5383,1
91,19,74,5383,5402,2
298,46,74,5402,5448,2
649,2,74,5448,5450,29
92,26,77,5447,5473,3
89,36,75,5475,5511,3
602,198,77,123669,123867,3
823,14,77,5666,5680,12
173,193,77,5680,5873,27
989,230,78,123678,123908,2
316,293,78,123686,123979,17
99,48,81,6279,6327,2
959,151,80,6328,6479,2
42,30,82,6477,6507,4
52,17,82,6507,6524,5
276,205,82,123776,123981,39
82,15,83,6722,6737,2
860,235,85,123762,123997,11
424,148,85,6951,7099,45
760,12,86,7098,7110,50
19,1,87,7109,7110,2
712,277,87,123774,124051,41
62,5,88,7330,7335,1
849,116,88,7335,7451,36
798,269,88,123829,124098,41
454,205,88,7672,7877,44
13,25,89,7876,7901,1
98,37,90,7900,7937,1
56,50,90,7937,7987,2
73,27,90,7987,8014,3
274,160,90,8014,8174,49
426,36,91,8173,8209,8
321,30,91,8209,8239,30
48,10,93,8237,8247,5
43,24,95,8245,8269,1
390,223,97,123876,124099,48
937,55,98,8479,8534,2
794,65,98,8534,8599,2
6,25,99,8598,8623,4
31,47,99,8623,8670,4
714,211,100,8669,8880,50
841,62,103,8877,8939,7
787,164,103,8939,9103,18
480,229,103,123870,124099,50
815,222,104,123900,124122,1
292,187,105,9522,9709,5
933,80,106,9708,9788,9
502,111,106,9788,9899,20
215,151,106,9899,10050,35
866,71,107,10049,10120,45
894,202,108,10119,10321,25
398,228,108,123893,124121,46
872,8,109,10545,10553,4
435,8,109,10553,10561,6
675,299,109,123893,124192,10
916,94,109,10788,10882,28
523,38,111,10880,10918,6
300,69,111,10918,10987,23
194,249,112,123970,124219,20
148,251,112,124021,124272,30
907,230,114,11401,11631,25
840,34,114,11631,11665,26
537,103,116,11663,11766,41
682,91,116,11766,11857,47
562,146,117,11856,12002,8
767,291,122,124023,124314,33
941,191,123,12235,12426,47
460,116,124,12425,12541,10
184,265,124,124114,124379,30
758,163,125,12738,12901,8
844,38,126,12900,12938,41
306,224,130,124171,124395,6
169,2,130,13136,13138,16
297,152,131,13137,13289,25
339,190,132,13288,13478,18
237,228,133,124182,124410,4
713,161,133,13687,13848,25
200,295,133,124185,124480,35
408,8,133,14073,14081,41
546,183,133,14081,14264,42
494,220,134,14263,14483,50
965,66,135,14482,14548,24
629,132,135,14548,14680,42
163,288,136,124289,124577,2
742,29,137,14866,14895,27
622,236,138,124354,124590,41
525,33,139,15114,15147,10
453,217,139,124396,124613,26
422,75,139,15340,15415,46
385,11,139,15415,15426,47
308,164,140,15425,15589,12
687,56,140,15589,15645,21
113,196,140,15645,15841,27
396,68,141,15840,15908,6
359,74,141,15908,15982,26
598,222,142,124397,124619,28
947,135,142,16194,16329,46
253,251,143,124413,124664,47
218,206,147,16529,16735,21
935,292,147,124428,124720,25
862,255,149,124496,124751,15
889,181,149,17187,17368,40
382,151,149,17368,17519,44
547,46,150,17518,17564,28
688,58,151,17563,17621,33
335,121,152,17620,17741,4
595,150,154,17739,17889,46
942,78,155,17888,17966,19
388,186,157,17964,18150,6
822,4,157,18150,18154,26
376,201,157,124550,124751,26
311,253,158,124513,124766,49
632,125,161,18580,18705,23
634,135,164,18702,18837,35
268,156,165,18836,18992,32
651,183,168,18989,19172,28
344,218,168,124540,124758,31
786,137,170,19386,19523,34
162,209,174,124611,124820,14
213,152,174,19660,19812,34
331,266,176,124585,124851,18
535,46,177,20042,20088,6
521,233,177,124646,124879,12
796,46,177,20292,20338,44
226,21,179,20336,20357,30
209,180,183,20353,20533,11
779,180,184,20532,20712,27
659,1,187,20709,20710,14
271,142,188,20709,20851,28
304,227,188,124643,124870,46
807,9,189,21075,21084,16
693,217,190,124670,124887,1
190,74,190,21281,21355,15
138,2,193,21352,21354,23
952,136,193,21354,21490,41
204,51,194,21489,21540,47
997,246,195,124662,124908,13
871,175,195,21759,21934,26
439,179,195,21934,22113,38
589,294,196,124709,125003,1
731,101,196,22310,22411,6
897,16,196,22411,22427,24
608,19,198,22425,22444,2
203,284,200,124774,125058,46
265,284,201,124839,125123,44
252,254,203,124927,125181,40
510,110,206,23073,23183,27
514,253,206,124940,125193,36
238,107,206,23421,23528,39
413,211,207,23527,23738,45
175,165,208,23737,23902,8
833,124,209,23901,24025,40
663,104,211,24023,24127,19
212,227,215,124979,125206,47
957,74,217,24326,24400,26
923,298,218,124985,125283,44
908,150,221,24614,24764,40
122,18,222,24763,24781,29
999,77,223,24780,24857,20
950,95,223,24857,24952,42
836,73,223,24952,25025,45
119,96,224,25024,25120,50
996,162,225,25119,25281,12
112,68,225,25281,25349,15
604,66,227,25347,25413,10
552,133,227,25413,25546,31
391,241,229,125051,125292,9
630,80,230,25764,25844,50
782,285,231,125059,125344,22
563,70,231,26074,26144,44
618,216,232,26143,26359,25
755,218,233,26358,26576,15
639,258,234,125142,125400,37
880,12,235,26773,26785,14
455,53,235,26785,26838,28
812,12,236,26837,26849,13
635,160,239,26846,27006,22
417,133,239,27006,27139,24
281,110,240,27138,27248,44
587,166,243,27245,27411,18
703,34,245,27409,27443,9
976,217,247,27441,27658,17
199,95,248,27657,27752,39
594,34,249,27751,27785,13
887,261,249,125191,125452,40
332,23,250,27978,28001,3
854,5,250,28001,28006,47
305,160,251,28005,28165,36
367,132,254,28162,28294,30
718,146,254,28294,28440,38
370,21,255,28439,28460,19
487,283,256,125222,125505,50
177,114,257,28681,28795,7
732,161,257,28795,28956,18
189,279,260,125297,125576,12
351,134,263,29154,29288,46
327,199,263,29288,29487,49
101,277,265,125350,125627,9
421,80,265,29706,29786,42
603,63,265,29786,29849,47
445,255,266,125424,125679,6
793,106,266,30050,30156,27
667,282,267,125444,125726,38
601,149,270,30386,30535,47
972,187,271,30534,30721,43
233,211,272,30720,30931,9
386,173,272,30931,31104,10
926,1,274,31102,31103,14
949,64,275,31102,31166,12
801,229,275,31166,31395,29
817,133,277,31393,31526,38
642,159,277,31526,31685,49
259,286,278,125493,125779,17
914,194,278,125591,125785,23
720,209,278,32094,32303,29
962,249,278,125587,125836,30
172,281,278,125615,125896,41
674,130,280,32720,32850,8
504,239,283,125696,125935,16
558,234,287,125718,125952,48
333,292,288,125729,126021,15
541,60,288,33472,33532,32
349,72,289,33531,33603,32
751,196,288,33604,33800,32
301,164,290,33798,33962,11
149,138,290,33962,34100,22
420,201,291,34099,34300,5
330,272,292,125785,126057,25
404,25,293,34530,34555,18
694,288,294,125837,126125,44
394,168,296,34770,34938,32
468,26,297,34937,34963,17
461,179,298,34962,35141,22
757,14,299,35140,35154,32
134,100,299,35154,35254,41
885,197,299,35254,35451,48
155,64,301,35449,35513,6
568,79,301,35513,35592,8
902,45,301,35592,35637,40
536,262,303,125893,126155,50
222,233,306,125964,126197,23
269,63,307,36042,36105,4
416,57,309,36103,36160,1
783,19,309,36160,36179,26
641,251,311,125987,126238,5
904,102,311,36382,36484,19
726,129,311,36484,36613,27
830,28,314,36610,36638,2
451,111,314,36638,36749,43
832,85,314,36749,36834,46
221,56,317,36831,36887,7
129,103,317,36887,36990,8
681,236,317,126010,126246,15
934,280,317,126021,126301,42
585,97,319,37435,37532,11
146,169,320,37531,37700,18
781,65,324,37696,37761,4
762,73,325,37760,37833,8
771,257,326,126067,126324,35
211,247,329,126164,126411,3
958,149,330,38210,38359,21
342,228,330,126197,126425,48
392,104,331,38571,38675,8
533,45,331,38675,38720,35
132,20,332,38719,38739,9
167,217,332,38739,38956,13
548,266,332,126204,126470,20
790,133,334,39173,39306,3
749,10,336,39304,39314,37
336,119,340,39310,39429,26
927,92,341,39428,39520,12
144,236,341,126229,126465,25
154,97,343,39750,39847,41
943,88,344,39846,39934,8
262,148,346,39932,40080,20
518,286,346,126242,126528,44
886,45,346,40298,40343,48
986,276,347,126295,126571,25
284,63,347,40574,40637,41
701,70,348,40636,40706,11
513,186,348,40706,40892,25
206,298,348,126347,126645,50
915,232,349,126451,126683,26
186,65,350,41306,41371,27
223,165,350,41371,41536,35
881,254,350,126469,126723,48
554,67,351,41748,41815,1
384,108,352,41814,41922,47
153,127,352,41922,42049,49
633,180,353,42048,42228,9
628,67,353,42228,42295,35
968,81,354,42294,42375,9
135,135,354,42375,42510,44
495,207,354,42510,42717,46
325,4,356,42715,42719,5
362,93,357,42718,42811,13
273,183,358,42810,42993,18
340,217,358,126502,126719,28
315,4,359,43205,43209,4
677,127,359,43209,43336,38
870,170,361,43334,43504,36
777,284,362,126527,126811,2
607,127,362,43691,43818,34
150,184,362,43818,44002,39
964,8,365,43999,44007,18
877,26,366,44006,44032,6
982,119,366,44032,44151,47
418,189,367,44150,44339,21
403,251,367,126618,126869,23
637,155,368,44526,44681,30
647,73,369,44680,44753,37
267,245,370,126671,126916,16
310,2,370,44947,44949,17
145,3,372,44947,44950,4
512,235,372,44950,45185,49
258,224,373,126697,126921,11
705,98,375,45398,45496,12
708,172,375,45496,45668,32
572,19,375,45668,45687,44
474,69,375,45687,45756,47
176,160,376,45755,45915,12
567,79,376,45915,45994,50
380,59,377,45993,46052,17
545,141,377,46052,46193,32
826,10,377,46193,46203,44
171,233,379,126711,126944,12
527,18,379,46405,46423,28
586,275,381,126715,126990,10
918,228,381,126768,126996,15
365,145,382,46869,47014,11
888,229,382,126797,127026,27
648,49,382,47212,47261,34
475,271,382,126792,127063,38
429,294,383,126852,127146,4
242,202,383,47704,47906,6
991,252,384,126935,127187,4
313,78,384,48115,48193,26
329,116,386,48191,48307,7
890,207,388,126988,127195,16
896,25,389,48499,48524,8
205,36,390,48523,48559,30
198,300,392,126974,127274,24
272,66,394,48772,48838,34
449,65,395,48837,48902,25
151,251,395,127053,127304,44
379,215,397,49118,49333,29
188,237,397,127089,127326,32
501,39,400,49543,49582,39
395,94,400,49582,49676,45
940,237,406,127113,127350,12
837,78,406,49874,49952,34
553,145,407,49951,50096,47
168,26,408,50095,50121,39
802,277,408,127130,127407,44
620,32,409,50338,50370,40
105,7,409,50370,50377,44
473,144,409,50377,50521,47
109,146,410,50520,50666,38
348,30,411,50665,50695,24
656,94,412,50694,50788,14
883,158,414,50786,50944,50
939,205,415,127202,127407,27
136,29,416,51140,51169,28
734,126,416,51169,51295,35
746,123,418,51293,51416,11
165,38,418,51416,51454,27
973,115,419,51453,51568,12
763,240,420,127203,127443,39
322,295,420,127218,127513,42
230,4,424,51987,51991,8
448,285,425,127292,127577,11
852,34,425,52206,52240,15
111,271,425,127358,127629,20
346,81,427,52457,52538,24
814,46,429,52536,52582,7
735,93,429,52582,52675,11
319,1,429,52675,52676,42
827,148,430,52675,52823,1
706,145,430,52823,52968,31
556,60,431,52967,53027,4
616,90,431,53027,53117,18
728,222,435,127399,127621,7
769,300,435,127390,127690,22
557,236,436,127464,127700,46
987,185,437,127518,127703,8
141,161,438,53967,54128,25
497,153,438,54128,54281,35
788,3,439,54280,54283,23
875,196,440,54282,54478,18
856,195,441,54477,54672,43
431,53,442,54671,54724,38
818,297,442,127477,127774,41
741,197,445,54942,55139,4
920,37,445,55139,55176,28
893,80,446,55175,55255,27
898,51,447,55254,55305,5
990,247,447,127549,127796,7
661,163,449,55523,55686,17
853,12,450,55685,55697,3
954,19,451,55696,55715,6
846,230,452,127575,127805,45
244,133,453,55929,56062,10
719,166,454,56061,56227,9
381,4,454,56227,56231,19
285,115,454,56231,56346,45
529,267,455,127577,127844,35
256,195,459,127652,127847,2
775,17,459,56754,56771,27
107,155,459,56771,56926,48
317,258,462,127613,127871,21
361,217,462,57154,57371,29
254,251,463,127647,127898,50
838,159,464,57592,57751,18
979,106,465,57750,57856,31
409,68,466,57855,57923,11
571,247,467,127692,127939,6
850,107,469,58122,58229,45
816,61,470,58228,58289,8
876,177,472,58287,58464,24
606,196,473,127745,127941,23
353,99,475,58649,58748,45
580,134,476,58747,58881,7
772,200,477,127738,127938,37
644,111,478,59078,59189,35
792,166,478,59189,59355,40
509,88,478,59355,59443,43
181,68,480,59441,59509,22
314,76,480,59509,59585,25
360,106,481,59584,59690,17
664,69,481,59690,59759,45
910,224,482,127723,127947,4
270,266,483,127748,128014,27
530,205,485,60163,60368,17
522,13,485,60368,60381,24
922,40,489,60377,60417,18
835,222,490,60416,60638,18
806,280,486,127778,128058,18
956,215,490,60871,61086,34
157,193,490,61086,61279,45
318,287,492,127847,128134,5
627,134,492,61482,61616,15
579,198,492,61616,61814,41
789,93,495,61811,61904,35
463,282,496,127909,128191,9
930,36,497,62123,62159,11
696,235,502,127975,128210,4
753,260,502,128000,128260,4
373,208,503,62573,62781,28
293,63,505,62779,62842,32
236,13,507,62840,62853,16
774,91,507,62853,62944,37
369,200,510,62941,63141,21
593,92,513,63138,63230,24
492,231,514,128055,128286,26
354,219,514,63422,63641,38
724,166,516,63639,63805,1
723,58,518,63803,63861,39
407,188,519,63860,64048,16
483,224,520,128099,128323,8
901,207,520,64228,64435,9
672,199,520,64435,64634,29
401,248,521,128095,128343,10
636,7,522,64859,64866,31
831,297,523,128114,128411,10
662,177,523,65092,65269,13
142,146,523,65269,65415,30
869,224,524,128222,128446,2
347,58,524,65602,65660,12
932,54,524,65660,65714,16
995,245,525,128251,128496,40
491,293,527,128262,128555,29
278,195,529,66135,66330,30
574,194,530,66329,66523,7
839,5,532,66521,66526,9
722,298,532,128311,128609,33
414,196,532,66765,66961,45
795,137,534,66959,67096,22
859,223,538,128408,128631,16
133,182,540,67285,67467,20
486,92,544,67463,67555,13
925,100,545,67554,67654,42
864,60,546,67653,67713,29
892,294,547,128385,128679,49
879,46,550,67946,67992,20
865,203,550,67992,68195,46
861,212,551,68194,68406,32
704,176,554,68403,68579,23
450,267,554,128465,128732,43
193,253,556,128509,128762,9
756,225,556,69005,69230,42
873,230,556,69230,69460,49
249,159,557,69459,69618,2
540,46,558,69617,69663,50
511,221,560,128553,128774,5
551,6,560,69866,69872,35
476,76,561,69871,69947,24
605,38,562,69946,69984,44
891,135,563,69983,70118,2
185,74,563,70118,70192,30
921,37,564,70191,70228,27
520,2,565,70227,70229,41
532,135,568,70226,70361,38
992,1,569,70360,70361,25
115,223,569,128572,128795,26
813,242,569,128570,128812,42
929,263,569,128587,128850,42
277,203,571,128702,128905,19
498,40,571,71148,71188,41
312,275,572,128683,128958,41
152,280,574,128754,129034,6
936,116,574,71608,71724,42
645,41,575,71723,71764,48
275,31,576,71763,71794,10
984,35,577,71793,71828,5
747,116,577,71828,71944,28
670,143,577,71944,72087,40
255,258,578,128810,129068,13
197,52,580,72304,72356,2
251,31,580,72356,72387,39
399,36,585,72382,72418,22
592,162,587,128913,129075,19
761,270,588,128853,129123,41
613,197,592,72778,72975,20
438,243,593,128885,129128,18
488,179,593,73207,73386,48
500,61,595,73384,73445,8
824,245,595,128906,129151,13
243,134,597,73663,73797,20
423,288,597,128933,129221,31
621,2,599,74011,74013,11
975,112,599,74013,74125,20
279,27,599,74125,74152,50
919,93,600,74151,74244,30
478,157,601,74243,74400,36
867,146,603,74398,74544,27
610,17,604,74543,74560,13
519,205,604,74560,74765,20
764,229,605,129032,129261,8
733,215,606,74944,75159,36
227,21,606,75159,75180,38
214,199,607,75179,75378,15
538,71,609,75376,75447,40
851,53,611,75445,75498,44
685,174,613,75496,75670,7
590,33,613,75670,75703,20
611,9,614,75702,75711,13
104,203,616,75709,75912,20
459,4,616,75912,75916,46
358,110,617,75915,76025,3
245,100,618,76024,76124,27
565,292,618,129010,129302,36
192,12,619,76361,76373,40
419,165,620,76372,76537,22
116,87,620,76537,76624,48
791,168,622,76622,76790,43
993,181,623,76789,76970,42
496,127,623,76970,77097,49
555,102,624,77096,77198,33
576,282,624,129091,129373,47
671,290,628,129137,129427,29
804,278,629,129228,129506,1
960,140,630,77827,77967,5
900,68,630,77967,78035,32
909,94,631,78034,78128,42
400,60,632,78127,78187,45
730,55,632,78187,78242,50
174,292,636,129283,129575,45
447,29,637,78453,78482,12
967,244,639,129350,129594,15
178,75,639,78702,78777,21
295,82,643,78773,78855,5
744,269,643,129397,129666,26
219,30,644,79047,79077,5
234,152,644,79077,79229,33
131,142,645,79228,79370,47
994,195,647,79368,79563,24
652,194,647,79563,79757,36
437,14,649,79755,79769,24
528,172,649,79769,79941,40
638,45,651,79939,79984,12
507,143,654,79981,80124,11
828,163,654,80124,80287,13
264,69,654,80287,80356,25
485,117,656,80354,80471,37
366,32,658,80469,80501,6
334,244,658,129470,129714,8
928,172,658,80682,80854,26
288,47,659,80853,80900,22
588,233,659,129482,129715,22
524,294,661,129481,129775,29
953,61,666,81356,81417,34
584,98,667,81416,81514,44
225,242,667,129532,129774,49
195,101,669,81749,81850,44
1000,80,671,81848,81928,14
118,57,672,81927,81984,17
371,292,673,129531,129823,49
581,208,674,82219,82427,4
676,147,677,82424,82571,42
653,277,679,129579,129856,36
845,85,680,82806,82891,4
434,237,680,129639,129876,11
471,1,682,83105,83106,32
224,187,682,83106,83293,32
843,126,683,83292,83418,3
797,283,683,129660,129943,28
356,47,683,83631,83678,46
969,157,684,83677,83834,10
803,171,684,83834,84005,32
752,134,686,84003,84137,2
241,211,687,84136,84347,36
428,150,689,84345,84495,25
287,300,690,129703,130003,18
446,262,690,129810,130072,26
364,277,691,129849,130126,34
690,151,693,85139,85290,13
368,86,693,85290,85376,27
484,180,698,85371,85551,5
658,289,698,129888,130177,21
239,164,699,85781,85945,15
299,77,699,85945,86022,19
974,138,702,86019,86157,29
397,268,705,129947,130215,50
650,96,707,86375,86471,34
139,297,706,129992,130289,34
534,130,708,86692,86822,49
355,169,709,86821,86990,7
597,269,709,130073,130342,28
683,177,711,87201,87378,9
472,287,712,130106,130393,18
692,188,712,87610,87798,24
411,14,712,87798,87812,26
506,170,713,87811,87981,21
855,103,714,87980,88083,29
283,265,714,130178,130443,32
619,113,714,88296,88409,47
646,185,715,88408,88593,36
596,98,716,88592,88690,17
931,225,716,130242,130467,39
458,143,716,88889,89032,45
560,164,718,89030,89194,23
770,51,718,89194,89245,42
402,60,721,89242,89302,29
503,258,721,130237,130495,42
323,47,721,89527,89574,45
944,149,722,89573,89722,29
508,72,722,89722,89794,42
863,212,724,89792,90004,29
821,70,724,90004,90074,32
374,59,726,90072,90131,23
378,134,727,90130,90264,28
499,214,728,90263,90477,17
963,166,730,90475,90641,16
320,296,730,130273,130569,28
878,134,730,90854,90988,41
490,297,733,130335,130632,21
440,187,734,91215,91402,44
977,183,738,91398,91581,21
882,113,738,91581,91694,48
739,111,739,91693,91804,41
482,64,739,91804,91868,49
389,69,740,91867,91936,4
737,145,742,91934,92079,11
235,166,742,130482,130648,14
158,146,742,92220,92366,29
847,300,744,130412,130712,38
257,137,745,92597,92734,44
917,56,746,92733,92789,11
493,204,749,92786,92990,7
457,299,748,130488,130787,7
140,242,750,130560,130802,35
583,255,751,130576,130831,46
911,294,752,130614,130908,11
702,207,752,93873,94080,35
805,221,755,130717,130938,2
296,207,756,130738,130945,37
377,9,756,94463,94472,50
905,202,757,94471,94673,21
743,169,757,94673,94842,29
517,63,757,94842,94905,48
309,80,759,94903,94983,37
655,168,760,94982,95150,28
467,231,763,130736,130967,6
543,18,763,95349,95367,38
350,202,764,95366,95568,20
338,71,764,95568,95639,47
103,69,767,95636,95705,17
766,196,767,95705,95901,25
352,5,767,95901,95906,39
383,149,770,95903,96052,33
180,280,771,130743,131023,31
466,260,772,130802,131062,13
665,3,773,96485,96488,14
229,8,773,96488,96496,44
286,104,774,96495,96599,45
848,76,775,96598,96674,13
387,215,777,130847,131062,4
406,246,780,130854,131100,5
250,197,780,97084,97281,20
372,76,781,97280,97356,48
302,105,782,97355,97460,23
246,27,782,97460,97487,43
978,134,785,97484,97618,13
906,159,788,97615,97774,10
980,229,788,130876,131105,11
591,7,788,97990,97997,30
678,262,791,130871,131133,22
640,254,791,130901,131155,25
260,235,792,130932,131167,17
425,152,795,98675,98827,6
575,145,795,98827,98972,43
955,104,795,98972,99076,46
343,130,797,99074,99204,7
393,162,797,99204,99366,17
216,193,797,99366,99559,37
680,236,798,130948,131184,48
689,8,801,99768,99776,5
669,27,801,99776,99803,35
108,16,802,99802,99818,28
432,192,804,99816,100008,38
736,206,804,100008,100214,42
868,26,807,100211,100237,13
570,298,808,130957,131255,24
479,300,809,131027,131327,10
660,142,810,100678,100820,5
208,196,810,100820,101016,17
550,46,810,101016,101062,42
441,259,812,131102,131361,17
748,114,812,101282,101396,40
970,86,813,101395,101481,21
945,249,813,131135,131384,42
128,6,815,101704,101710,14
363,283,816,131156,131439,46
695,59,824,101926,101985,24
106,80,826,101983,102063,28
946,273,827,131223,131496,47
544,195,829,102265,102460,13
691,23,830,102459,102482,15
710,194,831,102481,102675,12
465,190,832,102674,102864,22
738,195,832,102864,103059,50
578,38,834,103057,103095,28
643,15,837,103092,103107,30
740,134,839,103105,103239,17
810,215,839,131285,131500,39
164,97,839,103438,103535,45
773,100,840,103534,103634,47
337,175,842,103632,103807,1
280,196,844,103805,104001,45
130,252,845,131275,131527,20
263,233,845,104219,104452,38
433,255,847,131326,131581,39
858,108,849,104647,104755,8
754,147,849,104755,104902,15
625,53,849,104902,104955,23
679,39,849,104955,104994,41
842,42,849,104994,105036,49
566,99,851,105034,105133,24
716,283,851,131345,131628,29
179,30,852,105364,105394,19
341,216,852,131428,131644,39
778,53,853,105592,105645,45
780,79,855,105643,105722,15
721,171,856,105721,105892,30
924,77,857,105891,105968,40
938,203,857,105968,106171,42
759,119,857,106171,106290,47
626,81,860,106287,106368,29
117,93,861,106367,106460,13
231,57,862,106459,106516,25
776,133,863,106515,106648,38
481,201,863,106648,106849,42
569,261,865,131432,131693,39
182,92,865,107046,107138,49
137,70,866,107137,107207,15
988,43,866,107207,107250,19
526,65,866,107250,107315,26
614,293,868,131477,131770,28
981,193,870,107524,107717,39
191,169,870,107717,107886,42
874,130,871,107885,108015,37
415,157,871,108015,108172,42
615,38,877,108166,108204,26
324,44,874,108207,108251,26
715,192,879,108246,108438,20
707,47,879,108438,108485,21
505,244,881,131535,131779,15
247,88,881,108705,108793,50
120,133,882,108792,108925,45
307,68,884,108923,108991,7
727,275,884,131563,131838,48
201,285,886,131623,131908,32
452,33,887,109414,109447,2
290,57,888,109446,109503,36
202,222,888,131707,131929,37
785,249,891,131707,131956,20
709,25,891,109918,109943,41
114,202,892,109942,110144,9
631,210,894,131755,131965,30
430,215,894,131766,131981,39
819,150,895,110538,110688,30
564,226,897,110686,110912,29
561,175,897,110912,111087,32
961,189,898,111086,111275,27
784,287,900,131742,132029,18
600,237,900,131804,132041,35
170,228,902,131829,132057,4
971,129,902,111939,112068,32
768,267,903,131840,132107,11
248,121,903,112283,112404,14
808,26,905,112402,112428,26
998,84,906,112427,112511,17
291,151,907,112510,112661,21
913,146,911,131958,132104,14
765,188,912,112797,112985,50
725,216,916,112981,113197,41
143,172,917,113196,113368,16
326,88,917,113368,113456,42
711,202,920,113453,113655,5
220,299,921,131874,132173,13
884,90,923,113872,113962,27
160,156,924,113961,114117,15
125,113,924,114117,114230,42
668,226,927,131957,132183,4
948,59,927,114437,114496,28
166,61,930,114493,114554,6
684,46,934,114550,114596,20
147,124,936,114594,114718,5
427,290,938,131935,132225,49
232,55,940,114951,115006,11
464,235,941,131997,132232,42
599,22,943,115228,115250,28
266,6,943,115250,115256,42
698,48,944,115255,115303,14
582,140,945,115302,115442,20
210,8,948,115439,115447,2
410,129,946,115449,115578,2
470,81,948,115576,115657,31
289,132,949,115656,115788,41
657,17,950,115787,115804,4
294,104,950,115804,115908,15
895,42,951,115907,115949,12
654,222,951,115949,116171,33
820,214,952,116170,116384,15
700,234,952,132023,132257,27
951,178,952,116582,116760,46
357,55,954,116758,116813,1
686,294,954,132045,132339,4
303,4,954,117023,117027,26
983,223,956,132180,132403,3
825,162,957,117181,117343,12
799,174,957,117343,117517,34
282,185,957,117517,117702,34
261,178,959,117700,117878,27
444,4,960,117877,117881,10
573,186,960,117881,118067,30
531,266,960,132174,132440,42
673,88,962,118290,118378,1
666,9,965,118375,118384,18
161,135,964,118385,118520,18
559,98,965,118519,118617,21
240,155,966,118616,118771,39
102,77,967,118770,118847,48
750,233,968,132237,132470,16
624,224,969,132271,132495,1
187,177,969,119238,119415,13
412,243,969,132270,132513,35
228,170,971,119638,119808,10
156,291,972,132293,132584,24
834,104,973,120023,120127,42
609,80,975,120271,120351,18
462,190,983,120343,120533,18
697,163,974,132436,132599,19
159,89,985,120531,120620,35
515,220,985,132372,132592,45
469,41,986,120835,120876,31
829,187,987,120875,121062,35
903,73,987,121062,121135,50
443,274,988,132373,132647,45
549,294,989,132412,132706,38
345,173,990,121582,121755,5
800,125,991,121754,121879,2
436,37,993,121877,121914,7
124,41,993,121914,121955,15
328,98,994,121954,122052,10
127,15,994,122052,122067,11
617,175,994,122067,122242,17
405,105,994,122242,122347,40
745,82,996,122345,122427,12
516,15,998,122425,122440,11
123,137,999,122439,122576,8
699,92,999,122576,122668,10
966,19,999,122668,122687,39
5374,182,8000,125695,125877,1
8254,42,8000,125877,125919,20
6485,161,8000,125919,126080,30
1334,186,8000,126080,126266,35
6359,287,8001,1470938,1471225,1
1428,198,8001,126490,126688,7
4178,51,8001,126688,126739,37
7034,197,8001,126739,126936,40
8887,133,8002,126935,127068,13
9247,276,8002,1386759,1387035,15
5675,1,8002,127288,127289,22
8643,2,8002,127289,127291,25
4482,235,8002,1386809,1387044,38
9982,48,8003,127516,127564,9
4605,134,8003,127564,127698,40
2990,14,8004,127697,127711,1
1598,43,8004,127711,127754,5
8866,222,8004,127754,127976,17
3073,186,8004,127976,128162,25
6527,143,8004,128162,128305,40
7531,95,8004,128305,128400,42
3834,109,8004,128400,128509,43
6656,142,8004,128509,128651,50
3882,48,8005,128650,128698,5
5851,54,8005,128698,128752,5
6750,288,8005,1470938,1471226,20
1163,200,8005,128979,129179,22
1839,207,8005,129179,129386,27
5567,58,8005,129386,129444,30
9570,240,8005,1386880,1387120,33
1052,141,8005,129661,129802,47
3470,157,8006,129801,129958,45
9480,238,8006,1386895,1387133,45
6959,148,8007,130181,130329,15
8305,172,8007,130329,130501,22
4228,123,8007,130501,130624,27
5410,254,8007,1386907,1387161,37
3748,151,8008,130848,130999,7
9191,157,8008,130999,131156,11
4917,20,8008,131156,131176,44
6639,195,8008,131176,131371,45
2688,160,8009,131370,131530,20
5539,157,8009,131530,131687,46
5821,15,8009,131687,131702,49
5603,286,8010,1470942,1471228,8
3049,218,8010,131918,132136,10
2826,193,8010,132136,132329,20
7648,12,8010,132329,132341,29
9836,27,8010,132341,132368,29
2348,43,8011,132367,132410,11
6143,203,8011,132410,132613,13
4602,237,8011,1386994,1387231,23
7359,94,8011,132838,132932,34
1709,174,8011,132932,133106,36
5571,19,8011,133106,133125,40
9202,141,8011,133125,133266,47
6151,213,8012,133265,133478,20
8269,207,8012,133478,133685,31
2878,215,8012,133685,133900,32
9349,84,8012,133900,133984,37
9064,88,8012,133984,134072,40
2152,155,8013,134071,134226,17
4319,179,8013,134226,134405,25
6228,248,8013,1386999,1387247,36
4174,164,8013,134635,134799,38
5903,111,8013,134799,134910,41
3779,204,8014,134909,135113,18
9105,30,8014,135113,135143,30
6884,259,8014,1387012,1387271,35
7454,4,8014,135377,135381,48
9434,250,8015,1387042,1387292,31
9895,170,8015,135608,135778,32
5141,236,8015,1387071,1387307,32
2636,221,8015,1387090,1387311,33
2003,152,8016,136215,136367,1
5487,173,8016,136367,136540,3
5115,57,8016,136540,136597,6
3707,163,8016,136597,136760,9
9735,81,8016,136760,136841,23
3447,165,8017,136840,137005,5
9849,201,8017,137005,137206,23
5182,174,8017,137206,137380,42
8229,208,8018,137379,137587,42
5324,48,8018,137587,137635,46
3260,213,8019,137634,137847,19
1122,259,8019,1387088,1387347,24
1648,36,8019,138066,138102,44
5688,18,8020,138101,138119,13
9826,36,8020,138119,138155,31
3408,71,8020,138155,138226,42
5780,32,8021,138225,138257,2
8071,83,8021,138257,138340,18
6147,173,8021,138340,138513,41
2397,109,8021,138513,138622,42
2340,245,8021,1387121,1387366,45
2273,65,8021,138846,138911,47
7910,200,8022,138910,139110,5
2987,91,8022,139110,139201,6
6452,2,8022,139201,139203,10
4477,257,8022,1387137,1387394,13
8714,108,8022,139431,139539,37
1413,6,8023,139538,139544,2
9868,82,8023,139544,139626,3
6977,16,8023,139626,139642,21
6597,128,8023,139642,139770,36
9454,248,8023,1387163,1387411,36
8746,112,8024,139999,140111,17
1210,141,8024,140111,140252,22
6336,261,8025,1387189,1387450,15
6862,27,8025,140471,140498,32
5844,158,8025,140498,140656,44
4538,257,8026,1387222,1387479,16
4448,181,8026,140882,141063,25
5527,251,8026,1387262,1387513,33
7486,293,8026,1470930,1471223,44
6301,13,8026,141502,141515,50
4209,46,8027,141514,141560,6
8119,2,8027,141560,141562,8
5562,59,8027,141562,141621,8
3203,218,8027,141621,141839,28
9814,254,8027,1387346,1387600,30
6635,120,8027,142065,142185,46
5053,299,8028,1476660,1476959,28
6174,84,8028,142404,142488,34
7855,169,8028,142488,142657,36
1487,67,8028,142657,142724,37
1670,297,8028,1470952,1471249,44
1294,238,8029,1387506,1387744,19
3965,292,8029,1470966,1471258,23
9788,176,8029,143385,143561,33
4901,181,8029,143561,143742,47
2719,80,8030,143741,143821,25
7747,12,8030,143821,143833,43
9725,136,8031,143832,143968,3
8112,165,8031,143968,144133,8
5645,58,8031,144133,144191,16
5478,250,8031,1387572,1387822,20
5093,8,8031,144418,144426,25
5813,112,8031,144426,144538,25
2511,143,8031,144538,144681,29
8395,170,8031,144681,144851,32
6999,176,8031,144851,145027,36
8732,269,8031,1387599,1387868,39
5938,198,8031,145250,145448,40
5868,128,8031,145448,145576,49
1798,283,8032,1470981,1471264,4
7272,186,8032,145796,145982,17
1307,172,8032,145982,146154,18
6374,296,8032,1470983,1471279,29
9172,174,8032,146373,146547,41
9897,238,8032,1387759,1387997,48
8084,191,8033,146769,146960,7
6869,8,8033,146960,146968,9
3727,233,8033,1387769,1388002,16
3584,76,8033,147195,147271,25
9659,28,8033,147271,147299,48
9212,59,8034,147298,147357,40
2383,15,8035,147356,147371,18
2570,3,8035,147371,147374,23
3070,186,8035,147374,147560,33
8277,208,8035,147560,147768,47
5078,193,8036,147767,147960,4
5186,288,8036,1470992,1471280,28
4446,243,8036,1387836,1388079,30
6491,276,8036,1387855,1388131,34
1666,293,8036,1471000,1471293,40
1115,117,8036,148852,148969,49
3861,259,8037,1387963,1388222,2
1006,290,8038,1471012,1471302,6
2436,108,8038,149414,149522,23
4493,58,8038,149522,149580,32
4182,219,8038,149580,149799,38
1755,195,8039,149798,149993,6
1002,290,8039,1471021,1471311,13
3714,151,8039,150221,150372,28
6926,257,8039,1388104,1388361,37
2334,59,8039,150597,150656,40
2257,102,8040,150655,150757,3
4530,42,8040,150757,150799,34
6933,288,8040,1471029,1471317,34
1802,272,8040,1388187,1388459,36
8417,144,8040,151253,151397,41
6270,22,8040,151397,151419,45
7082,169,8041,151418,151587,16
8532,299,8041,1476650,1476949,20
8078,219,8041,1388300,1388519,22
2422,242,8041,1388295,1388537,45
8364,142,8042,152251,152393,7
5401,77,8042,152393,152470,22
2813,215,8042,152470,152685,29
2421,250,8042,1388310,1388560,30
9321,285,8042,1471050,1471335,32
7004,235,8042,1388383,1388618,35
5052,89,8042,153366,153455,43
2277,46,8043,153454,153500,6
3547,57,8043,153500,153557,16
7029,150,8043,153557,153707,28
4340,241,8043,1388392,1388633,37
4168,41,8043,153932,153973,43
2534,284,8043,1471055,1471339,49
7972,144,8044,154194,154338,4
1230,19,8044,154338,154357,11
9029,102,8044,154357,154459,18
9517,9,8044,154459,154468,21
2755,205,8044,154468,154673,22
9469,149,8044,154673,154822,46
1020,178,8045,154821,154999,7
9319,241,8045,1388466,1388707,7
6614,37,8045,155221,155258,30
8648,53,8046,155257,155310,20
4741,52,8046,155310,155362,26
2026,236,8046,1388482,1388718,26
1767,34,8046,155586,155620,38
5108,86,8046,155620,155706,42
7746,191,8046,155706,155897,45
6644,21,8047,155896,155917,36
5954,255,8047,1388487,1388742,36
8276,107,8048,156146,156253,6
9660,100,8048,156253,156353,13
6904,251,8048,1388516,1388767,14
6193,265,8048,1388552,1388817,19
6713,3,8048,156793,156796,22
2228,285,8048,1471053,1471338,30
3346,280,8048,1471060,1471340,33
7760,177,8049,157238,157415,2
1882,35,8049,157415,157450,6
5509,291,8050,1471059,1471350,7
1189,170,8050,157671,157841,13
4414,4,8050,157841,157845,18
7157,218,8051,157844,158062,27
6805,125,8051,158062,158187,34
6587,198,8052,158186,158384,2
1378,184,8052,158384,158568,11
1585,116,8052,158568,158684,36
8102,79,8052,158684,158763,40
4105,290,8052,1471066,1471356,46
9356,111,8053,158982,159093,3
4349,265,8053,1388823,1389088,21
9419,83,8053,159317,159400,33
4655,237,8053,1388866,1389103,40
6848,197,8054,159621,159818,5
7984,35,8054,159818,159853,16
8524,51,8054,159853,159904,20
5158,156,8054,159904,160060,34
3523,248,8054,1388883,1389131,47
5653,147,8055,160278,160425,7
6822,69,8055,160425,160494,14
1926,81,8055,160494,160575,16
5420,215,8055,160575,160790,31
5967,168,8056,160789,160957,5
2892,262,8056,1388906,1389168,48
3881,46,8057,161179,161225,10
3039,116,8057,161225,161341,18
2675,101,8057,161341,161442,20
1040,174,8057,161442,161616,23
2596,80,8057,161616,161696,24
8596,299,8057,1476638,1476937,41
9669,246,8058,1389002,1389248,10
2168,116,8058,162143,162259,19
2968,187,8058,162259,162446,26
6240,210,8058,162446,162656,36
1785,155,8059,162655,162810,14
6931,97,8059,162810,162907,22
9829,75,8059,162907,162982,49
2593,105,8060,162981,163086,2
9230,221,8060,1389029,1389250,33
6294,261,8060,1389016,1389277,35
1942,179,8060,163537,163716,41
3478,177,8060,163716,163893,45
1779,293,8061,1471075,1471368,20
6992,64,8061,164119,164183,48
2653,103,8061,164183,164286,48
4004,13,8061,164286,164299,49
4104,202,8063,164297,164499,3
7093,42,8063,164499,164541,25
7913,115,8063,164541,164656,46
8340,274,8064,1389108,1389382,4
1014,212,8064,164876,165088,23
7149,104,8064,165088,165192,46
2063,98,8065,165191,165289,13
4858,138,8065,165289,165427,19
6260,208,8065,165427,165635,49
4363,172,8066,165634,165806,5
6484,25,8066,165806,165831,33
2744,8,8066,165831,165839,46
3312,206,8067,165838,166044,36
9678,273,8067,1389160,1389433,47
9597,193,8067,166263,166456,48
8575,165,8068,166455,166620,1
8426,50,8068,166620,166670,3
2286,92,8068,166670,166762,3
2777,147,8068,166762,166909,37
3841,5,8068,166909,166914,48
8817,146,8068,166914,167060,50
5654,158,8069,167059,167217,6
1750,296,8069,1476630,1476926,12
9809,111,8069,167440,167551,21
5926,286,8069,1471092,1471378,36
9278,286,8069,1471096,1471382,46
3868,135,8070,168000,168135,2
9256,201,8070,168135,168336,14
3632,69,8070,168336,168405,21
1290,49,8070,168405,168454,27
1053,88,8070,168454,168542,28
2738,267,8071,1389377,1389644,34
9129,37,8071,168765,168802,43
9381,223,8072,1389428,1389651,19
8578,228,8072,1389431,1389659,28
8762,39,8072,169236,169275,34
7840,1,8073,169274,169275,6
5471,190,8073,169275,169465,13
3609,46,8073,169465,169511,15
8767,96,8073,169511,169607,16
9042,143,8073,169607,169750,24
4338,96,8073,169750,169846,27
9153,177,8073,169846,170023,35
3938,64,8074,170022,170086,1
4364,30,8074,170086,170116,4
4037,217,8074,170116,170333,11
4786,78,8074,170333,170411,21
5037,41,8074,170411,170452,28
4554,232,8074,1389429,1389661,31
9877,2,8074,170680,170682,45
1121,6,8074,170682,170688,48
7487,204,8074,170688,170892,49
8884,5,8075,170891,170896,24
3257,54,8075,170896,170950,30
3956,58,8075,170950,171008,50
1241,18,8076,171007,171025,3
4367,87,8076,171025,171112,13
8106,257,8076,1389431,1389688,13
8024,156,8076,171340,171496,25
8148,137,8076,171496,171633,40
7614,69,8077,171632,171701,8
4147,226,8077,171701,171927,16
1643,199,8077,171927,172126,31
9635,30,8077,172126,172156,33
4841,105,8078,172155,172260,13
3245,159,8078,172260,172419,28
2917,285,8078,1471089,1471374,35
4410,154,8079,172652,172806,29
5614,189,8079,172806,172995,50
3917,28,8080,172994,173022,18
4603,115,8080,173022,173137,22
2008,32,8080,173137,173169,24
5802,283,8080,1471093,1471376,26
2086,156,8080,173393,173549,41
9656,148,8080,173549,173697,44
2863,211,8080,173697,173908,49
4747,27,8081,173907,173934,20
3226,75,8081,173934,174009,32
7467,55,8081,174009,174064,34
9746,18,8081,174064,174082,35
2000,159,8081,174082,174241,38
8509,159,8081,174241,174400,44
8076,6,8082,174399,174405,8
5706,54,8082,174405,174459,8
4274,236,8082,1389564,1389800,12
6187,148,8082,174682,174830,16
3118,244,8082,1389578,1389822,18
3804,264,8082,1389607,1389871,19
6199,241,8082,1389645,1389886,38
1994,18,8083,175492,175510,21
6076,265,8083,1389666,1389931,24
1744,164,8083,175729,175893,29
3483,292,8083,1471092,1471384,29
5569,251,8083,1389773,1390024,42
1991,145,8084,176331,176476,13
9429,6,8084,176476,176482,19
4220,72,8084,176482,176554,27
5211,300,8084,1477039,1477339,29
4576,15,8084,176773,176788,32
2021,284,8084,1471118,1471402,38
3318,235,8085,1389914,1390149,2
9079,5,8085,177238,177243,29
5863,242,8085,1389925,1390167,34
9641,81,8085,177467,177548,38
8133,106,8085,177548,177654,45
9617,147,8086,177653,177800,1
3701,95,8086,177800,177895,3
2786,9,8086,177895,177904,8
2404,265,8086,1389938,1390203,13
5966,241,8086,1389983,1390224,15
5286,63,8086,178352,178415,18
9563,29,8086,178415,178444,30
4682,17,8086,178444,178461,39
3420,273,8086,1390001,1390274,50
9928,83,8087,178683,178766,1
8961,73,8087,178766,178839,9
2930,228,8087,1390054,1390282,24
8824,12,8087,179058,179070,40
8996,142,8087,179070,179212,40
6868,94,8088,179211,179305,4
1302,88,8088,179305,179393,12
2772,68,8088,179393,179461,50
4988,274,8089,1390058,1390332,5
8117,243,8089,1390105,1390348,20
3464,62,8089,179909,179971,40
2758,295,8090,1471113,1471408,21
6801,253,8091,1390177,1390430,13
2319,47,8091,180421,180468,28
7490,106,8091,180468,180574,37
3595,132,8091,180574,180706,46
7595,201,8092,180705,180906,7
1589,31,8092,180906,180937,33
6438,241,8093,1390207,1390448,4
8586,45,8093,181157,181202,14
2862,38,8093,181202,181240,15
4213,93,8093,181240,181333,19
8537,42,8093,181333,181375,27
5299,100,8093,181375,181475,28
3225,105,8093,181475,181580,37
8986,58,8093,181580,181638,41
2235,76,8093,181638,181714,48
7694,171,8094,181713,181884,6
5034,77,8094,181884,181961,16
9066,250,8094,1390220,1390470,20
5161,66,8094,182188,182254,42
4167,91,8094,182254,182345,43
7696,235,8095,1390241,1390476,13
7836,153,8095,182572,182725,23
2545,13,8095,182725,182738,27
3876,32,8096,182737,182769,7
2514,192,8096,182769,182961,30
7299,30,8096,182961,182991,36
5510,23,8097,182990,183013,39
5991,85,8096,183014,183099,39
4689,266,8098,1390249,1390515,26
4008,134,8098,183321,183455,36
6783,81,8098,183455,183536,38
5009,85,8098,183536,183621,43
9022,227,8098,1390291,1390518,45
6709,248,8099,1390290,1390538,16
5155,300,8099,1476603,1476903,27
2548,235,8099,1390371,1390606,48
4478,174,8100,184516,184690,2
9560,152,8100,184690,184842,41
1339,56,8100,184842,184898,42
2068,240,8101,1390379,1390619,1
3424,138,8101,185122,185260,10
3460,123,8101,185260,185383,28
7664,268,8101,1390393,1390661,30
9392,268,8101,1390433,1390701,31
3327,24,8101,185837,185861,43
7027,4,8102,185860,185864,8
5081,125,8102,185864,185989,8
8980,70,8102,185989,186059,22
1394,43,8102,186059,186102,24
9407,175,8103,186101,186276,16
5750,42,8103,186276,186318,18
6549,241,8103,1390485,1390726,22
4797,215,8103,186532,186747,30
7935,165,8103,186747,186912,31
2709,81,8103,186912,186993,32
3179,292,8103,1471132,1471424,49
3575,248,8104,1390559,1390807,3
7744,136,8104,187437,187573,4
4756,230,8104,1390584,1390814,10
5453,39,8104,187796,187835,19
1118,141,8104,187835,187976,22
6548,66,8105,187975,188041,1
6286,278,8105,1471148,1471426,22
4828,120,8105,188255,188375,25
7068,11,8105,188375,188386,44
7590,281,8105,1471147,1471428,48
7902,57,8106,188608,188665,13
9399,175,8106,188665,188840,34
3790,270,8106,1390702,1390972,38
2730,139,8107,189065,189204,6
9313,113,8107,189204,189317,15
4667,187,8107,189317,189504,29
3536,97,8107,189504,189601,40
2905,185,8108,189600,189785,6
8035,127,8108,189785,189912,9
6819,181,8108,189912,190093,28
5740,139,8109,190092,190231,6
8362,208,8109,190231,190439,6
6381,82,8109,190439,190521,14
3321,72,8109,190521,190593,47
1893,143,8109,190593,190736,50
5317,121,8110,190735,190856,7
7652,79,8110,190856,190935,16
2816,45,8110,190935,190980,22
2120,48,8110,190980,191028,23
6406,216,8110,191028,191244,35
9819,18,8110,191244,191262,45
9443,199,8110,191262,191461,50
9565,3,8111,191460,191463,1
8390,129,8111,191463,191592,18
1692,250,8111,1390748,1390998,25
7147,229,8111,1390776,1391005,49
6772,231,8112,1390779,1391010,1
3903,186,8112,192257,192443,34
2601,144,8112,192443,192587,37
1706,187,8112,192587,192774,39
6024,218,8114,192772,192990,11
8864,81,8114,192990,193071,23
6495,88,8115,193070,193158,13
4394,91,8115,193158,193249,25
7391,93,8115,193249,193342,26
1035,101,8115,193342,193443,27
2520,84,8115,193443,193527,41
4202,190,8116,193526,193716,4
4830,111,8116,193716,193827,27
9791,245,8116,1390776,1391021,36
2607,172,8116,194057,194229,39
4017,7,8116,194229,194236,43
9974,70,8117,194235,194305,13
3537,131,8117,194305,194436,32
6529,212,8117,194436,194648,49
2928,225,8118,1390798,1391023,4
2369,10,8118,194868,194878,7
6627,243,8118,1390800,1391043,10
5793,82,8118,195101,195183,22
4812,4,8118,195183,195187,25
9120,60,8118,195187,195247,28
4842,51,8119,195246,195297,9
9214,95,8119,195297,195392,20
8625,295,8119,1471135,1471430,27
5722,202,8119,195615,195817,31
8925,18,8120,195816,195834,15
3877,255,8120,1390873,1391128,21
7831,240,8120,1390902,1391142,30
7710,289,8122,1471149,1471438,16
1139,290,8122,1471158,1471448,18
2352,275,8122,1391024,1391299,41
6205,196,8122,196956,197152,43
2260,259,8122,1391076,1391335,50
5496,290,8123,1471170,1471460,10
1708,121,8123,197597,197718,22
9931,231,8123,1391168,1391399,42
5890,251,8124,1391176,1391427,6
4624,183,8124,198159,198342,17
8696,32,8124,198342,198374,18
8711,160,8124,198374,198534,22
6967,52,8124,198534,198586,24
1092,17,8124,198586,198603,34
8776,227,8124,1391203,1391430,34
7059,29,8125,198826,198855,5
4765,114,8125,198855,198969,23
5375,194,8125,198969,199163,23
7410,234,8125,1391210,1391444,29
2103,39,8125,199382,199421,37
3069,290,8125,1471176,1471466,46
2358,132,8125,199641,199773,47
1512,264,8125,1391283,1391547,48
9750,157,8126,199995,200152,7
8309,257,8126,1391324,1391581,44
1686,35,8127,200373,200408,10
8724,71,8127,200408,200479,18
3835,111,8127,200479,200590,19
3939,117,8127,200590,200707,20
8808,155,8127,200707,200862,31
5423,76,8127,200862,200938,32
5228,255,8127,1391360,1391615,46
2926,93,8128,201157,201250,2
2677,221,8128,201250,201471,17
2517,157,8128,201471,201628,19
5073,294,8128,1471180,1471474,21
4322,8,8128,201852,201860,48
4207,254,8129,1391452,1391706,46
2018,113,8130,202078,202191,1
3952,169,8130,202191,202360,12
2624,68,8130,202360,202428,14
7464,101,8131,202427,202528,11
1083,241,8131,1391490,1391731,22
9883,190,8131,202742,202932,34
1213,15,8132,202931,202946,7
9576,169,8132,202946,203115,17
9820,126,8132,203115,203241,37
6109,67,8133,203240,203307,8
2083,206,8133,203307,203513,10
1426,238,8133,1391505,1391743,11
9575,2,8133,203737,203739,15
8982,76,8133,203739,203815,23
4059,283,8133,1471191,1471474,32
5988,97,8133,204036,204133,41
4659,116,8134,204132,204248,7
1489,220,8134,204248,204468,16
8469,52,8134,204468,204520,17
5646,166,8134,204520,204686,33
6361,237,8134,1391576,1391813,48
6468,200,8135,204908,205108,1
7418,83,8135,205108,205191,8
4188,25,8135,205191,205216,22
5996,59,8135,205216,205275,25
4942,65,8135,205275,205340,25
4277,283,8135,1391592,1391875,28
9892,151,8135,205560,205711,30
7262,128,8135,205711,205839,34
2978,117,8135,205839,205956,36
1061,244,8136,1391660,1391904,22
5197,86,8136,206169,206255,28
9074,163,8136,206255,206418,38
5576,202,8137,206417,206619,23
5993,277,8138,1391729,1392006,34
6547,298,8137,1476569,1476867,36
9863,290,8138,1471205,1471495,48
2887,153,8139,207294,207447,1
4261,163,8139,207447,207610,8
9288,130,8139,207610,207740,21
8855,227,8139,1391837,1392064,26
9719,83,8139,207964,208047,27
6341,183,8140,208046,208229,21
8487,111,8140,208229,208340,22
3957,21,8140,208340,208361,34
9187,223,8140,208361,208584,37
9909,177,8141,208583,208760,6
8422,167,8141,208760,208927,14
9844,21,8141,208927,208948,17
6010,178,8141,208948,209126,38
2810,98,8142,209125,209223,16
2858,198,8142,209223,209421,21
6778,77,8142,209421,209498,26
6793,159,8143,209497,209656,23
1130,159,8143,209656,209815,26
3314,146,8143,209815,209961,31
6919,254,8143,1391839,1392093,32
1783,300,8143,1476981,1477281,36
6317,208,8143,210412,210620,40
7414,142,8143,210620,210762,46
9769,225,8144,1391920,1392145,12
1420,69,8144,210984,211053,13
1675,279,8144,1391919,1392198,30
3083,105,8145,211278,211383,9
4348,209,8145,211383,211592,14
1816,7,8145,211592,211599,16
7412,31,8146,211598,211629,30
6561,173,8146,211629,211802,41
4719,209,8147,211801,212010,21
7900,298,8147,1476564,1476862,25
1679,125,8147,212229,212354,28
3627,226,8147,212354,212580,30
8472,10,8147,212580,212590,37
6840,143,8147,212590,212733,41
5439,267,8147,1392037,1392304,49
2972,31,8147,212955,212986,50
9830,179,8148,212985,213164,13
6064,225,8148,213164,213389,38
6504,182,8148,213389,213571,44
9600,19,8149,213570,213589,9
4597,78,8149,213589,213667,37
7154,180,8150,213666,213846,4
8097,11,8150,213846,213857,5
2727,127,8150,213857,213984,5
9061,222,8150,1392082,1392304,25
4479,291,8150,1471228,1471519,25
2666,219,8150,214422,214641,31
2585,120,8150,214641,214761,41
4313,181,8151,214760,214941,5
6921,270,8151,1392150,1392420,8
9759,162,8151,215158,215320,12
1252,265,8151,1392200,1392465,15
4910,221,8151,215540,215761,20
4945,78,8151,215761,215839,31
3762,17,8151,215839,215856,40
5465,44,8152,215855,215899,7
6991,221,8152,215899,216120,34
2370,259,8152,1392241,1392500,39
5803,221,8153,216342,216563,14
8512,253,8153,1392272,1392525,16
8319,89,8153,216790,216879,45
6150,250,8153,1392306,1392556,47
9194,281,8154,1471237,1471518,11
5269,84,8154,217321,217405,39
5157,51,8155,217404,217455,1
2320,113,8155,217455,217568,7
6073,256,8155,1392381,1392637,16
3990,257,8155,1392415,1392672,18
2337,53,8155,218017,218070,20
1473,169,8155,218070,218239,20
7146,56,8155,218239,218295,21
6117,130,8155,218295,218425,24
8075,102,8156,218424,218526,3
5703,233,8156,1392448,1392681,43
1264,197,8156,218749,218946,44
1158,287,8156,1471236,1471523,50
7417,193,8157,219168,219361,1
7360,54,8157,219361,219415,6
6462,15,8157,219415,219430,15
7383,296,8157,1476972,1477268,40
2923,234,8157,1392570,1392804,41
5236,57,8157,219877,219934,46
8555,290,8157,1471253,1471543,46
5519,235,8158,1392643,1392878,6
1742,160,8158,220375,220535,26
7686,204,8158,220535,220739,27
2802,87,8158,220739,220826,29
1078,25,8159,220825,220850,22
8093,215,8159,220850,221065,24
5953,24,8159,221065,221089,48
6422,250,8160,1392654,1392904,6
5362,61,8160,221310,221371,12
4729,272,8160,1392685,1392957,29
3614,18,8160,221590,221608,46
9038,231,8161,1392731,1392962,2
2880,124,8161,221832,221956,10
5940,46,8161,221956,222002,29
3660,72,8161,222002,222074,32
9720,251,8162,1392736,1392987,1
6434,238,8162,1392764,1393002,3
3227,242,8162,1392779,1393021,3
8055,229,8162,1392799,1393028,5
5138,281,8162,1392806,1393087,5
2014,35,8162,223188,223223,8
7429,71,8162,223223,223294,45
8759,77,8162,223294,223371,48
9058,295,8163,1476554,1476849,19
1622,166,8163,223585,223751,25
9474,30,8163,223751,223781,42
6259,37,8164,223780,223817,16
1432,117,8164,223817,223934,34
8497,257,8165,1392922,1393179,1
2424,142,8165,224158,224300,18
3973,74,8165,224300,224374,43
9577,170,8166,224373,224543,14
9505,19,8166,224543,224562,30
8727,76,8166,224562,224638,31
8905,28,8166,224638,224666,32
8314,95,8167,224665,224760,8
1703,138,8167,224760,224898,10
7756,117,8167,224898,225015,12
8621,147,8167,225015,225162,19
8304,161,8167,225162,225323,32
8960,286,8167,1471269,1471555,40
3846,224,8168,1393012,1393236,7
3428,93,8168,225766,225859,34
9502,179,8168,225859,226038,42
5854,231,8168,1393013,1393244,50
2619,25,8169,226260,226285,3
8180,283,8169,1471272,1471555,5
3230,142,8169,226507,226649,9
7372,20,8169,226649,226669,15
2787,166,8169,226669,226835,42
1649,257,8170,1393074,1393331,20
6645,72,8170,227061,227133,28
5457,300,8170,1476956,1477256,45
7293,19,8170,227357,227376,46
4646,203,8170,227376,227579,46
8267,267,8171,1393163,1393430,17
8750,56,8171,227802,227858,31
7280,285,8172,1471283,1471568,14
3122,10,8172,228082,228092,36
4073,101,8172,228092,228193,47
4165,178,8172,228193,228371,48
5333,213,8172,228371,228584,49
6744,254,8173,1393268,1393522,29
2833,90,8173,228802,228892,35
2035,74,8173,228892,228966,45
8821,287,8174,1471284,1471571,23
1577,280,8174,1393348,1393628,36
4336,170,8174,229420,229590,45
1168,213,8174,229590,229803,49
5296,254,8175,1393404,1393658,3
4879,149,8175,230025,230174,7
9096,34,8175,230174,230208,29
7988,215,8175,230208,230423,30
8170,295,8176,1471289,1471584,18
9726,88,8177,230643,230731,10
9701,130,8177,230731,230861,40
5795,83,8178,230860,230943,24
4219,280,8178,1393494,1393774,24
9535,3,8178,231162,231165,44
5689,61,8179,231164,231225,2
2703,1,8180,231224,231225,9
1124,127,8180,231225,231352,11
2359,230,8180,1393545,1393775,16
4999,217,8180,1393561,1393778,22
4833,39,8180,231793,231832,26
8631,222,8180,231832,232054,36
8205,268,8180,1393553,1393821,37
1889,154,8180,232279,232433,49
8863,62,8181,232432,232494,1
6616,234,8181,1393595,1393829,1
4475,136,8181,232719,232855,3
5732,177,8181,232855,233032,6
7919,80,8181,233032,233112,15
2999,32,8181,233112,233144,29
8393,97,8181,233144,233241,39
6562,222,8181,233241,233463,44
7300,233,8182,1393598,1393831,36
5251,183,8182,233692,233875,38
8990,292,8182,1471295,1471587,39
9138,158,8182,234098,234256,42
7914,71,8183,234255,234326,13
3709,257,8183,1393665,1393922,14
4021,62,8183,234551,234613,15
5173,232,8183,1393698,1393930,17
5408,259,8183,1393696,1393955,35
7475,127,8183,235071,235198,42
9677,196,8183,235198,235394,46
3788,202,8184,235393,235595,4
1630,176,8184,235595,235771,21
4835,75,8184,235771,235846,25
8779,130,8184,235846,235976,26
2733,92,8184,235976,236068,50
6603,62,8185,236067,236129,12
8294,107,8185,236129,236236,19
7776,12,8185,236236,236248,40
4091,115,8185,236248,236363,47
4339,125,8186,236362,236487,1
6161,279,8186,1393728,1394007,17
8922,40,8186,236711,236751,26
8019,12,8186,236751,236763,34
6492,19,8186,236763,236782,37
6222,177,8187,236781,236958,11
7582,190,8187,236958,237148,11
9802,148,8187,237148,237296,21
5643,210,8187,237296,237506,40
5905,42,8188,237505,237547,6
3412,131,8188,237547,237678,13
8323,123,8188,237678,237801,23
7351,182,8188,237801,237983,42
3027,178,8188,237983,238161,43
7012,90,8189,238160,238250,10
9622,271,8189,1393785,1394056,25
2298,61,8189,238469,238530,29
2131,117,8189,238530,238647,32
8938,4,8189,238647,238651,42
3498,154,8190,238650,238804,9
8418,129,8190,238804,238933,17
6837,92,8190,238933,239025,22
1896,86,8190,239025,239111,29
6141,83,8190,239111,239194,42
8331,297,8190,1476529,1476826,45
7742,45,8191,239417,239462,5
5513,44,8191,239462,239506,20
4160,137,8191,239506,239643,22
4744,82,8191,239643,239725,28
5045,107,8191,239725,239832,41
7938,142,8191,239832,239974,48
6885,215,8192,239973,240188,5
7103,246,8192,1393888,1394134,5
9414,133,8192,240410,240543,20
6795,19,8192,240543,240562,40
9190,277,8193,1393908,1394185,2
6037,85,8193,240786,240871,9
7450,214,8193,240871,241085,20
6217,115,8194,241084,241199,1
4876,2,8194,241199,241201,4
4025,25,8194,241201,241226,4
6739,109,8194,241226,241335,11
8542,200,8195,241334,241534,4
7198,11,8195,241534,241545,26
5555,122,8195,241545,241667,40
9203,224,8195,1393963,1394187,42
4809,266,8195,1393965,1394231,44
8200,178,8196,242108,242286,5
7556,55,8196,242286,242341,12
6387,112,8196,242341,242453,29
2036,296,8196,1476525,1476821,37
9133,31,8196,242678,242709,45
9691,227,8196,1394062,1394289,48
1941,207,8196,242932,243139,49
7973,26,8196,243139,243165,50
1144,68,8197,243164,243232,24
2147,257,8197,1394065,1394322,43
4788,168,8197,243455,243623,50
1451,205,8198,243622,243827,7
3870,27,8198,243827,243854,19
8399,58,8198,243854,243912,20
7347,209,8199,243911,244120,12
2213,260,8199,1394094,1394354,30
4960,216,8199,244346,244562,40
4637,22,8199,244562,244584,43
8184,282,8200,1471318,1471600,3
3753,282,8200,1471324,1471606,9
5191,186,8200,245024,245210,10
7275,190,8200,245210,245400,10
3216,291,8200,1471323,1471614,20
3765,142,8200,245627,245769,23
9020,258,8200,1394297,1394555,31
4509,163,8200,245997,246160,44
3594,248,8201,1394331,1394579,10
2440,156,8201,246382,246538,24
3487,284,8201,1471332,1471616,30
7631,67,8201,246764,246831,32
6949,108,8202,246830,246938,7
7676,71,8202,246938,247009,18
4476,101,8202,247009,247110,35
6198,286,8202,1471335,1471621,40
6044,58,8203,247331,247389,1
2527,203,8203,247389,247592,1
9685,165,8203,247592,247757,17
3390,7,8203,247757,247764,32
7060,171,8203,247764,247935,37
7064,298,8203,1476926,1477224,38
6533,164,8203,248161,248325,45
7848,8,8203,248325,248333,50
8917,69,8204,248332,248401,1
2044,71,8204,248401,248472,11
3347,10,8204,248472,248482,24
5178,136,8204,248482,248618,27
1733,61,8204,248618,248679,28
7896,71,8204,248679,248750,37
8370,281,8204,1394521,1394802,39
2985,137,8204,248973,249110,48
1365,141,8204,249110,249251,49
7388,242,8205,1394586,1394828,19
8386,209,8205,249465,249674,21
8589,77,8205,249674,249751,29
8739,283,8206,1471348,1471631,12
8181,236,8206,1394666,1394902,15
3698,174,8206,250193,250367,37
2697,279,8206,1394677,1394956,37
8401,78,8207,250591,250669,1
5237,78,8207,250669,250747,3
2660,116,8207,250747,250863,45
6543,77,8207,250863,250940,48
6648,4,8208,250939,250943,25
1017,239,8208,1394731,1394970,27
9277,52,8208,251166,251218,40
4572,186,8208,251218,251404,44
5270,166,8209,251403,251569,2
8014,94,8209,251569,251663,4
3280,152,8209,251663,251815,15
4801,234,8209,1394742,1394976,16
4772,156,8209,252042,252198,23
8197,146,8209,252198,252344,41
8221,43,8209,252344,252387,45
7252,78,8210,252386,252464,6
1665,189,8210,252464,252653,8
9121,43,8210,252653,252696,31
5150,174,8210,252696,252870,31
7800,290,8210,1471343,1471633,35
3986,238,8210,1394800,1395038,41
3249,241,8211,1394814,1395055,10
8088,203,8211,253551,253754,22
5514,282,8211,1471353,1471635,26
9979,47,8211,253978,254025,33
6454,198,8211,254025,254223,42
8476,54,8211,254223,254277,44
3843,279,8212,1394890,1395169,25
1830,228,8212,1394946,1395174,27
8667,251,8212,1394940,1395191,35
2170,29,8212,254952,254981,37
5867,72,8212,254981,255053,41
2953,163,8212,255053,255216,46
5682,152,8213,255215,255367,2
8953,273,8213,1394963,1395236,20
6997,76,8213,255594,255670,22
7370,114,8213,255670,255784,31
5473,159,8213,255784,255943,33
9782,19,8213,255943,255962,34
2205,242,8213,1395014,1395256,40
1988,135,8213,256184,256319,42
2951,87,8213,256319,256406,46
3646,48,8214,256405,256453,15
4736,268,8214,1395036,1395304,24
3159,299,8214,1476915,1477214,24
8935,3,8215,256890,256893,38
9188,98,8215,256893,256991,42
7851,57,8216,256990,257047,16
1614,142,8216,257047,257189,20
6078,144,8216,257189,257333,24
2456,297,8216,1476513,1476810,34
7307,118,8216,257557,257675,39
7585,235,8216,1395199,1395434,44
8687,141,8216,257897,258038,49
4197,81,8217,258037,258118,4
1762,263,8217,1395215,1395478,9
7572,150,8217,258336,258486,24
9426,223,8217,1395257,1395480,32
2037,116,8217,258707,258823,35
6390,73,8217,258823,258896,49
2343,195,8218,258895,259090,3
9977,263,8218,1395256,1395519,3
4099,84,8219,259312,259396,14
6927,278,8219,1395296,1395574,18
2800,74,8219,259618,259692,24
3146,293,8219,1471373,1471666,36
6520,235,8219,1395405,1395640,42
4243,73,8220,260141,260214,4
6169,272,8220,1395415,1395687,17
8007,251,8220,1395468,1395719,29
6953,4,8220,260657,260661,49
9651,286,8220,1471386,1471672,49
2655,209,8221,260882,261091,8
4177,63,8221,261091,261154,20
6571,10,8221,261154,261164,23
1515,231,8221,1395556,1395787,29
9878,289,8221,1471389,1471678,46
7317,148,8222,261602,261750,36
2946,172,8222,261750,261922,49
1780,102,8222,261922,262024,50
1992,40,8223,262023,262063,2
9347,166,8223,262063,262229,20
1154,239,8223,1395623,1395862,21
3291,103,8223,262453,262556,25
2795,219,8223,1395645,1395864,33
3591,195,8223,262773,262968,37
6420,52,8223,262968,263020,38
6581,126,8223,263020,263146,39
9696,16,8223,263146,263162,43
7814,229,8224,1395640,1395869,48
8563,103,8225,263383,263486,20
4832,54,8225,263486,263540,38
8438,34,8226,263539,263573,12
4940,182,8226,263573,263755,14
3621,149,8226,263755,263904,19
9978,7,8226,263904,263911,21
3494,236,8226,1395648,1395884,24
9821,94,8226,264130,264224,32
5727,163,8226,264224,264387,33
2105,195,8226,264387,264582,43
9562,125,8226,264582,264707,50
4883,118,8227,264706,264824,1
6944,149,8227,264824,264973,23
7602,95,8227,264973,265068,30
4331,33,8228,265067,265100,9
6760,36,8228,265100,265136,22
4468,285,8228,1471387,1471672,35
4884,93,8228,265370,265463,44
2047,184,8228,265463,265647,48
9528,96,8229,265646,265742,23
7628,38,8229,265742,265780,37
5621,288,8229,1471389,1471677,43
2070,38,8230,266002,266040,3
7599,282,8230,1395766,1396048,12
4155,188,8230,266263,266451,16
7007,10,8230,266451,266461,24
5106,48,8230,266461,266509,26
1300,32,8230,266509,266541,37
1204,149,8230,266541,266690,45
1190,177,8231,266689,266866,48
6780,88,8232,266865,266953,16
5310,218,8232,266953,267171,16
6047,99,8233,267170,267269,5
3440,153,8233,267269,267422,12
5865,288,8233,1471390,1471678,28
5425,2,8233,267642,267644,39
6691,173,8234,267643,267816,45
7934,58,8235,267815,267873,5
4359,239,8235,1395884,1396123,7
3222,79,8235,268095,268174,31
6770,278,8235,1395898,1396176,37
5535,118,8236,268398,268516,16
2739,138,8236,268516,268654,22
3767,76,8237,268653,268729,6
3485,58,8237,268729,268787,16
7438,59,8237,268787,268846,18
4431,218,8237,268846,269064,29
9176,276,8237,1395948,1396224,30
4725,220,8237,269290,269510,49
5103,17,8238,269509,269526,22
4865,4,8238,269526,269530,28
1897,207,8238,269530,269737,44
1700,85,8239,269736,269821,6
6952,234,8239,1396005,1396239,8
1367,193,8239,270038,270231,31
2553,84,8239,270231,270315,34
1902,149,8239,270315,270464,34
4762,256,8239,1396014,1396270,41
6690,17,8240,270688,270705,28
5607,235,8240,1396046,1396281,43
4116,225,8240,1396057,1396282,45
8841,120,8241,271151,271271,6
2615,42,8241,271271,271313,13
2679,235,8241,1396058,1396293,27
1612,23,8241,271536,271559,48
2476,84,8242,271558,271642,4
8061,73,8242,271642,271715,30
6280,217,8243,271714,271931,1
9280,144,8243,271931,272075,4
7727,292,8243,1471392,1471684,9
7331,25,8243,272293,272318,19
3197,238,8243,1396125,1396363,26
4754,5,8243,272542,272547,27
2513,126,8243,272547,272673,30
3319,231,8243,1396135,1396366,31
1766,122,8243,272901,273023,33
8349,26,8244,273022,273048,17
1062,4,8244,273048,273052,29
5927,6,8244,273052,273058,35
6861,227,8244,1396140,1396367,37
8158,232,8244,1396141,1396373,38
3148,84,8244,273509,273593,39
2760,185,8245,273592,273777,9
2540,58,8245,273777,273835,17
4813,196,8245,273835,274031,17
6776,215,8245,274031,274246,34
5447,145,8246,274245,274390,9
4123,198,8246,274390,274588,23
8478,126,8246,274588,274714,26
3577,146,8246,274714,274860,38
9631,71,8247,274859,274930,8
8670,100,8247,274930,275030,8
9742,189,8247,275030,275219,49
2445,46,8248,275218,275264,16
3397,266,8248,1396142,1396408,16
5636,17,8248,275491,275508,19
3305,57,8248,275508,275565,19
5741,71,8248,275565,275636,34
4854,187,8248,275636,275823,48
8021,200,8249,275822,276022,21
5635,9,8249,276022,276031,30
5914,98,8249,276031,276129,34
8045,98,8250,276128,276226,12
9612,153,8250,276226,276379,14
7719,115,8250,276379,276494,16
7001,250,8250,1396192,1396442,22
9664,212,8250,276708,276920,23
2595,264,8250,1396222,1396486,28
7476,219,8250,277140,277359,32
6446,290,8250,1471397,1471687,50
9984,177,8251,277581,277758,9
3437,142,8251,277758,277900,32
1735,78,8251,277900,277978,34
2212,299,8251,1476481,1476780,39
4484,289,8251,1471417,1471706,40
4409,143,8251,278423,278566,48
2547,144,8251,278566,278710,48
4570,135,8252,278709,278844,35
7387,240,8253,1396434,1396674,17
4916,156,8253,279067,279223,22
2575,235,8253,1396451,1396686,27
6285,295,8253,1471423,1471718,29
1496,214,8253,279665,279879,31
6595,294,8253,1476485,1476779,40
8434,102,8253,280101,280203,47
8494,82,8254,280202,280284,1
4378,209,8254,280284,280493,15
9614,187,8254,280493,280680,16
1342,153,8254,280680,280833,19
1775,31,8254,280833,280864,25
3416,190,8254,280864,281054,25
6231,90,8254,281054,281144,30
4097,3,8254,281144,281147,34
3549,8,8254,281147,281155,46
7726,198,8255,281154,281352,4
1486,226,8255,1396587,1396813,8
9663,71,8255,281569,281640,17
8760,9,8255,281640,281649,45
8835,174,8256,281648,281822,20
6136,283,8257,1471446,1471729,5
9273,42,8257,282043,282085,11
6091,131,8257,282085,282216,20
3866,263,8257,1396646,1396909,26
7611,234,8257,1396681,1396915,31
1199,121,8257,282668,282789,40
9786,116,8257,282789,282905,44
6040,79,8258,282904,282983,5
2288,275,8258,1396692,1396967,6
1164,293,8258,1471449,1471742,15
8654,268,8258,1396796,1397064,36
7264,293,8258,1471462,1471755,37
1696,216,8259,283879,284095,2
3715,118,8259,284095,284213,19
5071,243,8259,1396894,1397137,34
9433,98,8259,284437,284535,47
8271,250,8260,1396918,1397168,9
3325,128,8260,284752,284880,25
2066,62,8260,284880,284942,28
4722,271,8260,1396949,1397220,47
9731,286,8261,1471471,1471757,5
9103,7,8261,285382,285389,15
7868,45,8261,285389,285434,16
1402,176,8261,285434,285610,31
2656,237,8262,1397055,1397292,7
9242,293,8262,1471476,1471769,13
4578,30,8262,286059,286089,20
1281,204,8262,286089,286293,27
6937,11,8262,286293,286304,29
4244,221,8262,286304,286525,41
5832,61,8262,286525,286586,45
9890,83,8263,286585,286668,4
4565,241,8263,1397119,1397360,26
4206,176,8263,286892,287068,46
6810,32,8264,287067,287099,25
5766,290,8264,1471488,1471778,27
7231,122,8265,287321,287443,2
8957,75,8265,287443,287518,23
2209,283,8265,1471501,1471784,42
1731,111,8266,287737,287848,6
2283,252,8266,1397249,1397501,15
7829,42,8266,288068,288110,36
7749,113,8266,288110,288223,50
7536,114,8267,288222,288336,44
8906,126,8268,288335,288461,2
5500,86,8268,288461,288547,4
7570,196,8268,288547,288743,8
6002,80,8268,288743,288823,14
3975,251,8268,1397275,1397526,17
9363,185,8268,289047,289232,27
4679,215,8268,289232,289447,31
9700,203,8268,289447,289650,43
1519,20,8269,289649,289669,1
5842,171,8269,289669,289840,5
9317,282,8269,1471499,1471781,5
3370,121,8269,290062,290183,10
7643,228,8269,1397362,1397590,18
9033,54,8269,290405,290459,30
1714,6,8269,290459,290465,33
1079,27,8269,290465,290492,37
4819,244,8269,1397368,1397612,44
3111,215,8269,290714,290929,46
8610,195,8270,290928,291123,14
4984,100,8270,291123,291223,40
9949,105,8270,291223,291328,49
5143,96,8271,291327,291423,2
9067,162,8271,291423,291585,8
6472,243,8271,1397387,1397630,12
6821,272,8271,1397411,1397683,29
4039,265,8271,1397455,1397720,31
9456,131,8271,292255,292386,36
1734,269,8271,1397501,1397770,47
1453,98,8272,292604,292702,3
3665,112,8272,292702,292814,14
9266,171,8272,292814,292985,22
4541,266,8272,1397541,1397807,31
4730,220,8272,293213,293433,43
7625,28,8272,293433,293461,49
9268,229,8273,1397581,1397810,1
9013,31,8273,293685,293716,18
7897,36,8273,293716,293752,19
4851,214,8273,293752,293966,35
2673,200,8273,293966,294166,37
3839,233,8274,1397586,1397819,3
8659,18,8274,294388,294406,19
1234,270,8274,1397595,1397865,21
1844,240,8274,1397635,1397875,36
6137,143,8274,294860,295003,44
1542,210,8275,295002,295212,2
9860,22,8275,295212,295234,9
7165,231,8275,1397660,1397891,22
4365,274,8275,1397674,1397948,33
3844,25,8275,295665,295690,49
4358,119,8276,295689,295808,1
4864,152,8276,295808,295960,11
2754,51,8276,295960,296011,21
1054,177,8276,296011,296188,48
2650,181,8277,296187,296368,15
6552,192,8277,296368,296560,41
3628,247,8278,1397718,1397965,16
6183,103,8278,296786,296889,27
7245,202,8279,296888,297090,6
8839,141,8279,297090,297231,46
5919,183,8280,297230,297413,9
1286,159,8280,297413,297572,29
2479,126,8280,297572,297698,30
2225,284,8280,1397738,1398022,41
3768,32,8281,297922,297954,9
1494,75,8281,297954,298029,39
1993,113,8281,298029,298142,47
7013,82,8282,298141,298223,23
4357,140,8282,298223,298363,44
5816,74,8283,298362,298436,4
8172,55,8283,298436,298491,45
8251,39,8284,298490,298529,4
4575,283,8284,1471485,1471768,5
1501,229,8284,1397855,1398084,7
2326,150,8284,298973,299123,22
4114,102,8285,299122,299224,7
5778,151,8285,299224,299375,12
6404,260,8285,1397856,1398116,16
9472,32,8285,299602,299634,18
7809,103,8286,299633,299736,43
5060,51,8286,299736,299787,45
9118,248,8287,1397892,1398140,5
5544,259,8287,1397915,1398174,23
9213,30,8287,300233,300263,25
5977,63,8287,300263,300326,30
6909,217,8287,300326,300543,49
9173,68,8288,300542,300610,44
3802,281,8288,1471489,1471770,47
7019,243,8289,1398000,1398243,31
9015,23,8290,301055,301078,9
7608,87,8290,301078,301165,10
3909,258,8290,1398022,1398280,28
4057,266,8290,1398052,1398318,31
6310,72,8290,301613,301685,40
4579,77,8291,301684,301761,1
6497,126,8291,301761,301887,13
6243,34,8291,301887,301921,14
5364,13,8291,301921,301934,15
5565,9,8291,301934,301943,19
9654,164,8291,301943,302107,20
9360,161,8291,302107,302268,21
3443,86,8291,302268,302354,32
1794,91,8291,302354,302445,32
4894,32,8291,302445,302477,50
3803,93,8292,302476,302569,1
7225,251,8292,1398091,1398342,2
2977,24,8292,302794,302818,15
7465,282,8292,1471488,1471770,16
7856,206,8292,303045,303251,18
1488,159,8292,303251,303410,21
3766,53,8292,303410,303463,37
1254,192,8293,303462,303654,7
3284,26,8293,303654,303680,13
9692,18,8293,303680,303698,26
4748,19,8293,303698,303717,34
9144,232,8293,1398168,1398400,34
4590,178,8293,303941,304119,42
3186,15,8294,304118,304133,1
2781,218,8294,304133,304351,2
8781,108,8294,304351,304459,4
3581,264,8294,1398175,1398439,11
6144,92,8294,304683,304775,25
3678,185,8295,304774,304959,7
1677,234,8295,1398218,1398452,15
6333,281,8295,1398228,1398509,21
3562,155,8295,305403,305558,32
3041,95,8295,305558,305653,37
4136,290,8295,1471486,1471776,38
8786,132,8295,305879,306011,40
9158,27,8295,306011,306038,46
5512,187,8296,306037,306224,1
8745,262,8296,1398338,1398600,1
8963,180,8296,306449,306629,4
2088,186,8296,306629,306815,40
8042,21,8296,306815,306836,43
6009,86,8296,306836,306922,44
4324,129,8296,306922,307051,47
8424,75,8296,307051,307126,49
6011,162,8297,307125,307287,44
6693,217,8297,307287,307504,45
4474,280,8298,1398375,1398655,3
2519,250,8298,1398433,1398683,18
9182,207,8298,307948,308155,19
8357,73,8298,308155,308228,29
7799,127,8298,308228,308355,29
5451,172,8299,308354,308526,38
5521,180,8300,308525,308705,5
9628,171,8300,308705,308876,38
6184,191,8301,308875,309066,14
8244,78,8301,309066,309144,40
7870,246,8301,1398458,1398704,44
3661,133,8302,309365,309498,3
4569,93,8302,309498,309591,11
9087,151,8302,309591,309742,42
8579,202,8303,309741,309943,3
6814,180,8303,309943,310123,5
5030,192,8303,310123,310315,11
8360,67,8303,310315,310382,19
4521,178,8303,310382,310560,25
5626,167,8303,310560,310727,38
2631,127,8303,310727,310854,41
2285,179,8304,310853,311032,6
5736,218,8304,311032,311250,12
4707,47,8304,311250,311297,23
3214,65,8304,311297,311362,36
5409,86,8304,311362,311448,38
1425,186,8304,311448,311634,44
8634,242,8304,1398479,1398721,44
5729,237,8305,1398498,1398735,6
8680,215,8305,312077,312292,11
2661,284,8305,1471486,1471770,13
9674,258,8305,1398563,1398821,34
3599,211,8306,312743,312954,4
1705,35,8306,312954,312989,10
3007,98,8306,312989,313087,12
4871,289,8306,1471490,1471779,27
6589,22,8306,313310,313332,36
2742,69,8306,313332,313401,42
1259,44,8308,313399,313443,2
9997,176,8308,313443,313619,6
3832,258,8308,1398651,1398909,12
6033,86,8308,313842,313928,26
9374,94,8308,313928,314022,43
7050,294,8308,1476432,1476726,48
3324,215,8309,314244,314459,5
1400,35,8309,314459,314494,8
3404,259,8309,1398734,1398993,36
3193,128,8310,314723,314851,15
8539,32,8310,314851,314883,29
7780,149,8311,314882,315031,1
5594,297,8311,1476428,1476725,7
7955,181,8311,315253,315434,16
3696,151,8311,315434,315585,25
8211,255,8312,1398822,1399077,1
3848,16,8312,315809,315825,5
7535,169,8312,315825,315994,5
2366,132,8312,315994,316126,7
8428,250,8312,1398847,1399097,36
7528,292,8313,1471519,1471811,1
5517,183,8313,316580,316763,4
8167,220,8313,316763,316983,5
7205,293,8313,1471528,1471821,20
5819,66,8313,317210,317276,43
1166,132,8313,317276,317408,44
9837,78,8313,317408,317486,45
8105,55,8314,317485,317540,6
8819,111,8314,317540,317651,9
3741,67,8314,317651,317718,36
9918,161,8315,317717,317878,7
1080,226,8316,1398989,1399215,8
2599,234,8316,1398991,1399225,11
4956,219,8316,318318,318537,13
2500,126,8316,318537,318663,14
7613,148,8316,318663,318811,27
5501,166,8316,318811,318977,38
6191,124,8316,318977,319101,50
7684,165,8316,319101,319266,50
1720,167,8317,319265,319432,22
4236,257,8318,1399006,1399263,8
4687,135,8318,319648,319783,12
3415,209,8318,319783,319992,17
2117,138,8318,319992,320130,34
1764,144,8318,320130,320274,38
1939,87,8318,320274,320361,44
5416,282,8319,1471537,1471819,19
8569,148,8319,320575,320723,45
1573,220,8319,1399106,1399326,47
3025,122,8320,320941,321063,12
2762,17,8320,321063,321080,27
8721,143,8320,321080,321223,42
5797,184,8321,321222,321406,2
8879,55,8321,321406,321461,5
8847,142,8321,321461,321603,7
9921,150,8321,321603,321753,8
6539,251,8321,1399101,1399352,12
7789,117,8321,321976,322093,20
3985,155,8321,322093,322248,24
5948,227,8321,1399127,1399354,37
3206,28,8322,322472,322500,45
2452,169,8323,322499,322668,3
6502,294,8323,1471534,1471828,29
4757,251,8323,1399195,1399446,47
4350,244,8324,1399223,1399467,6
8543,195,8324,323327,323522,8
3275,200,8324,323522,323722,14
6022,101,8324,323722,323823,25
4126,148,8325,323822,323970,7
3164,29,8325,323970,323999,28
5631,18,8325,323999,324017,31
9075,248,8325,1399241,1399489,37
5346,217,8325,324242,324459,42
3479,156,8325,324459,324615,46
2717,227,8325,1399270,1399497,47
5397,40,8325,324834,324874,50
3330,260,8326,1399268,1399528,13
3363,273,8326,1399301,1399574,16
6218,154,8326,325328,325482,36
3685,116,8327,325481,325597,9
7223,245,8327,1399349,1399594,11
9139,126,8327,325821,325947,20
3212,201,8328,325946,326147,13
8942,215,8328,326147,326362,23
6732,72,8328,326362,326434,27
1609,2,8328,326434,326436,35
6344,284,8328,1471543,1471827,40
8936,181,8328,326658,326839,44
5587,87,8328,326839,326926,49
7291,285,8329,1471542,1471827,14
8236,153,8329,327150,327303,18
7945,96,8329,327303,327399,46
3935,165,8329,327399,327564,47
2072,244,8329,1399487,1399731,49
1877,227,8330,1399510,1399737,15
1422,269,8330,1399518,1399787,24
3253,241,8330,1399567,1399808,28
7567,84,8330,328444,328528,29
4615,227,8330,1399583,1399810,37
1311,13,8331,328752,328765,18
3979,249,8331,1399594,1399843,19
3329,119,8331,328980,329099,28
7451,241,8331,1399623,1399864,28
9910,132,8331,329319,329451,30
8806,215,8331,329451,329666,30
2121,253,8331,1399636,1399889,31
3243,203,8331,329894,330097,38
8208,59,8332,330096,330155,1
7120,272,8332,1399664,1399936,17
8566,177,8332,330379,330556,32
3564,261,8332,1399712,1399973,45
2160,231,8333,1399745,1399976,16
1382,86,8333,331006,331092,26
2889,196,8333,331092,331288,31
3530,203,8335,331286,331489,5
5315,196,8335,331489,331685,27
5314,106,8335,331685,331791,31
8015,44,8335,331791,331835,34
4481,278,8335,1399751,1400029,48
7078,171,8336,332057,332228,18
8460,206,8336,332228,332434,39
7537,51,8336,332434,332485,45
1807,45,8337,332484,332529,15
5638,248,8337,1399800,1400048,16
4190,180,8337,332756,332936,27
2597,147,8338,332935,333082,10
8405,239,8338,1399823,1400062,34
2559,113,8338,333306,333419,37
8306,159,8338,333419,333578,44
1695,289,8339,1471538,1471827,7
3970,66,8339,333799,333865,19
1895,5,8339,333865,333870,24
1323,7,8339,333870,333877,24
3619,32,8339,333877,333909,27
8907,23,8339,333909,333932,30
7580,125,8340,333931,334056,6
7953,298,8340,1476400,1476698,35
2588,73,8341,334289,334362,23
5322,248,8342,1399937,1400185,13
6463,283,8342,1471557,1471840,48
1347,197,8343,334811,335008,4
7810,211,8343,335008,335219,12
2792,91,8343,335219,335310,13
8991,178,8343,335310,335488,25
9523,94,8343,335488,335582,29
3270,113,8343,335582,335695,32
2034,288,8343,1471558,1471846,38
8967,111,8343,335921,336032,49
6629,155,8344,336031,336186,1
7190,91,8344,336186,336277,6
5895,154,8344,336277,336431,8
6461,209,8344,336431,336640,15
9010,60,8344,336640,336700,19
6430,291,8344,1476404,1476695,22
1642,159,8344,336914,337073,30
9090,103,8344,337073,337176,34
5199,75,8345,337175,337250,3
1066,86,8345,337250,337336,3
4583,37,8345,337336,337373,5
2927,5,8345,337373,337378,9
8927,170,8345,337378,337548,15
3304,132,8345,337548,337680,19
4441,23,8345,337680,337703,26
1450,251,8345,1400127,1400378,30
5154,258,8345,1400152,1400410,30
7642,115,8345,338155,338270,31
6318,284,8345,1471578,1471862,43
2911,226,8345,1400247,1400473,49
3232,15,8345,338715,338730,50
4211,102,8345,338730,338832,50
9297,239,8346,1400250,1400489,6
8599,101,8346,339053,339154,19
7241,207,8347,339153,339360,36
6226,69,8347,339360,339429,50
5355,238,8348,1400261,1400499,30
7126,184,8348,339654,339838,47
1278,222,8348,339838,340060,50
5470,72,8349,340059,340131,10
4720,275,8349,1400275,1400550,12
2045,265,8349,1400322,1400587,31
2932,210,8349,340582,340792,46
6425,300,8350,1476779,1477079,18
1272,235,8350,1400417,1400652,20
4432,148,8350,341240,341388,28
6855,85,8350,341388,341473,37
8240,253,8350,1400427,1400680,41
6849,124,8351,341697,341821,7
9983,63,8352,341820,341883,8
2264,184,8352,341883,342067,10
3032,178,8352,342067,342245,19
8947,188,8353,342244,342432,23
2407,44,8353,342432,342476,24
2263,186,8353,342476,342662,36
6159,8,8353,342662,342670,38
4268,168,8354,342669,342837,4
1481,86,8354,342837,342923,12
8755,62,8354,342923,342985,15
3127,151,8354,342985,343136,31
7690,239,8354,1400459,1400698,33
7653,61,8354,343353,343414,40
7874,9,8354,343414,343423,45
2208,148,8355,343422,343570,8
7701,132,8355,343570,343702,30
7505,279,8355,1400471,1400750,30
6456,136,8355,343928,344064,42
7560,115,8355,344064,344179,49
7398,3,8356,344178,344181,8
9812,223,8356,1400527,1400750,18
5678,119,8356,344403,344522,26
1535,57,8356,344522,344579,39
1067,94,8356,344579,344673,40
8874,7,8357,344672,344679,8
4384,102,8357,344679,344781,11
3795,254,8357,1400521,1400775,13
9603,291,8357,1471587,1471878,32
7523,26,8357,345230,345256,33
5114,93,8357,345256,345349,42
8492,129,8357,345349,345478,45
1621,285,8357,1471596,1471881,46
8605,225,8357,1400672,1400897,49
5279,259,8358,1400674,1400933,18
3746,80,8358,346141,346221,42
5145,282,8359,1471598,1471880,45
9167,62,8359,346444,346506,46
3089,257,8359,1400769,1401026,46
5220,201,8359,346726,346927,49
8663,93,8360,346926,347019,5
1918,258,8360,1400801,1401059,11
2623,8,8360,347243,347251,19
3600,251,8360,1400837,1401088,44
6883,47,8361,347472,347519,34
1165,52,8362,347518,347570,8
3810,239,8362,1400859,1401098,16
6127,131,8362,347797,347928,22
1514,119,8362,347928,348047,27
9703,84,8363,348046,348130,18
8416,229,8363,1400873,1401102,26
1082,38,8363,348354,348392,38
1303,45,8363,348392,348437,39
2437,17,8363,348437,348454,47
4352,213,8364,348453,348666,2
1123,37,8364,348666,348703,9
7152,142,8364,348703,348845,37
8564,135,8365,348844,348979,11
5624,133,8365,348979,349112,15
5294,300,8365,1476765,1477065,41
1377,46,8366,349336,349382,10
7425,247,8366,1400931,1401178,16
7209,200,8366,349609,349809,18
7455,67,8366,349809,349876,19
1595,91,8366,349876,349967,35
5897,138,8366,349967,350105,36
9670,161,8367,350104,350265,8
3738,132,8367,350265,350397,20
7737,136,8367,350397,350533,20
2840,134,8367,350533,350667,21
4870,59,8367,350667,350726,32
2119,80,8367,350726,350806,34
9715,236,8367,1400955,1401191,44
5944,208,8368,351027,351235,5
1667,291,8368,1471605,1471896,10
9864,102,8368,351458,351560,22
8590,49,8368,351560,351609,42
1872,34,8368,351609,351643,44
2246,232,8368,1401021,1401253,48
2784,153,8368,351866,352019,49
4633,151,8369,352018,352169,10
2748,170,8369,352169,352339,14
7794,298,8369,1476383,1476681,18
1871,272,8369,1401091,1401363,29
1025,296,8369,1471626,1471922,35
3098,39,8369,353014,353053,40
1627,185,8369,353053,353238,49
3830,197,8370,353237,353434,27
1269,62,8370,353434,353496,30
9874,61,8370,353496,353557,46
3631,172,8371,353556,353728,16
9559,280,8372,1401185,1401465,1
2473,172,8372,353952,354124,21
2640,175,8372,354124,354299,34
2255,285,8373,1471637,1471922,31
5618,64,8373,354526,354590,48
4742,261,8374,1401294,1401555,18
6441,42,8374,354811,354853,23
8179,65,8374,354853,354918,26
3473,131,8375,354917,355048,31
6798,179,8375,355048,355227,44
9219,173,8376,355226,355399,4
5523,121,8376,355399,355520,10
9521,82,8376,355520,355602,11
4986,279,8376,1471641,1471920,19
7857,188,8376,355817,356005,23
5233,113,8376,356005,356118,28
9713,113,8376,356118,356231,32
8332,227,8376,1401396,1401623,42
4502,251,8376,1401399,1401650,45
5142,75,8377,356674,356749,27
3393,162,8377,356749,356911,33
4241,297,8377,1476379,1476676,33
7421,133,8377,357128,357261,43
1979,173,8379,357259,357432,10
7185,218,8379,357432,357650,23
2670,47,8379,357650,357697,29
7712,282,8380,1471654,1471936,11
1194,199,8380,357920,358119,43
6122,71,8381,358118,358189,11
2200,276,8382,1401533,1401809,38
9115,296,8383,1476375,1476671,3
1803,264,8383,1401642,1401906,21
1100,202,8383,358860,359062,49
8060,260,8384,1401682,1401942,10
9441,214,8384,359284,359498,29
1913,210,8385,359497,359707,21
6583,161,8385,359707,359868,25
7350,84,8385,359868,359952,38
3014,146,8386,359951,360097,18
9990,262,8386,1401716,1401978,21
8183,261,8386,1401758,1402019,46
6860,174,8387,360540,360714,3
5507,200,8387,360714,360914,21
6435,146,8388,360913,361059,1
5524,214,8388,361059,361273,19
9403,11,8389,361272,361283,9
1387,180,8389,361283,361463,21
6498,294,8389,1471660,1471954,31
5671,59,8389,361691,361750,45
4946,286,8390,1471676,1471962,10
6061,213,8390,361972,362185,18
5417,87,8390,362185,362272,38
7623,78,8391,362271,362349,5
9748,77,8391,362349,362426,36
9198,227,8391,362426,362653,36
6676,194,8391,362653,362847,38
3082,48,8392,362846,362894,5
2417,132,8392,362894,363026,5
7647,14,8392,363026,363040,6
1238,51,8392,363040,363091,40
9365,41,8393,363090,363131,3
2546,297,8393,1476365,1476662,20
3469,86,8393,363358,363444,31
4259,291,8393,1471688,1471979,41
9911,204,8393,363669,363873,42
7083,167,8393,363873,364040,43
5029,61,8394,364039,364100,24
6572,185,8394,364100,364285,32
1147,152,8394,364285,364437,38
4874,171,8394,364437,364608,39
5065,202,8395,364607,364809,1
3158,281,8395,1471698,1471979,15
1211,253,8396,1402069,1402322,4
3288,119,8396,365249,365368,14
1566,95,8396,365368,365463,47
1439,279,8397,1402095,1402374,30
7924,232,8397,1402152,1402384,40
6196,87,8397,365910,365997,46
3699,24,8398,365996,366020,1
4982,57,8398,366020,366077,15
7991,237,8398,1402156,1402393,16
9372,8,8398,366304,366312,25
9438,98,8398,366312,366410,25
2350,38,8398,366410,366448,42
7227,38,8399,366447,366485,18
2698,5,8399,366485,366490,22
5637,259,8399,1402166,1402425,30
6190,109,8400,366715,366824,2
4671,258,8401,1402201,1402459,5
7323,10,8401,367045,367055,13
4311,257,8401,1402235,1402492,21
9055,64,8401,367279,367343,46
3980,59,8401,367343,367402,48
1431,196,8402,367401,367597,1
3822,219,8402,367597,367816,1
7545,208,8402,367816,368024,23
7456,47,8402,368024,368071,31
2222,118,8403,368070,368188,6
4726,153,8403,368188,368341,12
9049,232,8403,1402266,1402498,21
5320,124,8403,368565,368689,26
6139,276,8404,1402275,1402551,5
2549,285,8404,1471691,1471976,27
9410,41,8405,369132,369173,9
4041,293,8405,1471692,1471985,28
7409,28,8405,369393,369421,41
1690,286,8406,1471706,1471992,32
4170,198,8406,369641,369839,35
5864,269,8406,1402502,1402771,39
1726,60,8406,370062,370122,49
4267,82,8407,370121,370203,15
3728,244,8407,1402550,1402794,28
1534,118,8407,370423,370541,37
7519,293,8408,1471708,1472001,17
9833,79,8408,370764,370843,28
3906,248,8408,1402632,1402880,29
4695,180,8408,371062,371242,31
9952,228,8408,1402656,1402884,34
9518,35,8408,371466,371501,39
6568,138,8408,371501,371639,41
7286,64,8409,371638,371702,1
2904,12,8409,371702,371714,3
5858,31,8409,371714,371745,27
2963,58,8410,371744,371802,2
4877,90,8410,371802,371892,6
2109,54,8410,371892,371946,12
5254,235,8410,1402657,1402892,37
2576,74,8410,372171,372245,42
7333,60,8410,372245,372305,43
1441,209,8410,372305,372514,43
9117,56,8411,372513,372569,12
6646,73,8411,372569,372642,19
2071,131,8411,372642,372773,19
3066,257,8411,1402667,1402924,26
3117,300,8411,1476720,1477020,29
4014,49,8411,373216,373265,34
7407,74,8412,373264,373338,9
6596,226,8412,1402761,1402987,11
2482,299,8412,1476722,1477021,13
8735,66,8412,373790,373856,18
6185,97,8412,373856,373953,22
2007,190,8412,373953,374143,40
3778,160,8412,374143,374303,42
1218,128,8413,374302,374430,18
9933,46,8413,374430,374476,21
1975,211,8413,374476,374687,34
3941,123,8413,374687,374810,46
5232,96,8413,374810,374906,50
8617,92,8414,374905,374997,17
6437,30,8414,374997,375027,30
8611,207,8414,375027,375234,40
2050,99,8414,375234,375333,41
4808,32,8415,375332,375364,3
3959,166,8415,375364,375530,18
4763,30,8415,375530,375560,21
8614,269,8415,1402812,1403081,34
1788,147,8416,375783,375930,7
1049,235,8416,1402857,1403092,10
4907,277,8416,1402866,1403143,38
4024,4,8416,376379,376383,48
1878,176,8416,376383,376559,49
6293,169,8416,376559,376728,50
8445,246,8417,1402917,1403163,1
4435,188,8417,376952,377140,6
7666,9,8417,377140,377149,32
2335,256,8417,1402941,1403197,44
6351,280,8418,1471743,1472023,11
1317,77,8418,377594,377671,31
3912,229,8419,1403029,1403258,15
2149,93,8419,377890,377983,17
9283,195,8419,377983,378178,22
2102,233,8419,1403044,1403277,22
8421,280,8419,1471743,1472023,26
4266,266,8419,1403107,1403373,37
9062,15,8419,378841,378856,38
9470,158,8419,378856,379014,48
5767,134,8420,379013,379147,8
2638,205,8420,379147,379352,9
3667,156,8420,379352,379508,17
5246,86,8420,379508,379594,38
3506,293,8420,1471741,1472034,45
6353,114,8421,379817,379931,6
9350,214,8421,379931,380145,21
3132,153,8421,380145,380298,29
8334,7,8421,380298,380305,42
7866,279,8421,1403204,1403483,45
1868,211,8422,380528,380739,7
5419,112,8422,380739,380851,13
4344,278,8422,1471758,1472036,22
8113,231,8422,1403314,1403545,31
4520,212,8422,381293,381505,36
4723,288,8423,1471753,1472041,2
7202,33,8423,381729,381762,33
1344,177,8423,381762,381939,39
1244,185,8423,381939,382124,45
9179,275,8424,1403377,1403652,10
1409,15,8424,382346,382361,29
9946,240,8424,1403429,1403669,48
6123,234,8425,1403446,1403680,5
2015,6,8425,382805,382811,22
8192,57,8425,382811,382868,22
4287,277,8425,1403461,1403738,25
7301,57,8425,383087,383144,41
1384,83,8425,383144,383227,45
2157,62,8425,383227,383289,49
8860,45,8426,383288,383333,17
6459,19,8426,383333,383352,25
3905,17,8426,383352,383369,40
8657,272,8426,1403515,1403787,40
7986,35,8426,383591,383626,49
4827,232,8427,1403565,1403797,4
3629,65,8427,383846,383911,11
9634,155,8427,383911,384066,40
8149,76,8427,384066,384142,44
9959,110,8427,384142,384252,44
2073,237,8428,1403571,1403808,1
5163,123,8428,384476,384599,19
8514,68,8428,384599,384667,34
4652,157,8428,384667,384824,38
6356,157,8428,384824,384981,40
7504,46,8428,384981,385027,47
2592,96,8429,385026,385122,6
7553,94,8429,385122,385216,16
1295,75,8429,385216,385291,18
3663,152,8431,385289,385441,11
3207,160,8430,385442,385602,11
4149,270,8431,1403586,1403856,47
7592,144,8432,385819,385963,1
5264,12,8432,385963,385975,24
5456,247,8432,1403631,1403878,34
4245,80,8433,386198,386278,12
4501,138,8433,386278,386416,24
4278,20,8433,386416,386436,29
2991,1,8433,386436,386437,34
5550,88,8434,386436,386524,26
8830,27,8434,386524,386551,29
1343,66,8434,386551,386617,30
5725,129,8434,386617,386746,30
7294,294,8434,1471749,1472043,36
6464,143,8434,386976,387119,37
1823,296,8434,1471761,1472057,44
8799,142,8434,387341,387483,47
1837,109,8435,387482,387591,1
8443,40,8435,387591,387631,22
1449,181,8435,387631,387812,44
6099,281,8436,1403760,1404041,2
9338,96,8436,388036,388132,9
2024,20,8436,388132,388152,11
6866,44,8436,388152,388196,14
8726,158,8436,388196,388354,30
2974,47,8437,388353,388400,28
4223,167,8437,388400,388567,33
2144,131,8437,388567,388698,43
2896,105,8437,388698,388803,45
8336,193,8438,388802,388995,5
6698,82,8438,388995,389077,9
2918,2,8438,389077,389079,10
1553,205,8438,389079,389284,13
4380,54,8438,389284,389338,14
7477,191,8438,389338,389529,15
8584,228,8438,1403824,1404052,19
9776,147,8438,389744,389891,26
4292,283,8438,1403832,1404115,28
4510,268,8438,1403895,1404163,42
5911,107,8438,390331,390438,49
2061,87,8439,390437,390524,15
7698,77,8439,390524,390601,23
7207,68,8439,390601,390669,27
6734,139,8439,390669,390808,43
3559,255,8439,1403940,1404195,44
4592,138,8440,391029,391167,6
1022,234,8440,1403969,1404203,23
1888,40,8440,391392,391432,33
3836,160,8441,391431,391591,34
2950,89,8442,391590,391679,13
2506,257,8442,1403982,1404239,24
1748,110,8442,391898,392008,44
7909,112,8442,392008,392120,48
7778,274,8442,1404016,1404290,48
4900,170,8443,392342,392512,34
5605,43,8443,392512,392555,50
5102,70,8444,392554,392624,8
2351,279,8444,1471773,1472052,22
3364,187,8445,392837,393024,40
8503,108,8446,393023,393131,5
9205,22,8446,393131,393153,11
7844,287,8446,1471768,1472055,17
6836,25,8446,393377,393402,35
5746,119,8446,393402,393521,36
7509,256,8447,1404181,1404437,5
9025,197,8447,393742,393939,19
2290,44,8447,393939,393983,42
8365,137,8447,393983,394120,48
9855,195,8448,394119,394314,16
7041,19,8448,394314,394333,24
2993,222,8448,394333,394555,38
9084,37,8448,394555,394592,42
3964,148,8448,394592,394740,45
8809,50,8449,394739,394789,6
7336,195,8450,394788,394983,25
9961,145,8450,394983,395128,39
4702,94,8450,395128,395222,41
5597,69,8451,395221,395290,11
7420,283,8451,1471770,1472053,18
1200,37,8451,395512,395549,22
5180,57,8451,395549,395606,42
7008,60,8451,395606,395666,45
5272,60,8451,395666,395726,48
3508,120,8452,395725,395845,31
6773,160,8452,395845,396005,36
9688,201,8452,396005,396206,38
2416,4,8452,396206,396210,42
4492,181,8453,396209,396390,2
2776,242,8453,1404265,1404507,11
4443,259,8453,1404277,1404536,36
8437,246,8454,1404308,1404554,16
9554,52,8454,397070,397122,18
3553,157,8454,397122,397279,20
5415,118,8454,397279,397397,26
6481,218,8454,397397,397615,31
7841,103,8454,397615,397718,43
6072,280,8454,1471771,1472051,48
2114,167,8455,397940,398107,6
2357,260,8455,1404387,1404647,6
7136,57,8455,398329,398386,10
8482,296,8455,1471766,1472062,14
1569,280,8455,1404480,1404760,30
5592,205,8455,398837,399042,41
1531,52,8455,399042,399094,47
3116,280,8456,1471783,1472063,11
4878,230,8456,1404588,1404818,14
2025,99,8456,399542,399641,35
4077,144,8457,399640,399784,7
6112,165,8457,399784,399949,41
3971,1,8458,399948,399949,9
5668,179,8458,399949,400128,9
3849,173,8458,400128,400301,33
7959,73,8458,400301,400374,37
1492,149,8459,400373,400522,21
7586,122,8459,400522,400644,27
6442,297,8459,1476305,1476602,31
8513,273,8459,1404651,1404924,33
3797,137,8459,401089,401226,35
6825,187,8459,401226,401413,42
2306,102,8460,401412,401514,2
6034,128,8460,401514,401642,6
6636,22,8460,401642,401664,18
3233,203,8460,401664,401867,22
3855,10,8460,401867,401877,28
3574,52,8460,401877,401929,32
5735,112,8460,401929,402041,34
6887,102,8460,402041,402143,46
5303,198,8460,402143,402341,49
2874,288,8461,1471791,1472079,2
3140,86,8461,402565,402651,3
2439,123,8461,402651,402774,5
4198,258,8461,1404759,1405017,15
5726,71,8461,402994,403065,19
9798,29,8461,403065,403094,31
2854,166,8462,403093,403259,17
5878,97,8462,403259,403356,27
5268,44,8462,403356,403400,28
9707,260,8463,1404800,1405060,19
7939,163,8463,403614,403777,42
9773,140,8464,403776,403916,7
6440,7,8464,403916,403923,9
6665,181,8464,403923,404104,15
8964,62,8464,404104,404166,24
6360,6,8464,404166,404172,26
9550,194,8464,404172,404366,31
1657,160,8464,404366,404526,33
5598,28,8464,404526,404554,37
6138,116,8464,404554,404670,37
6685,22,8464,404670,404692,49
3234,259,8465,1404833,1405092,37
9178,116,8465,404916,405032,41
6394,296,8465,1476301,1476597,42
7481,122,8465,405252,405374,48
1636,217,8465,405374,405591,48
2198,66,8466,405590,405656,10
3781,95,8466,405656,405751,10
8548,22,8466,405751,405773,11
3637,80,8466,405773,405853,16
5358,88,8467,405852,405940,5
5341,73,8467,405940,406013,7
1698,74,8467,406013,406087,13
5338,72,8467,406087,406159,42
3724,169,8467,406159,406328,43
4549,289,8468,1471812,1472101,8
7097,63,8468,406544,406607,12
7679,153,8468,406607,406760,13
2251,113,8468,406760,406873,15
7048,248,8468,1404983,1405231,21
9743,270,8468,1405012,1405282,24
2274,218,8468,407316,407534,40
4893,230,8468,1405060,1405290,44
7254,46,8468,407756,407802,48
6405,111,8468,407802,407913,50
8811,227,8469,1405064,1405291,2
3094,217,8469,408137,408354,13
9954,24,8469,408354,408378,24
4316,82,8469,408378,408460,25
5195,158,8469,408460,408618,30
6371,59,8469,408618,408677,31
7035,10,8469,408677,408687,33
7382,265,8470,1405069,1405334,4
7527,51,8470,408907,408958,14
5871,291,8470,1471815,1472106,14
2793,157,8470,409183,409340,17
4734,162,8470,409340,409502,19
5164,195,8470,409502,409697,25
2206,112,8470,409697,409809,33
6653,232,8470,1405167,1405399,38
8317,258,8471,1405173,1405431,1
9639,185,8471,410259,410444,6
9629,121,8471,410444,410565,11
8247,82,8471,410565,410647,33
6030,79,8472,410646,410725,8
9544,265,8472,1405213,1405478,8
4183,64,8472,410942,411006,40
2089,248,8473,1405260,1405508,8
4911,83,8473,411222,411305,14
4849,3,8473,411305,411308,15
3569,51,8473,411308,411359,20
6046,279,8473,1405286,1405565,40
8919,171,8474,411580,411751,7
7375,80,8474,411751,411831,14
2474,275,8474,1405340,1405615,34
4850,125,8474,412055,412180,43
2185,208,8475,412179,412387,3
4283,116,8475,412387,412503,17
7371,200,8475,412503,412703,17
2020,177,8475,412703,412880,34
7471,26,8475,412880,412906,38
4654,87,8476,412905,412992,23
6675,177,8476,412992,413169,29
5340,29,8476,413169,413198,50
4926,93,8477,413197,413290,17
6236,38,8477,413290,413328,20
3021,183,8477,413328,413511,26
4257,193,8477,413511,413704,34
3056,245,8477,1405392,1405637,46
7283,22,8478,413923,413945,2
4016,138,8478,413945,414083,12
9754,222,8478,1405422,1405644,22
4092,237,8478,1405420,1405657,26
3896,100,8478,414521,414621,28
8188,45,8478,414621,414666,35
9457,5,8479,414665,414670,39
1898,94,8480,414669,414763,30
2864,264,8480,1405430,1405694,41
9011,34,8481,414987,415021,2
8412,63,8481,415021,415084,5
3402,34,8481,415084,415118,19
5153,292,8481,1471812,1472104,25
4902,154,8481,415337,415491,32
7415,144,8481,415491,415635,44
1508,149,8482,415634,415783,8
8465,75,8482,415783,415858,20
4995,15,8482,415858,415873,23
8766,123,8482,415873,415996,24
9657,118,8482,415996,416114,36
3711,280,8482,1405530,1405810,38
7327,60,8482,416340,416400,49
3395,143,8483,416399,416542,31
7707,93,8483,416542,416635,40
1077,188,8483,416635,416823,47
2815,251,8484,1405585,1405836,3
1167,203,8484,417045,417248,11
4440,84,8484,417248,417332,19
7195,78,8484,417332,417410,24
5353,114,8484,417410,417524,39
9822,108,8485,417523,417631,8
3490,16,8485,417631,417647,27
3309,139,8485,417647,417786,29
9386,159,8486,417785,417944,6
7723,161,8486,417944,418105,11
7379,239,8486,1405606,1405845,13
7428,280,8486,1405623,1405903,18
6879,259,8486,1405689,1405948,22
2305,29,8486,418769,418798,24
4137,65,8487,418797,418862,8
9089,80,8487,418862,418942,18
4100,207,8487,418942,419149,34
7498,238,8487,1405723,1405961,34
9869,15,8487,419373,419388,48
4680,6,8488,419387,419393,19
6251,234,8488,1405733,1405967,20
5068,18,8488,419620,419638,21
7226,267,8488,1405733,1406000,35
8728,295,8488,1476280,1476575,38
7255,236,8488,1405832,1406068,39
8326,12,8488,420321,420333,46
9866,181,8489,420332,420513,9
7773,299,8489,1476647,1476946,16
7014,175,8489,420740,420915,26
7714,126,8489,420915,421041,38
6762,88,8489,421041,421129,43
4731,120,8490,421128,421248,11
9440,294,8490,1471840,1472134,25
5466,222,8490,421467,421689,48
2532,146,8490,421689,421835,49
7739,91,8491,421834,421925,4
5847,69,8491,421925,421994,40
2715,122,8491,421994,422116,41
5642,96,8491,422116,422212,45
6624,94,8492,422211,422305,2
7094,141,8492,422305,422446,2
4234,272,8492,1405957,1406229,7
2644,250,8492,1406015,1406265,22
2651,95,8492,422882,422977,38
1635,181,8492,422977,423158,41
9098,161,8493,423157,423318,4
8666,139,8493,423318,423457,12
4852,270,8493,1406038,1406308,38
2219,42,8493,423683,423725,41
6269,245,8494,1406084,1406329,3
6413,144,8494,423947,424091,5
5367,298,8494,1476644,1476942,9
3662,82,8494,424309,424391,46
6683,180,8494,424391,424571,50
2515,192,8495,424570,424762,10
1658,39,8495,424762,424801,16
7548,60,8495,424801,424861,19
8965,276,8495,1406161,1406437,23
1859,107,8495,425086,425193,44
3381,168,8495,425193,425361,45
6591,222,8496,425360,425582,3
3353,40,8496,425582,425622,5
8036,37,8496,425622,425659,22
1921,280,8496,1406217,1406497,24
4015,254,8496,1406278,1406532,47
9650,277,8497,1406306,1406583,1
2163,102,8497,426321,426423,12
9310,245,8497,1406349,1406594,35
2287,211,8497,426657,426868,43
3084,275,8498,1406371,1406646,7
2433,245,8498,1406416,1406661,36
8462,219,8498,427319,427538,49
8500,169,8499,427537,427706,20
3752,211,8499,427706,427917,20
3706,59,8499,427917,427976,33
6981,271,8499,1406437,1406708,48
7689,212,8500,428198,428410,5
1196,108,8500,428410,428518,26
8182,229,8500,428518,428747,35
9543,209,8500,428747,428956,36
6609,144,8500,428956,429100,49
1214,300,8501,1476274,1476574,1
1150,96,8501,429324,429420,8
4704,134,8501,429420,429554,10
2459,80,8501,429554,429634,23
1289,255,8501,1406540,1406795,27
1133,253,8501,1406569,1406822,30
5818,155,8501,430083,430238,31
9619,289,8501,1471870,1472159,35
6013,29,8501,430472,430501,46
6192,144,8501,430501,430645,48
4923,230,8501,1406649,1406879,50
6290,299,8502,1476277,1476576,1
7636,99,8502,431092,431191,4
5984,274,8502,1406711,1406985,26
8587,104,8502,431415,431519,39
6305,143,8502,431519,431662,50
6620,12,8503,431661,431673,6
8731,286,8503,1471892,1472178,15
6692,18,8503,431893,431911,20
8943,21,8503,431911,431932,24
6563,157,8503,431932,432089,28
2743,182,8503,432089,432271,29
6908,282,8504,1471899,1472181,33
7292,35,8504,432487,432522,37
2505,7,8505,432521,432528,2
3223,145,8505,432528,432673,14
4442,103,8505,432673,432776,30
6718,252,8505,1406878,1407130,34
4796,196,8505,433000,433196,44
5687,140,8506,433195,433335,24
6846,85,8506,433335,433420,28
8738,237,8507,1406903,1407140,2
4969,253,8507,1406916,1407169,17
1126,205,8507,433868,434073,24
6674,168,8507,434073,434241,39
7612,280,8507,1406947,1407227,40
3607,87,8507,434463,434550,43
3011,138,8508,434549,434687,3
4370,156,8508,434687,434843,8
7302,118,8508,434843,434961,27
9333,213,8508,434961,435174,33
7700,240,8508,1407009,1407249,33
1366,263,8508,1407025,1407288,34
8488,175,8509,435614,435789,5
7843,113,8509,435789,435902,18
9522,77,8509,435902,435979,32
7492,44,8509,435979,436023,44
6114,1,8509,436023,436024,47
8979,134,8510,436023,436157,7
1774,188,8510,436157,436345,18
1587,15,8510,436345,436360,32
9254,126,8510,436360,436486,32
5159,94,8510,436486,436580,33
5406,144,8510,436580,436724,36
9228,272,8510,1407061,1407333,37
4176,184,8510,436949,437133,46
9793,175,8511,437132,437307,10
7511,132,8511,437307,437439,29
3871,219,8511,437439,437658,34
4593,38,8511,437658,437696,36
6918,170,8512,437695,437865,1
7311,234,8512,1407109,1407343,5
5856,212,8512,438087,438299,13
7946,79,8512,438299,438378,14
5759,297,8512,1476270,1476567,14
8123,156,8512,438603,438759,16
4265,87,8512,438759,438846,31
4653,75,8512,438846,438921,42
8290,219,8512,438921,439140,48
8138,288,8513,1471901,1472189,21
1950,42,8513,439363,439405,34
9078,144,8514,439404,439548,2
8692,241,8514,1407240,1407481,25
3224,215,8514,439767,439982,36
4825,83,8515,439981,440064,1
7096,191,8515,440064,440255,1
3773,77,8515,440255,440332,17
3777,124,8515,440332,440456,23
8155,91,8515,440456,440547,46
4990,226,8516,1407257,1407483,6
9423,259,8516,1407265,1407524,9
9766,211,8516,440986,441197,15
8143,243,8516,1407301,1407544,50
6364,245,8516,1407321,1407566,50
4913,207,8517,441642,441849,20
4426,281,8517,1407337,1407618,31
6110,143,8517,442077,442220,33
2618,211,8517,442220,442431,38
3535,167,8518,442430,442597,40
6542,300,8518,1476619,1476919,43
3145,31,8519,442819,442850,22
4273,183,8519,442850,443033,32
3060,236,8519,1407454,1407690,32
5006,294,8519,1471919,1472213,32
6335,38,8519,443475,443513,33
9290,128,8519,443513,443641,36
1842,209,8519,443641,443850,45
6786,279,8520,1407523,1407802,3
9236,207,8520,444072,444279,8
4627,23,8520,444279,444302,11
6436,195,8520,444302,444497,15
8136,19,8520,444497,444516,21
7999,296,8520,1476268,1476564,38
8297,169,8521,444741,444910,22
6358,140,8521,444910,445050,29
5058,209,8521,445050,445259,41
3306,170,8522,445258,445428,1
3995,141,8522,445428,445569,2
6092,297,8522,1476267,1476564,3
4673,155,8522,445792,445947,20
7786,163,8522,445947,446110,33
1550,292,8522,1476276,1476568,47
2429,242,8522,1407746,1407988,48
4423,13,8523,446551,446564,1
9724,173,8523,446564,446737,3
5791,214,8523,446737,446951,15
3106,46,8523,446951,446997,40
1059,45,8523,446997,447042,42
2354,239,8524,1407758,1407997,13
9346,47,8524,447269,447316,14
1459,28,8524,447316,447344,18
6332,25,8524,447344,447369,31
7976,26,8524,447369,447395,35
2059,287,8524,1471967,1472254,36
7106,13,8525,447624,447637,5
8904,90,8525,447637,447727,7
1523,271,8525,1407823,1408094,11
7180,158,8525,447951,448109,13
6312,267,8525,1407879,1408146,19
2694,135,8525,448324,448459,29
6389,153,8525,448459,448612,39
5266,284,8525,1471973,1472257,50
3925,288,8526,1471974,1472262,43
5720,184,8527,449056,449240,1
5171,272,8527,1408035,1408307,2
3262,168,8527,449465,449633,24
9199,12,8527,449633,449645,26
6349,113,8528,449644,449757,19
4545,123,8529,449756,449879,4
3705,205,8529,449879,450084,12
6017,158,8529,450084,450242,21
5693,23,8529,450242,450265,25
6088,202,8529,450265,450467,31
2750,114,8530,450466,450580,1
3204,129,8530,450580,450709,1
8698,47,8530,450709,450756,7
4326,291,8530,1471979,1472270,15
3046,257,8530,1408146,1408403,33
3029,261,8530,1408169,1408430,35
4401,161,8530,451427,451588,41
7507,240,8530,1408211,1408451,47
4948,276,8530,1408228,1408504,48
9545,12,8531,452029,452041,20
7250,99,8531,452041,452140,39
2587,7,8531,452140,452147,47
3421,255,8532,1408277,1408532,1
3747,259,8532,1408317,1408576,19
9526,148,8532,452586,452734,21
3894,128,8532,452734,452862,27
2962,274,8532,1408354,1408628,40
5486,121,8533,453083,453204,17
6086,107,8533,453204,453311,28
1536,260,8533,1408399,1408659,31
6227,156,8533,453539,453695,35
2603,219,8534,453694,453913,36
4674,213,8534,453913,454126,47
3003,36,8535,454125,454161,4
1796,94,8535,454161,454255,33
5975,256,8535,1408432,1408688,37
9985,182,8535,454480,454662,42
6045,98,8536,454661,454759,11
3235,131,8536,454759,454890,12
2753,202,8536,454890,455092,17
3568,54,8536,455092,455146,26
1826,129,8536,455146,455275,37
7182,96,8537,455274,455370,16
5312,95,8537,455370,455465,23
6545,139,8537,455465,455604,26
4382,122,8537,455604,455726,27
1625,154,8537,455726,455880,31
9477,175,8537,455880,456055,49
7215,146,8538,456054,456200,19
2683,26,8538,456200,456226,20
5747,120,8538,456226,456346,39
6038,293,8539,1471982,1472275,8
7819,209,8539,456562,456771,24
2141,186,8539,456771,456957,27
2281,1,8539,456957,456958,33
3023,94,8539,456958,457052,34
1048,39,8539,457052,457091,36
8742,84,8539,457091,457175,49
1583,26,8540,457174,457200,4
4012,140,8540,457200,457340,14
2233,25,8540,457340,457365,50
3655,175,8541,457364,457539,21
5396,147,8541,457539,457686,27
3331,176,8541,457686,457862,44
6418,269,8541,1408525,1408794,47
3588,231,8541,1408572,1408803,49
1861,192,8542,458302,458494,10
9611,62,8542,458494,458556,24
3776,164,8542,458556,458720,35
3124,66,8543,458719,458785,23
2227,242,8544,1408578,1408820,5
9484,117,8544,459006,459123,36
3719,118,8544,459123,459241,43
6328,254,8544,1408598,1408852,44
6746,259,8544,1408630,1408889,49
3433,71,8545,459684,459755,16
2332,20,8545,459755,459775,21
8865,150,8545,459775,459925,34
7346,7,8545,459925,459932,49
2845,243,8546,1408666,1408909,4
8196,4,8546,460152,460156,23
4548,122,8546,460156,460278,33
7107,145,8546,460278,460423,38
5792,210,8546,460423,460633,40
4332,78,8546,460633,460711,47
4125,20,8547,460710,460730,48
6715,3,8548,460729,460732,16
7822,146,8548,460732,460878,30
1479,187,8549,460877,461064,4
4060,43,8549,461064,461107,10
4935,10,8549,461107,461117,18
1552,41,8549,461117,461158,20
7879,237,8549,1408681,1408918,23
1915,65,8550,461382,461447,9
2700,92,8550,461447,461539,13
5983,291,8550,1471980,1472271,35
2757,228,8551,1408743,1408971,3
3110,278,8551,1408749,1409027,7
6807,213,8551,462217,462430,9
2039,235,8551,1408804,1409039,10
8050,190,8551,462653,462843,14
8299,227,8551,1408815,1409042,17
6906,140,8551,463067,463207,23
3190,156,8552,463206,463362,12
5660,27,8552,463362,463389,16
2125,126,8552,463389,463515,16
3436,286,8552,1471990,1472276,27
1597,29,8553,463737,463766,8
2104,226,8553,1408873,1409099,43
5839,37,8554,463988,464025,5
6188,158,8554,464025,464183,6
6075,66,8554,464183,464249,31
1239,215,8554,464249,464464,49
8118,56,8554,464464,464520,50
2387,17,8555,464519,464536,11
9740,3,8555,464536,464539,28
6100,138,8555,464539,464677,33
2079,129,8555,464677,464806,39
1674,59,8555,464806,464865,49
9243,213,8555,464865,465078,49
5935,224,8556,465077,465301,20
3006,67,8556,465301,465368,29
7278,213,8557,465367,465580,10
6806,31,8557,465580,465611,17
2116,245,8557,1408880,1409125,19
7090,281,8557,1408900,1409181,23
3988,134,8557,466051,466185,34
5350,220,8558,466184,466404,10
2702,297,8558,1476236,1476533,14
6005,160,8558,466629,466789,49
6703,190,8559,466788,466978,8
6525,261,8559,1409019,1409280,29
7071,13,8560,467196,467209,6
3758,187,8560,467209,467396,11
4162,32,8560,467396,467428,41
7748,180,8561,467427,467607,10
7411,96,8561,467607,467703,15
9944,4,8561,467703,467707,16
6264,24,8561,467707,467731,26
5200,168,8561,467731,467899,28
3899,207,8561,467899,468106,41
6295,178,8561,468106,468284,46
5923,96,8562,468283,468379,4
2371,46,8562,468379,468425,9
5745,91,8562,468425,468516,9
7493,216,8562,468516,468732,24
3035,54,8562,468732,468786,43
9592,230,8562,1409057,1409287,46
8640,61,8563,469005,469066,2
9929,138,8563,469066,469204,28
6261,232,8563,1409067,1409299,29
5075,160,8563,469423,469583,36
5902,17,8563,469583,469600,40
1858,17,8564,469599,469616,28
7172,120,8564,469616,469736,31
4388,213,8564,469736,469949,35
7206,35,8565,469948,469983,7
5351,37,8565,469983,470020,12
2538,212,8565,470020,470232,14
4658,278,8565,1409075,1409353,18
4231,235,8565,1409119,1409354,35
9425,104,8565,470688,470792,46
7629,184,8565,470792,470976,47
4218,77,8566,470975,471052,7
2347,250,8566,1409134,1409384,24
7772,151,8566,471271,471422,31
7405,5,8566,471422,471427,35
8885,73,8567,471426,471499,17
6429,231,8567,1409159,1409390,17
8396,87,8567,471723,471810,30
4678,279,8567,1409164,1409443,30
3545,292,8567,1471992,1472284,36
8375,100,8567,472266,472366,40
6534,191,8567,472366,472557,47
3653,104,8568,472556,472660,1
7658,270,8568,1409273,1409543,15
7056,19,8568,472880,472899,19
9163,192,8568,472899,473091,31
9571,214,8568,473091,473305,32
6510,28,8568,473305,473333,33
9574,161,8568,473333,473494,34
8325,177,8568,473494,473671,42
5289,109,8568,473671,473780,47
1073,198,8569,473779,473977,25
3356,94,8569,473977,474071,36
1854,20,8569,474071,474091,47
3247,66,8570,474090,474156,50
8483,240,8571,1409315,1409555,2
2325,207,8571,474380,474587,9
7579,39,8571,474587,474626,11
8722,62,8571,474626,474688,12
6957,91,8571,474688,474779,29
7823,237,8571,1409336,1409573,29
4067,77,8571,474998,475075,38
8480,189,8571,475075,475264,45
9780,240,8572,1409350,1409590,6
4096,104,8572,475485,475589,14
7571,89,8572,475589,475678,17
5117,200,8573,475677,475877,8
7865,228,8573,1409371,1409599,9
1177,93,8573,476095,476188,13
9227,107,8573,476188,476295,40
4355,162,8574,476294,476456,6
9840,163,8574,476456,476619,12
5385,37,8574,476619,476656,28
2067,5,8574,476656,476661,35
2484,124,8574,476661,476785,38
4663,65,8574,476785,476850,42
9255,244,8574,1409375,1409619,43
1911,96,8574,477073,477169,46
1228,247,8575,1409395,1409642,10
5194,219,8575,477391,477610,16
1440,113,8575,477610,477723,30
2629,36,8575,477723,477759,32
5293,52,8575,477759,477811,47
1270,143,8575,477811,477954,49
5014,113,8576,477953,478066,12
1920,277,8576,1409417,1409694,17
4157,212,8576,478290,478502,22
1952,63,8576,478502,478565,23
5542,191,8576,478565,478756,26
8859,266,8576,1409471,1409737,27
4193,84,8576,478979,479063,44
6650,12,8576,479063,479075,48
1776,185,8577,479074,479259,16
6447,258,8577,1409517,1409775,24
5112,27,8577,479478,479505,29
6847,67,8577,479505,479572,29
6951,256,8577,1409553,1409809,44
7620,179,8577,479794,479973,46
1745,8,8577,479973,479981,50
3061,99,8578,479980,480079,4
2979,103,8578,480079,480182,5
7821,96,8578,480182,480278,9
7740,125,8578,480278,480403,37
9894,180,8579,480402,480582,3
8320,137,8579,480582,480719,7
7274,98,8579,480719,480817,14
8373,138,8579,480817,480955,25
5572,195,8579,480955,481150,26
1567,185,8579,481150,481335,31
7318,106,8579,481335,481441,33
8701,135,8579,481441,481576,33
6969,24,8579,481576,481600,41
8000,61,8579,481600,481661,44
5559,83,8579,481661,481744,47
7219,199,8579,481744,481943,50
1554,151,8580,481942,482093,2
7105,18,8580,482093,482111,14
8790,108,8580,482111,482219,16
1201,202,8580,482219,482421,21
4131,294,8580,1471988,1472282,25
2499,195,8580,482640,482835,27
4677,35,8581,482834,482869,2
4112,290,8581,1472004,1472294,10
2084,18,8581,483092,483110,22
4260,257,8581,1409709,1409966,22
5135,7,8581,483324,483331,33
8453,278,8582,1409742,1410020,27
3299,264,8583,1409797,1410061,6
6354,293,8583,1472013,1472306,6
2311,186,8583,483996,484182,15
8639,284,8583,1472028,1472312,32
1870,199,8583,484403,484602,33
9871,9,8583,484602,484611,42
7941,27,8583,484611,484638,43
5579,111,8583,484638,484749,48
2292,83,8584,484748,484831,12
1329,90,8584,484831,484921,13
7603,242,8584,1409946,1410188,13
8558,294,8584,1472029,1472323,23
2078,255,8584,1410023,1410278,44
6784,39,8584,485596,485635,49
2031,27,8585,485634,485661,13
7159,70,8585,485661,485731,19
2136,295,8585,1472039,1472334,25
9151,51,8585,485950,486001,30
9941,193,8585,486001,486194,40
3125,168,8586,486193,486361,10
4920,2,8586,486361,486363,27
8709,28,8586,486363,486391,28
3636,169,8587,486390,486559,24
8449,232,8587,1410109,1410341,36
3774,227,8587,1410116,1410343,41
2438,256,8587,1410119,1410375,45
1373,83,8588,487237,487320,6
2368,232,8588,1410157,1410389,8
1429,210,8588,487537,487747,49
7151,33,8589,487746,487779,1
9721,161,8589,487779,487940,29
2986,149,8589,487940,488089,35
4814,135,8589,488089,488224,41
7129,63,8589,488224,488287,42
7931,167,8590,488286,488453,5
2056,93,8590,488453,488546,26
4518,189,8590,488546,488735,29
7095,111,8590,488735,488846,38
2654,260,8591,1410161,1410421,1
9081,148,8591,489070,489218,26
1931,124,8591,489218,489342,28
8988,147,8591,489342,489489,43
3816,111,8591,489489,489600,50
4302,12,8592,489599,489611,2
6325,115,8592,489611,489726,3
8883,287,8592,1472046,1472333,3
2539,70,8592,489949,490019,26
7683,172,8593,490018,490190,10
2418,188,8593,490190,490378,21
6876,3,8593,490378,490381,29
5837,157,8593,490381,490538,38
3958,277,8594,1410253,1410530,3
6177,154,8594,490760,490914,9
5193,72,8594,490914,490986,37
9002,263,8595,1410311,1410574,9
1031,53,8595,491203,491256,19
9043,117,8595,491256,491373,26
6152,215,8595,491373,491588,30
3317,114,8595,491588,491702,35
5589,285,8595,1472046,1472331,41
4356,150,8596,491926,492076,10
9383,170,8596,492076,492246,11
1756,199,8596,492246,492445,22
4936,185,8596,492445,492630,43
3812,1,8597,492629,492630,16
4106,193,8597,492630,492823,16
4959,32,8597,492823,492855,49
8700,130,8598,492854,492984,20
8058,21,8598,492984,493005,26
7128,19,8598,493005,493024,29
1397,102,8598,493024,493126,33
5762,84,8599,493125,493209,17
5373,20,8599,493209,493229,30
3372,237,8599,1410401,1410638,31
8585,143,8599,493457,493600,33
9623,286,8600,1472044,1472330,1
8616,262,8600,1410473,1410735,4
1790,166,8600,494045,494211,23
9391,95,8600,494211,494306,26
7322,63,8600,494306,494369,28
8257,228,8600,1410518,1410746,33
9047,112,8600,494586,494698,38
7337,226,8601,1410523,1410749,6
5718,42,8601,494919,494961,16
9009,25,8601,494961,494986,19
6930,277,8601,1410524,1410801,23
1860,191,8601,495211,495402,30
9161,105,8601,495402,495507,31
3505,85,8602,495506,495591,1
9257,3,8602,495591,495594,4
3622,103,8602,495594,495697,5
1908,180,8602,495697,495877,21
3671,37,8602,495877,495914,28
8803,55,8602,495914,495969,32
8520,187,8602,495969,496156,37
4117,250,8602,1410578,1410828,40
3659,136,8603,496377,496513,13
3399,205,8603,496513,496718,29
1919,48,8604,496717,496765,9
8827,58,8604,496765,496823,39
4532,215,8605,496822,497037,12
1995,249,8605,1410591,1410840,35
9832,13,8606,497270,497283,10
4932,175,8606,497283,497458,13
1909,41,8606,497458,497499,16
9601,35,8606,497499,497534,19
7257,96,8606,497534,497630,21
9099,58,8606,497630,497688,35
8868,213,8606,497688,497901,36
9777,43,8606,497901,497944,49
9442,125,8607,497943,498068,14
1833,299,8607,1476189,1476488,21
6496,28,8607,498292,498320,23
6890,278,8607,1410680,1410958,33
7593,257,8607,1410734,1410991,45
1581,50,8607,498761,498811,49
3004,300,8608,1476530,1476830,20
7569,134,8608,499037,499171,23
9449,290,8608,1472065,1472355,23
9760,275,8608,1410873,1411148,36
3566,34,8609,499625,499659,1
9293,5,8609,499659,499664,7
7801,179,8609,499664,499843,11
2345,253,8609,1410925,1411178,18
2914,189,8609,500065,500254,28
1588,69,8609,500254,500323,36
2774,46,8609,500323,500369,47
8470,163,8609,500369,500532,49
9032,193,8610,500531,500724,1
8559,248,8610,1410962,1411210,19
4574,250,8610,1410991,1411241,29
6350,247,8610,1411024,1411271,33
7948,227,8610,1411048,1411275,43
8609,17,8611,501597,501614,11
8407,174,8611,501614,501788,28
5665,198,8611,501788,501986,47
6299,132,8611,501986,502118,48
2942,191,8611,502118,502309,48
2773,89,8612,502308,502397,10
7681,8,8612,502397,502405,18
8234,125,8612,502405,502530,20
2648,141,8612,502530,502671,36
4775,210,8613,502670,502880,3
9858,148,8613,502880,503028,28
4758,229,8614,1411056,1411285,19
7968,187,8614,503242,503429,35
1781,33,8614,503429,503462,46
2243,182,8615,503461,503643,18
5040,111,8615,503643,503754,32
3456,127,8615,503754,503881,44
6001,8,8615,503881,503889,46
6215,164,8616,503888,504052,11
9448,9,8616,504052,504061,18
8740,135,8616,504061,504196,19
1310,119,8616,504196,504315,44
5628,176,8616,504315,504491,47
7733,249,8616,1411060,1411309,50
5148,283,8616,1472067,1472350,50
3028,119,8617,504936,505055,9
4594,129,8617,505055,505184,17
3396,230,8617,505184,505414,36
4379,292,8617,1472069,1472361,40
5796,194,8618,505635,505829,7
5383,64,8618,505829,505893,14
1813,228,8618,1411208,1411436,22
2419,244,8618,1411217,1411461,25
1516,117,8618,506326,506443,28
4937,199,8618,506443,506642,32
3769,288,8618,1472077,1472365,39
4906,155,8618,506865,507020,46
9373,266,8619,1411297,1411563,12
1243,256,8619,1411338,1411594,14
4205,270,8620,1411371,1411641,7
7951,196,8620,507688,507884,18
8647,190,8620,507884,508074,41
5826,48,8620,508074,508122,49
3290,1,8621,508121,508122,1
3815,186,8621,508122,508308,14
1852,54,8621,508308,508362,21
9529,61,8621,508362,508423,22
5306,188,8621,508423,508611,22
1537,286,8621,1472088,1472374,22
1434,103,8621,508825,508928,24
7488,4,8621,508928,508932,25
3435,31,8621,508932,508963,34
1990,21,8621,508963,508984,43
6856,295,8621,1472092,1472387,43
3477,49,8621,509207,509256,44
3152,203,8622,509255,509458,16
4715,245,8622,1411532,1411777,38
6245,238,8622,1411557,1411795,46
3608,284,8622,1472104,1472388,46
5754,70,8623,510123,510193,9
4617,36,8623,510193,510229,10
4927,52,8623,510229,510281,10
2749,232,8623,1411632,1411864,26
9005,270,8623,1411644,1411914,46
3510,173,8624,510724,510897,18
1360,85,8624,510897,510982,21
8429,281,8624,1472107,1472388,26
1962,133,8624,511206,511339,27
9368,259,8624,1411745,1412004,39
7911,36,8624,511562,511598,42
8374,204,8624,511598,511802,45
2182,195,8625,511801,511996,29
9972,300,8625,1476514,1476814,35
3772,185,8625,512230,512415,36
4528,25,8626,512414,512439,17
6975,197,8626,512439,512636,19
6320,174,8626,512636,512810,20
7102,223,8626,512810,513033,23
8261,273,8626,1411827,1412100,37
8683,16,8626,513258,513274,47
3926,148,8627,513273,513421,1
7030,48,8627,513421,513469,10
4294,63,8627,513469,513532,40
6843,210,8627,513532,513742,43
2678,70,8628,513741,513811,14
8250,84,8628,513811,513895,15
5495,263,8628,1411871,1412134,16
7232,257,8628,1411917,1412174,33
8447,298,8628,1476177,1476475,35
7894,70,8628,514573,514643,37
5849,71,8628,514643,514714,46
9157,227,8629,1412002,1412229,4
3202,135,8629,514934,515069,18
6905,164,8629,515069,515233,28
6574,60,8629,515233,515293,39
7820,253,8630,1412006,1412259,7
8580,54,8630,515514,515568,11
2573,173,8630,515568,515741,14
8120,70,8630,515741,515811,19
6179,46,8630,515811,515857,27
1227,229,8631,1412033,1412262,2
3425,32,8631,516081,516113,33
3297,210,8631,516113,516323,33
4199,274,8631,1412040,1412314,40
3991,27,8631,516545,516572,47
5388,142,8631,516572,516714,48
1981,235,8631,1412091,1412326,48
5422,275,8631,1412103,1412378,48
1618,236,8632,1412159,1412395,9
8115,36,8632,517377,517413,11
1624,14,8632,517413,517427,45
3391,197,8633,517426,517623,5
7711,153,8633,517623,517776,6
2373,92,8633,517776,517868,11
9831,2,8633,517868,517870,14
8433,53,8633,517870,517923,16
3915,52,8633,517923,517975,35
8176,21,8634,517974,517995,8
4164,85,8634,517995,518080,32
7376,123,8634,518080,518203,33
5580,139,8634,518203,518342,36
3898,255,8634,1412168,1412423,37
7660,99,8634,518567,518666,40
5483,209,8635,518665,518874,9
8708,275,8635,1412197,1412472,41
2016,288,8635,1472122,1472410,48
9114,87,8636,519321,519408,14
3806,267,8636,1412303,1412570,21
1318,287,8636,1472126,1472413,39
4886,95,8636,519855,519950,45
7061,292,8636,1472132,1472424,45
1835,209,8636,520174,520383,46
8385,214,8637,520382,520596,2
7363,23,8637,520596,520619,3
8818,141,8637,520619,520760,5
7164,162,8637,520760,520922,15
9542,28,8637,520922,520950,16
9046,172,8637,520950,521122,16
3910,287,8637,1472145,1472432,19
2901,202,8637,521337,521539,30
2486,127,8637,521539,521666,35
2254,173,8637,521666,521839,38
3528,116,8637,521839,521955,50
1647,55,8638,521954,522009,47
3157,4,8639,522008,522012,20
8583,65,8639,522012,522077,38
3130,227,8640,1412524,1412751,5
9393,73,8640,522298,522371,14
4895,32,8640,522371,522403,26
6911,3,8641,522402,522405,2
4194,169,8641,522405,522574,12
8201,144,8641,522574,522718,27
8901,285,8641,1472145,1472430,28
9520,220,8641,522938,523158,43
3220,68,8641,523158,523226,44
8199,99,8642,523225,523324,1
1824,278,8642,1412597,1412875,19
1225,100,8642,523539,523639,23
5208,34,8642,523639,523673,28
4070,267,8642,1412649,1412916,30
5943,300,8643,1476497,1476797,28
8880,277,8643,1412754,1413031,34
6623,248,8644,1412802,1413050,13
7353,189,8644,524569,524758,26
7577,61,8644,524758,524819,36
1096,204,8645,524818,525022,10
6079,266,8645,1412829,1413095,15
4214,117,8645,525242,525359,22
2435,260,8646,1412869,1413129,2
3968,38,8646,525583,525621,35
9112,123,8646,525621,525744,44
7261,119,8647,525743,525862,2
5840,118,8647,525862,525980,5
1917,251,8647,1412903,1413154,23
4860,65,8647,526205,526270,25
3501,44,8647,526270,526314,38
6775,200,8648,526313,526513,1
3960,271,8648,1412930,1413201,43
5035,240,8648,1412979,1413219,49
8976,210,8649,526957,527167,1
2159,172,8649,527167,527339,23
5661,11,8649,527339,527350,48
7915,231,8649,1412995,1413226,50
4253,296,8650,1476163,1476459,16
3606,70,8650,527799,527869,18
1506,135,8650,527869,528004,20
1460,202,8650,528004,528206,32
6719,245,8650,1413054,1413299,40
8346,207,8650,528428,528635,42
4861,42,8651,528634,528676,17
7368,219,8652,528675,528894,2
5841,292,8652,1472165,1472457,2
8359,213,8652,529119,529332,32
6867,94,8652,529332,529426,35
8697,257,8652,1413128,1413385,38
5366,165,8653,529651,529816,10
5773,167,8653,529816,529983,12
1761,21,8653,529983,530004,22
4321,11,8653,530004,530015,41
9200,116,8654,530014,530130,2
1998,287,8654,1472175,1472462,37
9320,155,8655,530354,530509,14
8538,82,8655,530509,530591,22
6722,24,8655,530591,530615,36
6710,197,8655,530615,530812,37
5130,91,8656,530811,530902,7
1437,125,8656,530902,531027,24
8893,24,8656,531027,531051,30
5440,237,8656,1413219,1413456,33
5915,177,8656,531268,531445,39
1221,65,8657,531444,531509,19
7557,140,8657,531509,531649,35
1090,219,8657,531649,531868,41
5828,293,8658,1472176,1472469,1
3944,191,8658,532092,532283,2
1086,93,8658,532283,532376,10
2135,37,8658,532376,532413,41
3831,114,8658,532413,532527,46
1097,140,8659,532526,532666,29
5027,192,8659,532666,532858,30
8878,93,8659,532858,532951,33
6671,163,8660,532950,533113,4
2989,253,8660,1413288,1413541,4
8253,19,8660,533334,533353,6
5347,165,8660,533353,533518,13
6599,204,8660,533518,533722,14
3166,38,8660,533722,533760,30
6103,81,8660,533760,533841,34
5280,52,8660,533841,533893,36
7546,187,8660,533893,534080,43
7876,169,8660,534080,534249,49
1181,32,8661,534248,534280,3
3432,61,8661,534280,534341,6
1462,276,8661,1413323,1413599,8
3400,290,8661,1472189,1472479,10
9193,214,8661,534781,534995,14
5859,62,8661,534995,535057,29
7033,169,8661,535057,535226,36
4657,125,8662,535225,535350,9
9249,125,8662,535350,535475,19
2395,201,8662,535475,535676,19
8782,43,8662,535676,535719,37
9602,98,8662,535719,535817,37
9106,238,8663,1413429,1413667,7
2134,26,8663,536038,536064,14
5327,161,8663,536064,536225,24
8307,106,8663,536225,536331,25
1108,62,8663,536331,536393,34
5558,298,8664,1476149,1476447,35
7804,172,8665,536625,536797,7
1275,256,8665,1413491,1413747,17
6084,264,8665,1413528,1413792,24
7981,296,8665,1476151,1476447,24
4746,81,8665,537459,537540,27
6626,3,8665,537540,537543,45
5893,110,8666,537542,537652,7
3499,64,8666,537652,537716,22
9082,110,8666,537716,537826,22
3387,140,8666,537826,537966,24
1362,286,8666,1472219,1472505,30
3540,39,8666,538192,538231,32
7348,294,8667,1472225,1472519,7
2173,285,8667,1472237,1472522,12
7065,96,8667,538675,538771,13
5098,131,8667,538771,538902,20
1438,210,8667,538902,539112,20
8452,13,8667,539112,539125,31
8213,108,8667,539125,539233,35
6824,20,8667,539233,539253,38
9958,201,8667,539253,539454,38
3282,175,8668,539453,539628,1
1399,47,8668,539628,539675,5
7201,98,8668,539675,539773,5
1111,205,8668,539773,539978,20
9222,154,8669,539977,540131,14
2252,298,8669,1476148,1476446,24
4329,241,8669,1413853,1414094,36
3063,262,8669,1413864,1414126,36
6532,220,8669,540810,541030,37
3450,257,8669,1413903,1414160,43
5241,172,8670,541252,541424,24
5772,277,8670,1413940,1414217,25
8156,81,8670,541643,541724,28
2204,274,8670,1413983,1414257,35
7674,283,8671,1414029,1414312,20
6550,257,8671,1414092,1414349,42
8409,264,8671,1414125,1414389,45
1385,279,8671,1414166,1414445,48
3657,188,8672,542850,543038,17
2388,295,8672,1472249,1472544,23
8278,243,8672,1414271,1414514,36
5245,75,8672,543493,543568,38
5104,43,8672,543568,543611,44
1478,35,8672,543611,543646,47
2240,47,8673,543645,543692,11
1862,141,8673,543692,543833,26
7193,6,8673,543833,543839,33
8861,60,8673,543839,543899,41
8163,59,8674,543898,543957,1
9135,158,8674,543957,544115,3
2217,57,8674,544115,544172,6
8710,167,8675,544171,544338,17
6130,44,8675,544338,544382,32
9872,151,8675,544382,544533,43
7160,210,8675,544533,544743,50
9018,4,8676,544742,544746,19
9561,95,8676,544746,544841,29
3652,23,8676,544841,544864,30
8413,118,8676,544864,544982,37
7439,32,8676,544982,545014,42
1795,113,8677,545013,545126,9
3362,214,8677,545126,545340,16
6779,52,8677,545340,545392,25
8489,58,8677,545392,545450,25
9835,143,8677,545450,545593,38
4398,141,8677,545593,545734,46
4897,38,8678,545733,545771,10
1996,257,8678,1414285,1414542,10
9620,249,8678,1414327,1414576,19
6633,93,8678,546209,546302,24
4553,178,8678,546302,546480,30
7373,167,8679,546479,546646,17
9751,121,8679,546646,546767,27
4237,18,8679,546767,546785,49
8100,87,8680,546784,546871,25
2190,89,8680,546871,546960,39
3380,12,8680,546960,546972,42
5939,111,8680,546972,547083,45
2118,197,8681,547082,547279,36
2394,38,8682,547278,547316,6
5838,247,8682,1414345,1414592,16
1973,192,8682,547543,547735,42
4222,67,8683,547734,547801,12
1637,267,8683,1414371,1414638,15
5213,45,8683,548021,548066,33
2377,268,8683,1414414,1414682,45
1292,14,8684,548289,548303,26
3691,165,8684,548303,548468,34
6984,17,8684,548468,548485,40
6465,275,8684,1414458,1414733,50
2561,31,8685,548707,548738,28
2589,162,8685,548738,548900,28
5669,59,8686,548899,548958,47
5393,70,8687,548957,549027,8
6508,160,8688,549026,549186,2
9492,194,8688,549186,549380,5
4026,205,8688,549380,549585,31
9646,73,8688,549585,549658,39
7115,205,8688,549658,549863,40
9900,113,8689,549862,549975,15
2265,82,8689,549975,550057,18
5577,176,8689,550057,550233,42
3949,244,8689,1414509,1414753,47
3734,238,8690,1414524,1414762,13
3341,144,8690,550679,550823,50
5715,60,8691,550822,550882,21
6794,241,8691,1414547,1414788,22
9960,8,8691,551096,551104,32
8729,118,8691,551104,551222,35
8956,190,8692,551221,551411,4
6831,67,8692,551411,551478,15
6662,216,8692,551478,551694,20
5937,109,8692,551694,551803,38
9908,230,8692,1414567,1414797,46
3987,202,8693,552022,552224,4
1957,44,8693,552224,552268,13
1179,195,8693,552268,552463,26
1539,209,8693,552463,552672,40
3731,275,8694,1414567,1414842,13
4524,182,8694,552899,553081,16
3018,195,8694,553081,553276,22
5028,22,8694,553276,553298,41
6334,113,8694,553298,553411,47
5710,44,8695,553410,553454,4
1389,281,8695,1414614,1414895,20
4733,126,8695,553681,553807,24
2130,237,8695,1414667,1414904,31
5221,244,8695,1414670,1414914,35
3326,138,8695,554269,554407,43
3598,64,8696,554406,554470,10
7321,168,8696,554470,554638,15
1867,232,8696,1414691,1414923,18
4395,137,8696,554860,554997,20
5235,165,8696,554997,555162,23
9827,256,8696,1414701,1414957,44
3867,73,8696,555384,555457,48
4076,160,8697,555456,555616,15
3256,149,8697,555616,555765,31
9185,255,8697,1414732,1414987,45
6854,48,8698,555988,556036,2
9828,105,8698,556036,556141,18
5392,139,8698,556141,556280,18
1887,207,8698,556280,556487,23
9101,118,8698,556487,556605,31
2107,109,8698,556605,556714,33
4035,232,8698,1414761,1414993,37
2051,102,8698,556939,557041,38
7178,159,8698,557041,557200,47
9733,81,8699,557199,557280,11
3333,43,8699,557280,557323,15
4770,60,8699,557323,557383,44
3340,272,8699,1414770,1415042,49
5861,50,8700,557604,557654,1
8479,31,8700,557654,557685,2
7520,17,8700,557685,557702,5
1969,258,8700,1414813,1415071,13
4330,195,8700,557930,558125,25
2775,238,8700,1414848,1415086,27
1694,160,8700,558348,558508,28
5477,100,8700,558508,558608,50
8896,50,8702,558606,558656,15
1578,227,8703,1414861,1415088,7
1551,257,8703,1414864,1415121,17
8618,69,8703,559101,559170,21
1901,171,8703,559170,559341,29
1418,290,8703,1472233,1472523,40
6474,37,8704,559562,559599,35
3378,238,8704,1414953,1415191,37
5113,58,8704,559824,559882,41
8815,37,8704,559882,559919,46
8245,65,8704,559919,559984,49
9109,20,8705,559983,560003,12
5036,17,8705,560003,560020,35
5825,236,8705,1414956,1415192,35
4669,207,8706,560253,560460,12
2308,221,8706,560460,560681,16
1557,14,8706,560681,560695,32
6696,250,8706,1414971,1415221,46
2221,106,8707,560914,561020,17
6512,47,8707,561020,561067,18
1541,182,8707,561067,561249,21
3770,114,8707,561249,561363,22
8272,51,8707,561363,561414,29
3654,99,8707,561414,561513,31
1173,88,8707,561513,561601,38
2423,56,8707,561601,561657,39
2178,170,8708,561656,561826,12
5109,226,8708,1414994,1415220,23
2879,285,8708,1472237,1472522,24
3315,81,8708,562270,562351,31
4252,157,8708,562351,562508,46
8029,228,8708,1415063,1415291,47
1984,297,8708,1476481,1476778,48
8219,257,8709,1415124,1415381,6
5504,163,8709,563171,563334,15
3796,75,8709,563334,563409,19
7184,76,8709,563409,563485,19
5432,89,8709,563485,563574,21
7390,261,8709,1415167,1415428,22
8723,119,8709,563788,563907,25
8003,231,8709,1415204,1415435,26
9815,112,8709,564131,564243,34
8930,185,8709,564243,564428,42
4399,49,8709,564428,564477,50
5508,232,8710,1415216,1415448,9
3105,7,8710,564694,564701,13
3703,115,8710,564701,564816,17
7011,105,8710,564816,564921,31
8018,65,8710,564921,564986,34
9604,216,8710,564986,565202,36
8966,4,8710,565202,565206,50
1070,202,8711,565205,565407,18
1498,299,8712,1476110,1476409,14
3924,126,8712,565631,565757,28
5800,204,8712,565757,565961,33
3928,273,8712,1415283,1415556,40
6186,298,8714,1476430,1476728,7
2128,111,8714,566403,566514,11
1407,163,8714,566514,566677,29
2129,197,8714,566677,566874,37
8463,86,8714,566874,566960,42
6368,122,8714,566960,567082,48
4038,276,8715,1415388,1415664,7
6423,67,8715,567303,567370,23
7197,125,8715,567370,567495,26
4867,297,8715,1476112,1476409,31
4187,168,8715,567723,567891,39
5201,111,8715,567891,568002,50
2906,127,8716,568001,568128,5
3085,224,8716,568128,568352,16
2563,115,8716,568352,568467,24
6249,237,8716,1415499,1415736,33
5330,43,8716,568684,568727,43
5632,195,8717,568726,568921,5
7936,120,8717,568921,569041,13
3133,299,8717,1476111,1476410,28
1482,32,8717,569261,569293,32
3853,126,8717,569293,569419,36
7950,149,8718,569418,569567,1
8613,82,8718,569567,569649,24
6322,256,8719,1415571,1415827,37
5441,117,8720,569872,569989,11
7243,286,8720,1472296,1472582,25
7038,35,8720,570208,570243,28
3681,228,8720,1415670,1415898,28
5744,144,8720,570463,570607,41
6214,123,8721,570606,570729,24
6823,109,8721,570729,570838,26
5817,297,8721,1476425,1476722,30
6399,197,8721,571064,571261,43
6444,242,8722,1415728,1415970,10
4151,204,8722,571483,571687,14
9901,40,8722,571687,571727,41
3666,255,8722,1415747,1416002,43
5485,63,8722,571950,572013,44
5617,195,8722,572013,572208,44
2401,227,8723,1415780,1416007,4
7167,210,8723,572428,572638,19
5394,31,8723,572638,572669,26
8392,64,8724,572668,572732,10
6553,124,8725,572731,572855,2
9181,26,8725,572855,572881,4
1881,47,8725,572881,572928,6
9580,174,8725,572928,573102,6
2309,196,8725,573102,573298,8
1284,247,8725,1415777,1416024,13
2249,21,8725,573526,573547,22
7462,3,8725,573547,573550,49
6211,53,8726,573549,573602,48
4862,43,8727,573601,573644,5
2722,132,8727,573644,573776,21
4335,19,8727,573776,573795,29
3405,227,8727,1415799,1416026,39
4083,289,8727,1472308,1472597,49
1411,298,8728,1476106,1476404,1
2966,158,8728,574464,574622,21
8997,152,8728,574622,574774,35
2162,211,8729,574773,574984,44
1611,67,8730,574983,575050,9
1697,5,8730,575050,575055,12
3601,143,8730,575055,575198,15
9155,17,8730,575198,575215,16
4056,238,8730,1415915,1416153,18
6736,199,8730,575437,575636,39
1559,71,8731,575635,575706,1
4069,182,8731,575706,575888,10
1892,94,8731,575888,575982,17
1291,98,8731,575982,576080,26
4305,30,8732,576079,576109,3
5480,54,8732,576109,576163,12
8339,193,8732,576163,576356,19
3639,159,8732,576356,576515,20
8801,257,8732,1415937,1416194,22
6544,10,8732,576729,576739,45
7047,165,8732,576739,576904,49
7958,193,8732,576904,577097,50
8484,1,8733,577096,577097,3
7646,138,8733,577097,577235,8
2959,67,8733,577235,577302,12
6647,294,8733,1472324,1472618,38
3626,65,8733,577528,577593,43
1890,16,8733,577593,577609,49
4191,199,8734,577608,577807,6
4270,16,8734,577807,577823,17
7276,15,8734,577823,577838,18
2895,154,8734,577838,577992,24
2933,113,8734,577992,578105,25
6101,202,8734,578105,578307,26
1840,44,8734,578307,578351,36
4607,64,8735,578350,578414,18
5918,66,8735,578414,578480,20
3823,66,8735,578480,578546,23
5074,185,8735,578546,578731,26
2327,212,8735,578731,578943,27
5829,300,8735,1476102,1476402,27
3638,157,8735,579166,579323,50
7453,294,8736,1472349,1472643,2
1605,29,8736,579547,579576,9
1880,294,8736,1472363,1472657,13
9848,9,8736,579804,579813,20
1509,150,8736,579813,579963,29
3002,14,8736,579963,579977,39
8810,31,8736,579977,580008,46
5552,109,8737,580007,580116,24
8685,223,8737,580116,580339,36
3466,224,8737,580339,580563,37
8473,13,8737,580563,580576,41
5124,283,8738,1472374,1472657,3
7204,233,8738,1416243,1416476,10
8006,177,8738,581021,581198,11
8651,242,8738,1416252,1416494,11
1026,142,8738,581422,581564,18
1355,293,8738,1472376,1472669,30
9988,43,8738,581790,581833,31
4810,139,8738,581833,581972,36
7177,224,8739,1416330,1416554,9
9962,189,8739,582189,582378,15
9473,168,8739,582378,582546,18
4826,58,8739,582546,582604,20
5734,300,8739,1476406,1476706,33
7887,10,8739,582821,582831,34
7458,285,8739,1472400,1472685,41
8288,4,8739,583056,583060,45
4868,162,8740,583059,583221,9
8749,43,8740,583221,583264,10
1443,67,8740,583264,583331,12
3875,295,8740,1476108,1476403,16
9382,246,8740,1416503,1416749,32
4577,224,8740,1416526,1416750,43
4724,207,8740,584002,584209,50
2201,299,8741,1476107,1476406,3
1390,205,8741,584431,584636,7
5959,184,8741,584636,584820,13
1729,263,8741,1416582,1416845,37
3735,53,8741,585045,585098,46
6841,143,8742,585097,585240,11
5123,171,8742,585240,585411,22
2411,137,8742,585411,585548,24
6955,27,8743,585547,585574,1
1874,218,8743,1416626,1416844,8
7514,139,8743,585791,585930,10
5756,220,8743,585930,586150,12
3434,44,8743,586150,586194,20
1471,231,8743,1416617,1416848,20
5702,282,8743,1472431,1472713,27
6414,207,8744,586643,586850,14
5061,254,8744,1416684,1416938,24
6577,11,8744,587069,587080,25
9599,54,8744,587080,587134,26
5229,113,8744,587134,587247,29
4505,189,8744,587247,587436,34
2303,212,8744,587436,587648,46
2680,249,8744,1416715,1416964,48
8191,213,8745,587870,588083,16
8152,288,8745,1472429,1472717,17
3136,175,8745,588307,588482,26
7122,175,8745,588482,588657,36
3933,221,8745,1416801,1417022,46
4269,210,8745,588877,589087,50
8455,76,8746,589086,589162,44
2232,74,8747,589161,589235,3
5276,281,8747,1416797,1417078,12
9934,19,8747,589458,589477,33
1747,41,8747,589477,589518,44
6004,216,8748,589517,589733,30
6963,159,8748,589733,589892,37
4955,291,8748,1472435,1472726,49
5869,76,8749,590113,590189,3
2075,38,8749,590189,590227,8
2218,220,8749,1416914,1417134,25
4146,243,8749,1416911,1417154,43
3847,156,8749,590669,590825,45
2330,163,8750,590824,590987,8
8950,107,8750,590987,591094,18
3344,291,8750,1472445,1472736,26
3236,96,8750,591318,591414,28
2598,230,8750,591414,591644,35
7067,146,8750,591644,591790,44
9765,192,8750,591790,591982,50
6740,94,8751,591981,592075,1
1480,94,8751,592075,592169,8
7401,146,8751,592169,592315,13
9568,12,8752,592314,592326,34
3811,230,8752,1416981,1417211,37
6654,78,8752,592551,592629,47
1222,6,8753,592628,592634,24
4071,23,8753,592634,592657,25
5384,27,8753,592657,592684,30
8591,20,8753,592684,592704,33
4771,192,8754,592703,592895,5
2391,36,8754,592895,592931,8
6558,30,8754,592931,592961,26
5808,83,8754,592961,593044,30
4007,30,8754,593044,593074,39
2362,23,8754,593074,593097,41
3851,216,8754,593097,593313,43
7046,161,8755,593312,593473,4
7010,155,8755,593473,593628,23
4144,71,8755,593628,593699,26
4490,231,8755,1416984,1417215,34
1174,161,8755,593923,594084,46
2002,129,8755,594084,594213,50
2207,140,8756,594212,594352,4
1268,197,8756,594352,594549,34
3467,137,8756,594549,594686,38
5855,205,8756,594686,594891,50
4129,272,8757,1416989,1417261,11
1071,168,8757,595114,595282,49
7408,30,8758,595281,595311,3
5262,17,8758,595311,595328,28
9341,102,8758,595328,595430,38
7983,121,8759,595429,595550,13
4963,267,8759,1417031,1417298,13
7543,259,8759,1417075,1417334,27
1372,136,8759,596001,596137,38
9690,168,8759,596137,596305,44
3251,146,8760,596304,596450,9
2627,120,8760,596450,596570,21
2344,116,8760,596570,596686,24
4517,5,8760,596686,596691,26
1903,10,8760,596691,596701,30
3076,33,8760,596701,596734,31
5978,92,8760,596734,596826,49
6070,129,8761,596825,596954,17
8291,47,8761,596954,597001,23
8051,118,8761,597001,597119,31
7020,299,8761,1476386,1476685,31
8934,14,8761,597347,597361,38
7627,248,8761,1417165,1417413,42
2385,162,8761,597581,597743,43
2791,45,8761,597743,597788,50
7203,1,8762,597787,597788,23
3694,53,8762,597788,597841,27
3323,160,8762,597841,598001,32
7058,114,8762,598001,598115,39
6230,37,8763,598114,598151,24
7757,40,8763,598151,598191,49
6649,37,8764,598190,598227,7
7558,65,8764,598227,598292,7
7002,217,8764,598292,598509,31
9745,244,8764,1417190,1417434,46
5570,82,8764,598729,598811,48
3592,229,8765,1417210,1417439,10
8526,169,8765,599033,599202,19
9513,223,8765,599202,599425,21
6082,218,8765,599425,599643,48
7965,297,8766,1476384,1476681,8
3656,58,8766,599859,599917,14
4028,57,8766,599917,599974,22
2984,100,8766,599974,600074,25
3645,82,8766,600074,600156,33
1752,71,8766,600156,600227,42
8626,169,8767,600226,600395,5
9143,176,8767,600395,600571,14
5307,152,8767,600571,600723,18
7615,36,8767,600723,600759,21
7927,78,8767,600759,600837,24
7782,164,8767,600837,601001,32
3196,267,8767,1417273,1417540,38
4696,94,8767,601227,601321,42
2797,260,8768,1417314,1417574,1
7349,199,8768,601545,601744,43
1997,36,8769,601743,601779,8
5214,17,8769,601779,601796,11
1195,26,8769,601796,601822,21
3900,95,8769,601822,601917,28
5020,16,8769,601917,601933,29
1619,289,8769,1472462,1472751,35
5760,69,8769,602167,602236,36
8653,248,8769,1417398,1417646,41
1739,169,8770,602460,602629,32
6948,106,8770,602629,602735,39
9225,223,8771,602734,602957,1
2964,284,8771,1417419,1417703,14
1395,177,8771,603182,603359,21
1143,195,8771,603359,603554,21
8189,78,8771,603554,603632,24
4709,300,8771,1476377,1476677,34
1349,106,8771,603856,603962,36
6062,113,8771,603962,604075,48
7447,250,8771,1417538,1417788,49
2579,10,8771,604297,604307,50
7533,88,8772,604306,604394,22
5421,116,8772,604394,604510,24
5575,125,8772,604510,604635,32
1246,148,8772,604635,604783,32
8144,21,8772,604783,604804,36
2244,272,8773,1417563,1417835,3
3057,276,8773,1417620,1417896,19
9302,7,8773,605241,605248,21
2382,213,8774,605247,605460,8
1682,122,8774,605460,605582,28
2920,110,8774,605582,605692,49
1640,299,8774,1476376,1476675,50
9128,175,8775,605914,606089,14
3946,140,8775,606089,606229,31
9582,211,8775,606229,606440,42
9586,120,8776,606439,606559,4
6573,279,8776,1417724,1418003,38
6990,206,8777,606784,606990,13
3745,141,8777,606990,607131,22
4767,274,8777,1417783,1418057,24
4156,250,8777,1417834,1418084,27
3680,293,8777,1472491,1472784,27
1028,142,8777,607796,607938,41
8282,216,8778,607937,608153,9
6704,94,8778,608153,608247,28
5260,26,8778,608247,608273,29
4327,112,8778,608273,608385,46
8649,279,8778,1417916,1418195,48
6027,147,8779,608607,608754,40
6275,50,8779,608754,608804,44
2621,201,8779,608804,609005,49
1563,30,8780,609004,609034,2
9354,143,8780,609034,609177,19
1507,129,8780,609177,609306,25
4619,12,8780,609306,609318,30
1484,227,8780,1417972,1418199,32
9367,6,8781,609538,609544,15
1628,206,8781,609544,609750,16
6689,101,8781,609750,609851,29
3687,260,8781,1417970,1418230,31
7790,284,8781,1472499,1472783,31
2848,95,8782,610306,610401,19
5352,133,8782,610401,610534,19
5070,90,8782,610534,610624,25
2029,12,8782,610624,610636,32
8761,172,8782,610636,610808,42
9326,248,8783,1418056,1418304,2
7137,90,8783,611032,611122,22
5136,139,8783,611122,611261,31
6292,240,8784,1418080,1418320,12
5848,226,8784,611483,611709,13
4366,22,8784,611709,611731,29
9936,271,8784,1418086,1418357,35
7638,262,8784,1418135,1418397,40
7867,221,8784,1418177,1418398,42
9771,39,8784,612407,612446,46
3873,51,8785,612445,612496,14
8432,295,8785,1476082,1476377,19
8217,94,8785,612711,612805,20
7377,183,8785,612805,612988,43
5960,201,8786,612987,613188,6
5403,11,8786,613188,613199,15
8012,109,8786,613199,613308,17
4027,198,8786,613308,613506,21
7626,19,8786,613506,613525,22
3238,166,8786,613525,613691,26
2824,253,8786,1418233,1418486,30
3725,90,8786,613917,614007,38
9186,26,8787,614006,614032,14
8632,266,8787,1418260,1418526,14
1296,153,8787,614257,614410,18
3520,3,8787,614410,614413,37
3908,200,8788,614412,614612,13
7619,195,8789,614611,614806,28
3414,19,8789,614806,614825,36
9716,116,8789,614825,614941,47
3178,291,8789,1472512,1472803,49
4526,53,8790,615162,615215,4
4821,125,8790,615215,615340,14
7732,169,8791,615339,615508,2
6941,186,8791,615508,615694,3
8146,84,8791,615694,615778,36
6367,77,8791,615778,615855,41
7181,204,8791,615855,616059,45
4540,79,8792,616058,616137,30
4023,257,8792,1418361,1418618,33
8954,207,8792,616354,616561,34
9937,115,8792,616561,616676,36
5259,53,8793,616675,616728,1
4620,137,8793,616728,616865,2
7260,79,8793,616865,616944,13
4930,144,8793,616944,617088,23
7496,224,8793,1418395,1418619,49
2410,258,8793,1418397,1418655,49
3298,198,8794,617531,617729,15
3890,119,8794,617729,617848,22
1610,130,8795,617847,617977,23
2997,272,8795,1418431,1418703,40
4368,159,8796,618198,618357,18
8227,71,8796,618357,618428,20
8450,203,8796,618428,618631,23
1341,285,8796,1472518,1472803,33
1081,80,8796,618848,618928,37
7279,270,8796,1418541,1418811,40
8844,246,8796,1418587,1418833,45
3129,130,8796,619374,619504,47
2396,159,8797,619503,619662,17
1160,104,8797,619662,619766,23
5064,134,8797,619766,619900,37
9170,54,8798,619899,619953,1
3259,230,8798,1418611,1418841,15
9694,170,8798,620173,620343,16
1396,36,8798,620343,620379,21
3989,40,8798,620379,620419,46
3907,29,8799,620418,620447,3
4013,249,8799,1418618,1418867,5
2324,95,8799,620669,620764,17
9790,185,8799,620764,620949,17
4412,182,8799,620949,621131,34
9637,171,8799,621131,621302,38
5761,212,8800,621301,621513,20
8303,136,8801,621512,621648,6
8547,51,8801,621648,621699,14
6699,106,8801,621699,621805,48
9131,271,8802,1418641,1418912,12
9732,33,8802,622027,622060,26
9086,275,8802,1418688,1418963,26
7406,297,8802,1476351,1476648,30
7604,25,8802,622510,622535,34
6175,57,8802,622535,622592,37
7977,171,8802,622592,622763,42
8552,136,8802,622763,622899,43
6516,17,8803,622898,622915,28
7343,70,8803,622915,622985,35
3156,267,8804,1418793,1419060,10
6557,3,8804,623207,623210,14
2729,41,8804,623210,623251,19
5069,24,8804,623251,623275,29
1510,208,8804,623275,623483,44
6401,226,8805,1418836,1419062,3
1613,199,8805,623705,623904,8
9995,168,8805,623904,624072,10
4485,48,8805,624072,624120,30
4904,98,8805,624120,624218,45
2804,6,8805,624218,624224,48
8107,40,8806,624223,624263,5
9298,79,8806,624263,624342,7
6329,237,8806,1418844,1419081,33
9223,178,8806,624559,624737,49
6785,36,8807,624736,624772,6
5370,73,8807,624772,624845,7
9271,208,8807,624845,625053,18
8355,276,8807,1418858,1419134,18
4939,281,8807,1418910,1419191,21
2828,199,8807,625499,625698,27
6682,116,8807,625698,625814,34
3413,137,8807,625814,625951,35
6518,169,8807,625951,626120,42
7672,151,8808,626119,626270,4
5424,166,8808,626270,626436,7
6039,209,8808,626436,626645,11
9171,147,8808,626645,626792,19
4881,231,8808,1418971,1419202,25
4058,251,8808,1418983,1419234,29
9281,276,8808,1419008,1419284,30
7854,6,8808,627456,627462,37
1912,161,8808,627462,627623,44
6730,37,8808,627623,627660,47
8160,197,8809,627659,627856,16
3368,35,8809,627856,627891,18
4839,138,8809,627891,628029,36
6253,179,8809,628029,628208,36
8022,37,8810,628207,628244,5
8372,121,8810,628244,628365,7
1972,3,8810,628365,628368,9
4184,78,8810,628368,628446,11
2958,189,8810,628446,628635,14
5610,185,8810,628635,628820,22
2528,208,8810,628820,629028,25
4153,241,8810,1419058,1419299,26
1582,107,8810,629252,629359,31
1928,36,8810,629359,629395,33
9435,195,8810,629395,629590,34
1436,46,8810,629590,629636,42
5655,227,8810,1419077,1419304,49
7483,119,8811,629857,629976,2
3100,218,8811,629976,630194,11
5363,256,8811,1419079,1419335,17
6197,68,8811,630418,630486,26
9424,230,8811,1419114,1419344,32
9652,198,8811,630707,630905,37
9244,104,8811,630905,631009,43
8780,35,8812,631008,631043,6
2857,47,8812,631043,631090,14
9432,199,8812,631090,631289,23
5771,291,8812,1472518,1472809,24
3718,286,8812,1472531,1472817,32
9303,93,8813,631728,631821,40
9325,291,8813,1472536,1472827,40
5921,75,8813,632043,632118,41
4516,263,8814,1419294,1419557,11
2969,109,8814,632341,632450,12
6400,247,8814,1419331,1419578,38
1379,46,8815,632675,632721,2
8978,243,8815,1419353,1419596,26
7767,133,8815,632945,633078,27
3000,31,8815,633078,633109,32
4172,130,8815,633109,633239,35
3338,229,8815,1419370,1419599,38
6680,28,8816,633464,633492,5
4227,241,8816,1419378,1419619,15
1212,69,8816,633712,633781,19
5593,138,8816,633781,633919,24
8969,98,8816,633919,634017,34
8464,135,8817,634016,634151,24
8753,146,8817,634151,634297,39
1819,249,8818,1419402,1419651,19
6993,217,8818,634511,634728,20
9916,129,8818,634728,634857,30
8161,242,8818,1419434,1419676,33
8999,183,8818,635074,635257,37
6688,125,8818,635257,635382,48
1256,115,8819,635381,635496,13
6965,294,8819,1472538,1472832,39
8067,127,8819,635719,635846,42
1593,183,8820,635845,636028,3
8937,95,8820,636028,636123,8
1330,84,8820,636123,636207,15
1940,222,8820,1419515,1419737,24
6178,41,8820,636426,636467,25
8082,292,8820,1472550,1472842,45
1652,290,8821,1472563,1472853,16
8882,165,8821,636917,637082,18
5807,63,8821,637082,637145,29
8641,25,8821,637145,637170,32
8993,180,8821,637170,637350,35
7670,101,8821,637350,637451,48
9557,183,8822,637450,637633,26
1011,161,8822,637633,637794,39
2132,41,8822,637794,637835,45
3384,98,8822,637835,637933,45
9998,25,8822,637933,637958,46
6015,256,8822,1419624,1419880,47
6604,81,8823,638176,638257,8
2239,260,8823,1419656,1419916,39
2115,34,8823,638480,638514,45
1732,12,8823,638514,638526,49
5782,75,8824,638525,638600,7
4499,39,8824,638600,638639,18
5974,252,8824,1419694,1419946,32
7601,35,8824,638860,638895,36
1007,292,8824,1472570,1472862,40
4700,250,8824,1419781,1420031,50
1885,271,8824,1419808,1420079,50
7621,252,8825,1419853,1420105,2
4529,8,8825,639787,639795,3
7512,22,8825,639795,639817,13
8046,183,8825,639817,640000,23
3940,208,8825,640000,640208,33
5556,185,8825,640208,640393,39
8903,245,8826,1419881,1420126,3
2825,129,8826,640615,640744,10
4408,75,8826,640744,640819,17
3449,40,8826,640819,640859,26
3891,139,8826,640859,640998,32
2203,16,8826,640998,641014,33
6833,208,8826,641014,641222,41
8715,143,8827,641221,641364,18
1688,76,8827,641364,641440,28
4449,182,8827,641440,641622,44
5488,220,8828,641621,641841,15
4539,269,8829,1419901,1420170,7
9417,38,8829,642062,642100,10
9537,229,8829,1419951,1420180,24
6878,159,8829,642319,642478,33
2581,96,8829,642478,642574,36
7967,281,8830,1472578,1472859,11
8280,169,8830,642797,642966,25
2610,102,8830,642966,643068,26
6555,294,8830,1472581,1472875,32
9145,13,8830,643289,643302,39
8262,294,8831,1472595,1472889,6
7882,276,8831,1420119,1420395,16
6853,249,8831,1420168,1420417,20
5546,22,8831,643977,643999,22
2434,6,8831,643999,644005,25
5356,154,8831,644005,644159,38
4684,215,8831,644159,644374,46
5564,245,8832,1420201,1420446,19
6721,295,8832,1472608,1472903,37
7644,56,8832,644813,644869,39
7554,176,8832,644869,645045,40
2608,106,8833,645044,645150,8
2771,277,8833,1420273,1420550,16
2299,281,8834,1420324,1420605,2
3700,134,8834,645601,645735,7
1326,240,8834,1420381,1420621,26
7473,141,8834,645959,646100,29
2921,246,8834,1420395,1420641,38
4582,199,8834,646326,646525,40
4290,5,8834,646525,646530,41
1137,260,8834,1420418,1420678,48
9630,26,8835,646752,646778,8
5707,252,8835,1420458,1420710,25
7892,92,8835,646997,647089,28
3534,19,8835,647089,647108,37
9538,242,8835,1420486,1420728,45
2241,104,8836,647331,647435,10
6303,50,8836,647435,647485,13
4458,280,8836,1420500,1420780,20
5176,189,8836,647712,647901,50
4537,238,8837,1420557,1420795,7
6357,243,8837,1420580,1420823,19
6717,32,8837,648337,648369,39
4229,147,8837,648369,648516,46
7132,192,8838,648515,648707,16
3199,187,8838,648707,648894,17
7070,112,8838,648894,649006,25
9668,293,8838,1472614,1472907,25
1944,178,8838,649225,649403,29
3311,95,8838,649403,649498,30
3215,32,8838,649498,649530,34
8928,111,8838,649530,649641,38
6157,100,8838,649641,649741,40
4031,236,8838,1420663,1420899,43
4887,121,8838,649964,650085,49
9647,82,8839,650084,650166,2
9956,23,8839,650166,650189,20
1475,106,8839,650189,650295,34
6421,296,8839,1476316,1476612,40
7998,24,8839,650517,650541,44
5190,141,8840,650540,650681,23
5777,225,8841,1420733,1420958,4
7921,234,8841,1420734,1420968,21
5390,179,8841,651125,651304,44
2471,245,8842,1420743,1420988,11
7296,126,8842,651527,651653,33
6180,137,8842,651653,651790,48
3261,92,8843,651789,651881,1
8837,32,8843,651881,651913,10
7277,128,8843,651913,652041,12
3723,211,8843,652041,652252,14
7495,2,8844,652251,652253,8
6634,216,8844,1420772,1420988,22
3160,232,8844,1420764,1420996,26
5531,55,8844,652691,652746,27
9119,163,8844,652746,652909,41
7092,278,8844,1420771,1421049,41
6276,168,8845,653133,653301,2
7072,106,8845,653301,653407,5
7361,275,8845,1420826,1421101,7
2077,231,8845,1420886,1421117,19
6769,137,8845,653844,653981,37
4912,182,8845,653981,654163,44
1777,166,8845,654163,654329,45
5090,289,8846,1472628,1472917,35
7378,243,8846,1420936,1421179,36
8204,220,8846,1420960,1421180,47
5018,298,8847,1476025,1476323,12
1237,171,8847,655233,655404,16
7826,136,8847,655404,655540,23
9679,120,8847,655540,655660,28
8296,263,8847,1421012,1421275,30
2907,246,8847,1421047,1421293,31
6621,293,8847,1472648,1472941,31
8920,80,8848,656341,656421,11
4113,12,8848,656421,656433,14
7069,212,8848,656433,656645,22
1105,56,8848,656645,656701,32
8047,9,8848,656701,656710,38
4947,202,8848,656710,656912,42
9945,100,8849,656911,657011,27
8757,34,8849,657011,657045,30
8053,192,8849,657045,657237,36
5616,233,8850,1421118,1421351,2
4784,145,8850,657461,657606,9
9856,40,8850,657606,657646,14
8125,235,8850,1421127,1421362,17
7358,11,8851,657869,657880,10
4783,217,8851,657880,658097,11
8002,288,8851,1472653,1472941,41
5536,200,8852,658321,658521,20
4139,59,8852,658521,658580,26
1217,78,8852,658580,658658,27
3161,28,8852,658658,658686,33
3972,222,8852,658686,658908,37
3525,157,8853,658907,659064,1
8496,46,8853,659064,659110,49
4043,11,8854,659109,659120,13
7196,300,8854,1476298,1476598,29
5369,275,8854,1421255,1421530,34
9768,297,8854,1476023,1476320,37
6309,206,8854,659788,659994,42
1600,15,8854,659994,660009,44
2900,296,8854,1476303,1476599,48
2010,27,8855,660231,660258,5
9808,53,8855,660258,660311,10
2310,164,8855,660311,660475,14
1623,50,8855,660475,660525,28
9955,120,8855,660525,660645,34
2916,47,8856,660644,660691,23
5794,76,8856,660691,660767,39
2472,102,8857,660766,660868,2
2779,286,8857,1472696,1472982,21
6288,53,8857,661092,661145,39
9292,66,8857,661145,661211,47
4118,168,8857,661211,661379,48
6278,218,8857,661379,661597,48
2489,243,8858,1421471,1421714,1
2957,31,8858,661821,661852,7
8246,234,8858,1421492,1421726,18
5094,112,8858,662074,662186,20
2844,64,8858,662186,662250,26
1091,41,8858,662250,662291,29
6735,232,8859,1421504,1421736,4
3792,285,8859,1472696,1472981,14
6754,188,8859,662736,662924,16
8794,77,8859,662924,663001,23
7460,132,8859,663001,663133,28
5446,81,8859,663133,663214,49
6567,163,8860,663213,663376,5
8233,299,8860,1476021,1476320,43
1617,50,8861,663598,663648,6
5277,278,8861,1421625,1421903,20
3051,29,8861,663875,663904,27
8094,86,8861,663904,663990,44
8185,260,8862,1421677,1421937,1
6263,54,8862,664214,664268,2
1532,167,8862,664268,664435,34
7975,266,8863,1421714,1421980,6
9369,58,8863,664656,664714,7
3642,11,8863,664714,664725,13
3668,203,8863,664725,664928,37
7555,150,8863,664928,665078,46
7076,13,8864,665077,665090,2
2289,239,8864,1421762,1422001,8
4739,270,8864,1421776,1422046,14
9315,79,8864,665532,665611,17
8439,203,8864,665611,665814,30
7200,53,8864,665814,665867,40
7969,100,8865,665866,665966,3
6189,291,8865,1472707,1472998,17
9461,186,8865,666190,666376,22
7073,78,8865,666376,666454,39
7591,18,8865,666454,666472,49
8576,109,8866,666471,666580,17
2194,71,8866,666580,666651,35
1809,10,8867,666650,666660,3
5046,177,8867,666660,666837,7
3173,166,8867,666837,667003,17
2302,245,8867,1421879,1422124,18
4325,100,8867,667225,667325,28
1263,23,8867,667325,667348,29
2690,211,8868,667347,667558,5
1351,7,8868,667558,667565,14
6962,78,8868,667565,667643,20
2293,196,8868,667643,667839,23
3976,55,8868,667839,667894,25
5003,288,8869,1472712,1473000,1
8110,219,8869,668118,668337,21
2789,256,8869,1421960,1422216,25
7485,179,8869,668556,668735,48
6415,46,8870,668734,668780,7
9146,49,8870,668780,668829,13
4307,193,8870,668829,669022,15
5016,52,8870,669022,669074,30
4020,90,8870,669074,669164,35
3551,47,8871,669163,669210,12
6982,153,8871,669210,669363,12
8751,258,8871,1421992,1422250,18
5050,54,8871,669585,669639,19
1152,42,8871,669639,669681,32
4466,97,8871,669681,669778,39
9402,105,8872,669777,669882,4
7538,37,8873,669881,669918,25
5608,204,8873,669918,670122,30
7179,268,8874,1422025,1422293,5
5434,243,8874,1422070,1422313,10
1336,199,8874,670566,670765,36
3064,190,8874,670765,670955,40
1333,11,8874,670955,670966,43
6370,122,8875,670965,671087,5
6257,81,8876,671086,671167,1
2085,41,8876,671167,671208,12
8873,91,8876,671208,671299,17
4072,29,8876,671299,671328,34
7108,160,8876,671328,671488,38
9796,144,8876,671488,671632,44
3472,2,8877,671631,671633,2
5843,107,8877,671633,671740,41
1691,10,8877,671740,671750,46
4216,112,8877,671750,671862,50
3526,288,8878,1472710,1472998,5
7632,32,8878,672083,672115,15
5548,125,8878,672115,672240,19
2458,4,8878,672240,672244,26
3901,32,8878,672244,672276,31
7189,246,8878,1422144,1422390,34
2214,273,8878,1422167,1422440,39
9717,274,8878,1422215,1422489,41
9942,200,8879,672947,673147,1
8394,153,8879,673147,673300,5
2151,34,8879,673300,673334,16
4546,4,8879,673334,673338,34
9482,220,8879,673338,673558,48
3509,96,8879,673558,673654,49
8787,191,8880,673653,673844,11
9240,147,8880,673844,673991,16
8145,234,8880,1422260,1422494,16
5530,283,8880,1422260,1422543,35
1634,202,8881,674451,674653,2
4263,23,8881,674653,674676,12
5866,148,8881,674676,674824,17
1192,288,8881,1472715,1473003,18
9100,182,8881,675046,675228,25
5463,132,8881,675228,675360,31
7118,95,8881,675360,675455,41
7883,252,8881,1422377,1422629,48
9130,224,8882,1422408,1422632,15
2796,14,8882,675897,675911,24
2133,37,8882,675911,675948,46
2508,126,8882,675948,676074,47
2831,125,8883,676073,676198,5
1369,189,8883,676198,676387,8
3113,81,8883,676387,676468,15
9781,265,8883,1422416,1422681,19
9882,247,8883,1422457,1422704,21
3885,207,8883,676907,677114,29
8952,243,8883,1422481,1422724,50
5719,43,8884,677336,677379,9
2533,87,8884,677379,677466,20
5615,244,8884,1422501,1422745,40
2948,256,8884,1422525,1422781,42
8550,97,8884,677908,678005,43
2317,283,8885,1472719,1473002,18
5122,28,8885,678226,678254,20
2682,276,8885,1422618,1422894,28
3732,87,8886,678473,678560,1
3514,214,8886,678560,678774,18
6679,28,8886,678774,678802,33
4760,46,8886,678802,678848,43
2466,53,8887,678847,678900,22
4000,38,8887,678900,678938,24
5231,177,8887,678938,679115,28
7440,19,8887,679115,679134,31
2495,30,8887,679134,679164,34
1983,273,8887,1422669,1422942,39
6480,31,8887,679387,679418,42
7610,175,8887,679418,679593,43
5845,4,8887,679593,679597,46
1925,166,8888,679596,679762,1
4996,102,8888,679762,679864,20
6799,220,8888,679864,680084,20
4009,79,8888,680084,680163,34
5402,271,8888,1422718,1422989,39
2224,33,8888,680386,680419,45
2048,41,8889,680418,680459,4
7312,103,8889,680459,680562,16
9037,154,8889,680562,680716,25
6475,187,8890,680715,680902,29
5973,245,8891,1422758,1423003,13
7761,246,8891,1422784,1423030,24
5047,189,8891,681348,681537,40
8461,95,8891,681537,681632,50
5273,273,8892,1422801,1423074,31
4397,136,8892,681859,681995,36
3518,2,8892,681995,681997,38
4640,182,8893,681996,682178,12
5177,207,8893,682178,682385,15
1960,91,8893,682385,682476,42
6316,60,8894,682475,682535,22
2839,244,8894,1422858,1423102,22
6980,261,8894,1422888,1423149,22
9755,200,8894,682963,683163,23
7806,140,8895,683162,683302,2
3921,209,8895,683302,683511,4
1754,21,8895,683511,683532,23
1907,126,8895,683532,683658,37
8551,297,8896,1475988,1476285,6
1392,287,8896,1472730,1473017,16
3967,274,8896,1423036,1423310,25
5139,4,8896,684325,684329,48
4636,285,8896,1472738,1473023,49
7997,18,8896,684551,684569,50
4555,286,8896,1472743,1473029,50
4387,165,8897,684791,684956,21
6875,161,8897,684956,685117,36
9142,243,8897,1423204,1423447,47
9642,161,8898,685335,685496,2
2112,252,8898,1423221,1423473,2
9006,59,8898,685721,685780,30
3246,241,8898,1423250,1423491,43
9156,155,8899,686002,686157,4
5876,129,8899,686157,686286,9
1075,88,8899,686286,686374,11
9136,300,8899,1476255,1476555,12
8682,28,8899,686597,686625,16
9845,79,8899,686625,686704,22
1327,286,8899,1472758,1473044,24
9514,43,8899,686923,686966,33
8026,187,8899,686966,687153,38
3647,87,8899,687153,687240,39
2154,129,8900,687239,687368,39
2301,104,8900,687368,687472,47
2450,283,8901,1472761,1473044,5
8356,281,8901,1423443,1423724,41
5528,131,8901,687918,688049,43
3919,103,8901,688049,688152,48
2955,208,8901,688152,688360,50
8594,30,8902,688359,688389,13
1712,108,8902,688389,688497,19
7240,6,8902,688497,688503,20
5042,47,8902,688503,688550,21
3716,186,8902,688550,688736,24
8369,20,8902,688736,688756,25
7842,292,8902,1472760,1473052,28
5005,87,8902,688976,689063,32
1350,259,8902,1423567,1423826,47
4804,16,8903,689281,689297,13
1591,125,8903,689297,689422,17
6802,25,8903,689422,689447,20
2790,22,8903,689447,689469,22
8028,124,8904,689468,689592,5
9180,259,8904,1423601,1423860,12
9747,297,8904,1475986,1476283,24
5360,96,8904,690034,690130,43
9501,257,8905,1423699,1423956,6
6971,213,8905,690351,690564,8
2247,283,8905,1472781,1473064,12
6766,14,8905,690787,690801,13
6881,42,8905,690801,690843,18
1452,37,8905,690843,690880,34
6686,18,8905,690880,690898,39
6811,88,8906,690897,690985,5
2122,126,8906,690985,691111,22
7141,123,8906,691111,691234,32
3624,265,8906,1423780,1424045,35
3488,242,8906,1423815,1424057,36
9853,173,8906,691698,691871,43
9233,254,8906,1423835,1424089,44
9413,231,8906,1423867,1424098,49
3493,186,8906,692315,692501,50
5738,209,8907,692500,692709,12
7578,253,8907,1423878,1424131,24
9971,48,8907,692928,692976,39
9052,1,8908,692975,692976,1
1927,122,8908,692976,693098,10
2562,228,8908,1423906,1424134,11
3458,127,8908,693322,693449,23
3287,39,8908,693449,693488,34
3198,138,8908,693488,693626,45
6701,156,8908,693626,693782,46
4670,219,8909,1423915,1424134,9
2716,79,8909,693999,694078,22
4552,291,8909,1472778,1473069,43
1346,169,8909,694301,694470,48
6585,201,8910,694469,694670,2
2390,213,8910,694670,694883,16
1251,184,8910,694883,695067,17
6384,18,8910,695067,695085,23
3273,72,8910,695085,695157,24
8741,179,8910,695157,695336,29
3793,91,8910,695336,695427,35
3829,212,8910,695427,695639,45
8660,113,8911,695638,695751,1
8546,222,8911,695751,695973,14
9964,5,8911,695973,695978,15
7491,124,8911,695978,696102,48
5387,244,8912,1423967,1424211,12
1704,183,8912,696324,696507,31
4390,232,8913,1423990,1424222,15
9994,180,8913,696726,696906,35
5265,202,8913,696906,697108,36
2053,31,8914,697107,697138,11
9495,117,8914,697138,697255,19
4203,285,8914,1472781,1473066,20
4527,65,8915,697481,697546,3
1525,165,8915,697546,697711,6
6074,39,8915,697711,697750,13
4086,18,8915,697750,697768,17
4034,216,8915,697768,697984,26
8154,126,8915,697984,698110,41
4275,30,8915,698110,698140,43
4718,220,8915,698140,698360,49
1938,97,8916,698359,698456,6
8758,143,8916,698456,698599,9
9515,215,8916,698599,698814,14
6272,52,8916,698814,698866,17
5775,108,8916,698866,698974,25
6842,155,8916,698974,699129,40
3902,127,8916,699129,699256,42
8775,218,8916,699256,699474,43
9380,109,8916,699474,699583,46
8114,83,8916,699583,699666,48
9970,249,8916,1424052,1424301,50
1948,203,8917,699888,700091,18
8383,296,8917,1476243,1476539,22
4487,92,8917,700305,700397,27
3139,87,8917,700397,700484,33
3984,246,8917,1424136,1424382,34
3764,205,8917,700708,700913,45
4807,195,8918,700912,701107,1
5210,14,8918,701107,701121,11
1540,156,8918,701121,701277,21
6119,1,8918,701277,701278,23
1493,82,8918,701278,701360,37
3838,39,8919,701359,701398,21
8260,27,8919,701398,701425,31
3664,108,8919,701425,701533,43
6113,163,8919,701533,701696,48
8382,34,8920,701695,701729,6
7624,248,8920,1424157,1424405,6
1260,239,8920,1424186,1424425,25
9556,284,8920,1472793,1473077,25
9412,252,8920,1424263,1424515,30
5906,21,8920,702615,702636,40
5295,45,8920,702636,702681,40
1936,55,8921,702680,702735,6
3044,44,8921,702735,702779,15
3693,217,8921,702779,702996,20
4975,64,8921,702996,703060,32
2676,101,8921,703060,703161,41
1555,93,8921,703161,703254,48
4498,242,8921,1424291,1424533,48
8689,195,8922,703476,703671,19
3422,44,8922,703671,703715,33
7970,284,8923,1472793,1473077,5
5970,192,8923,703936,704128,19
2568,47,8923,704128,704175,25
8945,257,8923,1424370,1424627,42
3278,113,8923,704395,704508,49
4074,79,8924,704507,704586,5
3521,51,8924,704586,704637,30
6163,85,8924,704637,704722,41
9938,194,8925,704721,704915,5
8459,264,8925,1424403,1424667,6
9648,128,8925,705137,705265,13
5930,167,8925,705265,705432,22
8691,162,8925,705432,705594,25
5910,257,8925,1424447,1424704,28
1633,184,8925,705814,705998,30
7230,239,8925,1424481,1424720,39
9992,23,8925,706221,706244,46
9593,221,8925,1424501,1424722,47
4766,220,8926,706462,706682,4
2577,111,8926,706682,706793,41
7779,31,8926,706793,706824,42
4204,44,8927,706823,706867,10
6080,89,8927,706867,706956,43
3945,34,8928,706955,706989,10
7168,15,8928,706989,707004,21
6209,62,8928,707004,707066,38
9427,55,8929,707065,707120,4
1353,254,8929,1424495,1424749,10
2381,279,8929,1424522,1424801,20
4623,8,8929,707570,707578,22
8940,84,8929,707578,707662,40
6632,198,8929,707662,707860,40
9541,77,8930,707859,707936,3
5054,269,8930,1424578,1424847,5
1999,57,8930,708158,708215,48
3138,288,8931,1472788,1473076,5
7314,193,8931,708436,708629,49
6342,298,8932,1476227,1476525,5
4242,221,8932,1424745,1424966,9
7576,218,8932,709068,709286,15
4438,228,8932,1424746,1424974,15
6102,253,8932,1424747,1425000,20
2049,9,8932,709733,709742,22
9334,233,8932,1424777,1425010,39
5379,88,8932,709965,710053,45
9846,79,8933,710052,710131,7
8582,253,8933,1424785,1425038,21
2805,181,8933,710355,710536,23
2004,228,8933,1424812,1425040,30
7770,150,8934,710761,710911,9
2258,139,8934,710911,711050,22
9251,216,8934,711050,711266,35
1047,258,8935,1424810,1425068,13
5216,135,8935,711493,711628,22
7497,8,8935,711628,711636,34
1206,158,8936,711635,711793,9
2812,2,8936,711793,711795,14
9134,277,8936,1424833,1425110,35
8840,235,8936,1424890,1425125,42
7995,164,8936,712249,712413,47
1965,266,8936,1424906,1425172,47
5886,112,8937,712631,712743,9
1202,222,8937,712743,712965,14
1504,25,8937,712965,712990,40
4840,173,8937,712990,713163,47
5057,172,8937,713163,713335,50
3248,114,8938,713334,713448,22
4506,76,8938,713448,713524,23
6051,130,8938,713524,713654,24
7183,36,8940,713652,713688,14
4079,208,8940,713688,713896,30
8752,89,8940,713896,713985,39
4795,279,8940,1424946,1425225,44
6428,175,8941,714206,714381,11
6611,139,8941,714381,714520,12
1900,283,8941,1472797,1473080,29
9736,29,8941,714739,714768,37
4054,214,8941,714768,714982,48
9014,196,8942,714981,715177,2
3095,149,8942,715177,715326,11
9210,32,8942,715326,715358,42
2915,104,8942,715358,715462,46
7766,284,8942,1472800,1473084,49
8086,15,8943,715683,715698,4
4337,243,8943,1425117,1425360,11
2646,274,8943,1425137,1425411,43
6107,52,8943,716145,716197,44
2140,127,8943,716197,716324,45
3024,222,8943,716324,716546,45
6515,132,8943,716546,716678,46
7598,247,8943,1425191,1425438,46
8814,196,8943,716898,717094,48
5271,250,8944,1425220,1425470,8
1151,297,8944,1475955,1476252,31
7808,283,8944,1425289,1425572,35
9783,168,8944,717772,717940,38
4400,17,8944,717940,717957,41
1596,130,8944,717957,718087,42
5666,240,8944,1425349,1425589,48
7878,280,8944,1425366,1425646,50
5625,54,8945,718532,718586,12
5758,198,8945,718586,718784,14
1404,200,8945,718784,718984,20
5249,222,8945,1425426,1425648,25
8842,121,8946,719202,719323,1
5258,259,8946,1425424,1425683,10
6427,133,8946,719546,719679,14
6171,247,8946,1425458,1425705,37
6514,3,8946,719904,719907,45
6742,198,8947,719906,720104,11
3150,295,8947,1472818,1473113,42
4372,48,8948,720323,720371,5
2572,137,8948,720371,720508,8
6142,263,8948,1425539,1425802,28
7162,294,8949,1475954,1476248,8
6872,59,8949,720944,721003,9
7055,17,8949,721003,721020,25
8134,89,8949,721020,721109,31
4977,231,8949,1425646,1425877,33
6513,246,8949,1425653,1425899,45
8387,249,8950,1425673,1425922,1
2512,242,8950,1425701,1425943,4
1215,40,8950,721995,722035,8
4962,96,8950,722035,722131,20
7985,249,8950,1425718,1425967,41
4979,163,8950,722356,722519,49
3676,287,8951,1472847,1473134,9
5582,66,8951,722736,722802,17
6135,143,8951,722802,722945,17
4360,293,8951,1472853,1473146,30
1646,263,8951,1425859,1426122,46
3966,99,8952,723390,723489,1
8348,33,8952,723489,723522,22
4782,285,8952,1472861,1473146,41
9304,109,8953,723746,723855,5
1500,240,8953,1425956,1426196,12
7722,72,8953,724078,724150,28
3557,63,8953,724150,724213,30
6935,164,8953,724213,724377,33
4240,223,8953,724377,724600,35
7971,118,8953,724600,724718,39
5549,102,8953,724718,724820,47
6106,46,8954,724819,724865,2
2269,214,8954,724865,725079,11
9761,230,8954,1425968,1426198,16
6882,238,8954,1425970,1426208,31
6181,14,8954,725534,725548,42
1782,32,8954,725548,725580,45
2146,249,8954,1425984,1426233,45
5365,121,8955,725803,725924,1
4391,140,8955,725924,726064,9
2865,89,8955,726064,726153,20
7394,29,8955,726153,726182,22
3495,51,8955,726182,726233,22
4095,51,8955,726233,726284,27
6314,256,8955,1426011,1426267,32
3712,24,8955,726505,726529,43
1956,32,8956,726528,726560,10
3737,72,8956,726560,726632,18
5785,50,8957,726631,726681,1
8004,157,8957,726681,726838,5
3430,172,8957,726838,727010,16
7053,191,8957,727010,727201,30
6375,242,8957,1426031,1426273,35
7354,116,8958,727434,727550,12
6133,254,8958,1426047,1426301,14
4737,208,8958,727775,727983,37
3115,149,8958,727983,728132,46
2665,41,8958,728132,728173,50
1187,205,8959,728172,728377,2
2662,131,8959,728377,728508,5
1039,112,8959,728508,728620,37
8624,296,8959,1475944,1476240,38
6832,113,8959,728846,728959,50
1015,185,8960,728958,729143,37
3749,46,8960,729143,729189,44
8033,85,8961,729188,729273,4
9752,91,8961,729273,729364,30
3561,134,8961,729364,729498,50
9124,90,8962,729497,729587,45
2961,255,8963,1426129,1426384,7
1811,253,8963,1426161,1426414,12
3794,21,8963,730031,730052,19
4675,251,8963,1426195,1426446,24
5021,19,8963,730271,730290,26
8968,256,8963,1426220,1426476,30
1074,100,8963,730516,730616,42
1388,158,8964,730615,730773,11
5711,240,8964,1426250,1426490,14
2062,160,8964,730998,731158,25
3036,174,8964,731158,731332,34
7057,1,8964,731332,731333,46
3357,229,8964,1426268,1426497,49
3929,151,8965,731554,731705,1
8406,47,8965,731705,731752,6
5511,48,8965,731752,731800,12
4972,231,8965,1426271,1426502,23
8298,135,8965,732025,732160,29
2602,55,8965,732160,732215,33
5255,32,8965,732215,732247,46
4373,78,8966,732246,732324,3
2821,92,8966,732324,732416,3
4971,70,8966,732416,732486,15
2150,274,8966,1426277,1426551,21
1371,204,8966,732710,732914,28
7239,223,8966,1426331,1426554,46
1490,166,8967,733133,733299,50
2467,34,8968,733298,733332,3
7827,15,8968,733332,733347,16
4614,179,8968,733347,733526,37
6792,66,8969,733525,733591,10
2913,161,8969,733591,733752,11
1282,156,8969,733752,733908,18
9168,30,8970,733907,733937,7
4751,47,8970,733937,733984,16
5395,28,8970,733984,734012,22
3895,2,8970,734012,734014,39
5234,3,8970,734014,734017,43
4140,144,8970,734017,734161,47
1857,218,8971,734160,734378,7
9806,154,8971,734378,734532,17
3596,174,8971,734532,734706,22
5917,76,8971,734706,734782,32
1305,218,8971,734782,735000,38
6057,192,8971,735000,735192,46
4456,223,8971,1426330,1426553,47
1530,160,8972,735410,735570,15
4604,243,8972,1426328,1426571,21
6453,203,8972,735794,735997,34
4318,250,8972,1426341,1426591,36
7344,18,8972,736227,736245,47
2005,39,8973,736244,736283,8
3016,288,8973,1472859,1473147,8
9023,65,8973,736500,736565,11
4776,34,8973,736565,736599,13
2626,65,8973,736599,736664,42
1855,152,8973,736664,736816,50
4453,295,8974,1472865,1473160,3
2093,174,8974,737038,737212,5
1821,80,8974,737212,737292,23
7506,295,8974,1472879,1473174,24
9165,280,8974,1426547,1426827,45
6242,150,8975,737734,737884,17
8203,244,8975,1426602,1426846,21
7564,48,8975,738108,738156,24
4050,128,8975,738156,738284,28
2013,11,8975,738284,738295,31
6176,214,8975,738295,738509,31
4417,210,8975,738509,738719,46
5574,231,8975,1426624,1426855,49
5667,149,8975,738941,739090,50
1572,39,8976,739089,739128,24
4036,157,8976,739128,739285,30
2849,235,8976,1426632,1426867,40
8327,171,8976,739507,739678,46
2521,113,8976,739678,739791,48
6900,157,8977,739790,739947,2
6035,68,8977,739947,740015,8
5091,283,8977,1472894,1473177,10
3689,277,8977,1426695,1426972,23
3825,292,8977,1472896,1473188,45
6036,55,8978,740686,740741,6
7045,289,8978,1472906,1473195,45
7508,288,8979,1472912,1473200,12
2943,125,8979,741187,741312,25
6765,119,8979,741312,741431,29
9471,166,8979,741431,741597,40
3239,123,8980,741596,741719,6
1934,121,8980,741719,741840,40
3787,61,8980,741840,741901,49
5196,85,8980,741901,741986,49
2139,232,8981,1426919,1427151,6
3376,165,8981,742207,742372,14
4427,247,8981,1426929,1427176,18
2981,93,8981,742594,742687,23
8606,283,8981,1472920,1473203,33
6768,203,8981,742904,743107,49
3930,90,8982,743106,743196,13
4486,183,8982,743196,743379,18
8845,161,8982,743379,743540,23
7025,282,8982,1427013,1427295,43
9076,96,8983,743762,743858,11
9253,132,8983,743858,743990,22
8005,197,8983,743990,744187,37
1391,125,8983,744187,744312,45
2734,155,8984,744311,744466,11
3677,277,8984,1427066,1427343,16
5013,177,8984,744693,744870,18
2248,211,8984,744870,745081,25
9056,27,8984,745081,745108,30
1386,151,8984,745108,745259,39
3789,299,8985,1475919,1476218,12
2518,1,8985,745481,745482,28
8876,269,8986,1427177,1427446,10
8633,234,8986,1427223,1427457,43
8069,70,8987,745926,745996,17
2380,37,8987,745996,746033,36
5673,170,8987,746033,746203,43
3101,131,8988,746202,746333,1
3077,116,8988,746333,746449,2
6897,180,8988,746449,746629,5
2231,20,8988,746629,746649,11
8471,285,8988,1472929,1473214,13
2856,299,8988,1475918,1476217,29
8944,80,8988,747096,747176,43
4138,7,8988,747176,747183,46
2480,205,8988,747183,747388,48
6659,276,8989,1427350,1427626,9
1338,245,8989,1427401,1427646,14
6443,95,8989,747830,747925,15
5386,220,8989,747925,748145,45
6140,54,8990,748144,748198,14
6540,79,8990,748198,748277,16
7125,127,8990,748277,748404,31
8249,293,8990,1472952,1473245,42
3109,165,8991,748623,748788,5
9665,137,8991,748788,748925,11
3617,88,8991,748925,749013,22
2609,79,8992,749012,749091,31
5697,281,8992,1427469,1427750,36
7944,181,8993,749320,749501,8
7860,108,8993,749501,749609,23
4728,151,8993,749609,749760,35
6584,298,8993,1475918,1476216,50
4460,75,8995,749981,750056,5
6724,63,8995,750056,750119,10
2361,29,8995,750119,750148,14
2322,158,8995,750148,750306,36
1689,134,8996,750305,750439,11
9332,278,8996,1427573,1427851,36
5119,181,8996,750669,750850,43
3807,263,8996,1427632,1427895,47
3913,36,8997,751068,751104,28
9019,47,8997,751104,751151,29
7051,99,8997,751151,751250,31
4347,278,8997,1427660,1427938,35
1945,232,8997,1427715,1427947,43
4915,57,8997,751707,751764,47
8540,22,8998,751763,751785,15
4310,16,8998,751785,751801,19
2992,149,8998,751801,751950,44
3529,127,8998,751950,752077,46
4132,46,8999,752076,752122,12
3195,68,8999,752122,752190,20
6628,283,8999,1472976,1473259,22
5786,202,8999,752404,752606,30
3144,244,8999,1427788,1428032,33
7326,225,9000,1427808,1428033,3
9704,159,9000,753045,753204,6
3582,27,9000,753204,753231,16
7247,106,9000,753231,753337,27
1883,236,9000,1427810,1428046,27
4740,84,9000,753560,753644,29
4224,144,9001,753643,753787,14
5493,230,9001,1427820,1428050,14
8425,207,9001,754012,754219,27
9805,182,9002,754218,754400,3
7903,162,9002,754400,754562,4
3218,127,9002,754562,754689,8
3184,40,9002,754689,754729,11
1604,233,9002,1427824,1428057,14
2485,234,9002,1427843,1428077,22
3798,125,9002,755168,755293,40
3650,111,9002,755293,755404,49
3423,126,9003,755403,755529,14
8128,235,9003,1427850,1428085,38
6976,247,9004,1427867,1428114,8
3313,129,9004,755971,756100,20
2174,300,9004,1476154,1476454,21
7717,30,9004,756324,756354,39
3482,73,9005,756353,756426,12
5087,151,9005,756426,756577,15
1299,134,9005,756577,756711,17
2672,160,9005,756711,756871,27
2617,145,9005,756871,757016,34
2881,290,9005,1472984,1473274,38
7964,164,9005,757242,757406,43
8693,183,9005,757406,757589,48
5010,187,9006,757588,757775,43
5202,83,9007,757774,757857,1
8655,140,9007,757857,757997,13
7759,126,9007,757997,758123,14
6416,66,9007,758123,758189,18
4271,277,9008,1472997,1473274,4
5801,247,9008,1428059,1428306,9
7834,235,9008,1428085,1428320,32
1134,293,9008,1472993,1473286,36
5002,192,9008,759078,759270,37
4611,268,9008,1428148,1428416,39
1564,290,9009,1473002,1473292,21
3147,29,9009,759716,759745,24
4122,227,9009,1428250,1428477,34
1314,236,9009,1428257,1428493,42
6069,159,9010,760188,760347,31
5987,43,9010,760347,760390,36
2379,73,9011,760389,760462,2
7881,195,9011,760462,760657,3
2400,97,9011,760657,760754,5
8673,121,9011,760754,760875,10
2541,60,9011,760875,760935,28
5690,72,9011,760935,761007,38
5133,118,9012,761006,761124,13
6403,119,9012,761124,761243,39
9362,278,9013,1428267,1428545,6
1933,160,9013,761464,761624,13
6687,112,9013,761624,761736,16
4822,96,9013,761736,761832,20
6839,129,9013,761832,761961,21
9680,20,9013,761961,761981,25
7526,81,9013,761981,762062,29
8225,281,9013,1428319,1428600,38
2126,142,9013,762288,762430,44
8248,249,9014,1428374,1428623,14
6631,274,9014,1428409,1428683,22
1463,52,9014,762868,762920,29
6973,65,9014,762920,762985,34
4647,65,9015,762984,763049,3
8285,215,9015,763049,763264,16
6237,162,9015,763264,763426,39
7018,229,9016,1428456,1428685,14
2643,125,9016,763650,763775,15
8900,49,9016,763775,763824,31
4749,252,9016,1428459,1428711,38
7541,72,9017,764049,764121,9
1930,221,9017,764121,764342,10
6987,136,9017,764342,764478,13
4601,84,9017,764478,764562,15
8137,150,9017,764562,764712,21
2745,216,9017,764712,764928,45
8122,54,9017,764928,764982,48
4200,55,9018,764981,765036,24
1815,111,9018,765036,765147,28
8974,47,9018,765147,765194,30
5481,212,9019,765193,765405,8
5965,99,9019,765405,765504,11
3037,285,9019,1472999,1473284,39
7194,207,9019,765727,765934,41
8414,94,9020,765933,766027,22
7161,24,9020,766027,766051,25
1315,15,9020,766051,766066,39
2829,128,9020,766066,766194,44
8389,181,9020,766194,766375,44
1792,56,9021,766374,766430,3
1717,235,9021,1428547,1428782,25
8079,233,9021,1428558,1428791,26
2564,158,9021,766873,767031,47
9045,73,9022,767030,767103,1
8062,212,9022,767103,767315,3
9499,222,9022,767315,767537,27
5298,81,9022,767537,767618,34
8316,35,9022,767618,767653,46
6378,126,9022,767653,767779,50
5540,233,9023,1428571,1428804,9
9060,10,9023,767996,768006,43
5309,24,9023,768006,768030,43
5304,206,9023,768030,768236,46
1416,236,9023,1428581,1428817,48
4954,44,9023,768459,768503,50
7668,73,9024,768502,768575,4
5835,39,9024,768575,768614,24
6460,215,9024,768614,768829,30
2550,22,9024,768829,768851,33
2403,31,9024,768851,768882,37
5981,142,9024,768882,769024,50
4931,155,9024,769024,769179,50
1424,282,9025,1428590,1428872,1
9569,55,9025,769403,769458,4
8111,171,9025,769458,769629,7
9912,290,9025,1472994,1473284,14
8638,179,9025,769854,770033,18
6238,43,9025,770033,770076,30
4392,271,9025,1428697,1428968,35
7957,48,9025,770310,770358,48
9913,162,9025,770358,770520,49
7917,26,9026,770519,770545,4
6664,72,9026,770545,770617,14
5751,271,9026,1428742,1429013,41
9437,238,9027,1428787,1429025,1
8549,253,9027,1428802,1429055,3
1110,149,9027,771289,771438,22
1423,205,9027,771438,771643,29
8929,282,9027,1473001,1473283,30
8718,285,9028,1473003,1473288,8
9065,134,9028,772085,772219,16
9183,47,9028,772219,772266,19
8562,3,9028,772266,772269,24
2478,175,9028,772269,772444,40
8678,108,9028,772444,772552,47
3527,245,9028,1428952,1429197,47
4834,110,9029,772770,772880,6
4051,223,9029,1428981,1429204,19
7551,246,9030,1428986,1429232,8
6661,131,9030,773311,773442,15
8831,29,9031,773441,773470,7
2535,247,9031,1429012,1429259,29
8595,174,9032,773688,773862,1
3050,98,9032,773862,773960,7
7186,176,9032,773960,774136,16
7562,91,9033,774363,774454,29
4233,296,9032,1473003,1473299,31
9640,113,9033,774454,774567,37
1753,207,9033,774567,774774,48
9034,214,9034,774773,774987,10
8207,130,9034,774987,775117,14
6601,128,9034,775117,775245,28
6672,247,9034,1429089,1429336,28
1012,264,9034,1429112,1429376,45
1033,251,9035,1429151,1429402,34
3388,126,9035,775912,776038,48
5285,151,9036,776037,776188,23
7297,98,9036,776188,776286,34
9208,135,9037,776285,776420,32
4929,285,9038,1473011,1473296,1
3394,22,9038,776644,776666,4
7952,19,9038,776666,776685,19
6042,97,9038,776685,776782,27
8805,67,9038,776782,776849,37
3090,152,9038,776849,777001,38
7080,197,9038,777001,777198,38
8971,170,9038,777198,777368,44
5335,213,9038,777368,777581,45
2339,16,9039,777580,777596,4
9801,45,9039,777596,777641,12
1276,244,9039,1429230,1429474,37
9681,26,9039,777866,777892,42
4596,182,9040,777891,778073,4
8342,39,9040,778073,778112,5
6164,187,9040,778112,778299,10
2649,213,9040,778299,778512,11
9951,169,9040,778512,778681,25
9722,117,9040,778681,778798,28
9050,216,9040,778798,779014,35
1520,198,9040,779014,779212,48
2487,203,9041,779211,779414,9
3071,107,9041,779414,779521,12
5168,127,9041,779521,779648,17
2431,21,9041,779648,779669,27
6523,269,9041,1429253,1429522,47
3920,142,9042,779887,780029,12
8851,1,9042,780029,780030,14
2778,132,9042,780030,780162,17
7431,83,9042,780162,780245,21
3962,284,9043,1473010,1473294,24
2885,280,9043,1429356,1429636,38
4210,288,9043,1473011,1473299,39
2852,17,9043,780912,780929,48
8777,133,9044,780928,781061,6
9583,20,9044,781061,781081,8
1433,197,9044,781081,781278,11
7338,71,9044,781278,781349,19
7784,135,9044,781349,781484,34
4343,74,9044,781484,781558,39
9686,53,9045,781557,781610,2
6235,26,9045,781610,781636,27
6431,197,9045,781636,781833,29
9148,152,9046,781832,781984,8
9436,168,9046,781984,782152,16
5526,210,9046,782152,782362,27
2376,139,9046,782362,782501,32
1084,281,9046,1473016,1473297,37
5563,57,9046,782726,782783,41
9001,254,9047,1429524,1429778,3
1363,281,9047,1473017,1473298,8
7304,31,9047,783222,783253,10
2976,162,9047,783253,783415,18
3565,93,9047,783415,783508,23
8556,13,9047,783508,783521,33
2594,53,9048,783520,783573,34
5883,118,9048,783573,783691,43
9530,178,9048,783691,783869,44
8235,103,9048,783869,783972,49
7795,246,9048,1429616,1429862,50
8322,288,9049,1473015,1473303,3
2076,273,9049,1429700,1429973,25
7117,295,9049,1473020,1473315,28
1258,140,9049,784856,784996,30
7980,185,9050,784995,785180,49
7005,123,9050,785180,785303,50
5183,202,9051,785302,785504,12
5491,150,9051,785504,785654,18
4145,86,9051,785654,785740,19
7121,8,9051,785740,785748,23
9644,279,9051,1429815,1430094,25
5179,213,9051,785967,786180,28
6206,87,9051,786180,786267,33
3578,295,9051,1475869,1476164,40
4818,247,9051,1429930,1430177,49
6373,105,9052,786710,786815,6
9415,206,9052,786815,787021,8
2620,295,9052,1475869,1476164,13
8747,159,9052,787249,787408,20
5400,39,9052,787408,787447,40
1751,5,9052,787447,787452,45
8748,121,9053,787451,787572,5
3165,298,9053,1475867,1476165,6
4258,152,9053,787794,787946,13
3818,202,9053,787946,788148,49
5239,89,9054,788147,788236,5
9811,101,9054,788236,788337,10
6077,94,9054,788337,788431,48
4148,12,9055,788430,788442,20
3586,285,9055,1473071,1473356,23
1987,269,9055,1430118,1430387,32
8220,33,9055,788888,788921,38
6365,182,9055,788921,789103,42
9658,19,9056,789102,789121,18
3310,169,9056,789121,789290,21
7715,216,9056,789290,789506,42
8281,13,9056,789506,789519,48
5489,250,9057,1430163,1430413,49
8890,88,9058,789739,789827,9
5033,210,9058,789827,790037,13
4961,243,9058,1430188,1430431,21
3439,86,9058,790261,790347,34
6910,155,9058,790347,790502,34
8668,59,9059,790501,790560,10
3407,155,9059,790560,790715,39
1736,201,9060,790714,790915,16
1231,210,9061,790914,791124,4
6398,277,9061,1430213,1430490,19
7961,236,9061,1430267,1430503,27
4048,122,9061,791562,791684,41
9898,139,9061,791684,791823,42
6641,278,9061,1430280,1430558,43
3187,71,9061,792046,792117,44
7574,170,9062,792116,792286,23
7085,123,9062,792286,792409,49
6530,219,9063,792408,792627,7
9496,202,9063,792627,792829,12
1032,208,9063,792829,793037,27
1266,178,9064,793036,793214,2
5704,143,9064,793214,793357,10
7282,233,9064,1430331,1430564,11
6323,62,9064,793581,793643,15
7364,272,9064,1430337,1430609,16
2030,72,9064,793870,793942,41
9462,268,9064,1430385,1430653,45
2788,212,9065,794165,794377,2
3717,107,9065,794377,794484,19
4918,289,9065,1473066,1473355,40
2965,214,9066,794705,794919,13
5908,171,9066,794919,795090,39
2055,271,9067,1430486,1430757,7
1183,155,9067,795311,795466,16
7135,62,9067,795466,795528,23
6972,193,9067,795528,795721,23
3572,69,9067,795721,795790,50
9616,138,9068,795789,795927,3
9336,69,9068,795927,795996,26
6619,156,9068,795996,796152,28
1421,132,9068,796152,796284,32
2027,177,9068,796284,796461,47
1544,202,9069,796460,796662,14
4288,62,9069,796662,796724,27
3579,173,9069,796724,796897,39
6605,269,9070,1430531,1430800,10
5543,17,9070,797119,797136,29
2625,193,9070,797136,797329,31
6771,298,9071,1475854,1476152,10
7500,172,9071,797551,797723,15
8347,65,9071,797723,797788,45
8629,153,9071,797788,797941,47
1784,225,9072,797940,798165,14
9126,194,9072,798165,798359,16
2875,165,9072,798359,798524,20
6850,134,9072,798524,798658,28
9421,298,9072,1475855,1476153,28
2470,230,9072,1430687,1430917,31
7208,91,9072,799106,799197,34
7607,223,9072,799197,799420,35
3999,51,9072,799420,799471,41
4609,51,9072,799471,799522,44
9598,62,9072,799522,799584,45
8796,246,9074,1430690,1430936,1
2707,11,9074,799807,799818,14
7899,118,9074,799818,799936,24
3389,128,9074,799936,800064,28
8273,245,9074,1430708,1430953,31
7563,70,9074,800292,800362,39
3120,136,9074,800362,800498,40
7703,198,9074,800498,800696,40
4645,20,9074,800696,800716,45
5218,276,9075,1430727,1431003,1
8410,208,9075,800940,801148,9
5723,56,9075,801148,801204,15
2392,26,9075,801204,801230,34
9192,98,9076,801229,801327,1
3451,242,9076,1430777,1431019,1
2580,83,9076,801552,801635,6
7404,290,9076,1473095,1473385,19
3240,82,9076,801850,801932,34
6763,1,9076,801932,801933,50
1778,33,9077,801932,801965,4
6522,26,9077,801965,801991,5
4535,108,9077,801991,802099,7
9397,262,9077,1430854,1431116,20
3648,52,9077,802326,802378,21
5561,274,9078,1430892,1431166,3
6451,203,9078,802600,802803,13
9939,234,9078,1430947,1431181,29
2611,90,9079,803021,803111,2
4171,49,9080,803110,803159,16
2389,73,9080,803159,803232,41
8852,253,9080,1430960,1431213,47
9596,160,9080,803451,803611,50
9420,256,9081,1430985,1431241,16
3008,133,9081,803837,803970,30
6551,101,9081,803970,804071,38
9466,111,9081,804071,804182,41
6426,298,9082,1475848,1476146,3
6111,206,9082,804404,804610,18
5088,25,9082,804610,804635,24
2468,279,9082,1431076,1431355,40
4846,10,9083,804856,804866,28
9352,249,9083,1431124,1431373,36
6560,146,9083,805096,805242,37
2427,73,9083,805242,805315,46
7954,252,9084,1431147,1431399,2
6412,229,9084,1431175,1431404,45
2736,120,9085,805762,805882,5
8505,243,9085,1431181,1431424,5
9676,277,9085,1431202,1431479,5
5452,250,9085,1431252,1431502,20
4743,202,9085,806553,806755,23
2460,249,9085,1431276,1431525,30
7974,113,9085,806981,807094,43
7982,91,9085,807094,807185,44
8017,159,9086,807184,807343,25
6300,185,9086,807343,807528,27
5783,133,9086,807528,807661,39
4385,73,9086,807661,807734,48
7176,126,9087,807733,807859,30
4533,76,9087,807859,807935,41
8109,49,9088,807934,807983,1
8707,70,9088,807983,808053,16
7544,228,9088,1431299,1431527,27
3277,104,9088,808276,808380,33
9375,139,9088,808380,808519,35
6808,30,9089,808518,808548,2
3729,30,9089,808548,808578,10
4141,81,9089,808578,808659,18
2924,217,9089,808659,808876,25
7395,72,9089,808876,808948,28
9608,239,9089,1431292,1431531,35
4298,145,9090,809181,809326,8
7100,109,9090,809326,809435,18
1357,202,9090,809435,809637,28
1474,200,9090,809637,809837,43
7374,50,9091,809836,809886,1
5167,204,9091,809886,810090,5
1148,108,9091,810090,810198,27
2586,172,9091,810198,810370,32
5900,99,9091,810370,810469,33
7396,104,9091,810469,810573,39
3293,144,9091,810573,810717,45
6250,126,9092,810716,810842,4
5670,28,9092,810842,810870,5
2832,179,9092,810870,811049,9
1850,195,9092,811049,811244,29
4934,54,9092,811244,811298,44
7340,151,9093,811297,811448,3
6966,214,9093,811448,811662,12
3856,265,9093,1431308,1431573,24
6681,116,9093,811881,811997,38
6085,10,9093,811997,812007,41
5497,296,9093,1473100,1473396,43
2481,95,9093,812230,812325,48
4483,49,9093,812325,812374,49
7016,125,9094,812373,812498,10
5187,160,9094,812498,812658,12
7518,116,9094,812658,812774,19
6622,224,9094,812774,812998,35
4087,171,9094,812998,813169,45
7463,163,9095,813168,813331,8
8730,300,9095,1475837,1476137,17
6851,190,9096,813554,813744,5
4806,40,9096,813744,813784,40
8774,299,9096,1475840,1476139,43
6809,88,9097,814006,814094,25
2869,243,9097,1431522,1431765,27
6262,20,9097,814317,814337,33
4005,15,9097,814337,814352,43
6726,244,9097,1431541,1431785,45
2329,135,9098,814575,814710,11
6774,206,9098,814710,814916,28
9282,105,9098,814916,815021,32
9553,202,9099,815020,815222,14
8813,57,9099,815222,815279,17
6049,248,9099,1431557,1431805,38
8791,54,9100,815504,815558,4
4968,279,9100,1431584,1431863,28
8140,44,9100,815778,815822,29
3563,186,9100,815822,816008,42
3644,45,9100,816008,816053,46
1977,125,9101,816052,816177,4
9976,219,9101,816177,816396,21
2782,298,9101,1475838,1476136,25
2464,254,9102,1431703,1431957,5
6065,97,9102,816836,816933,28
1916,118,9102,816933,817051,38
8705,172,9102,817051,817223,42
5343,234,9103,1431734,1431968,6
4933,185,9103,817444,817629,15
2696,275,9103,1431753,1432028,19
4093,28,9103,817844,817872,20
2803,245,9103,1431804,1432049,21
8266,141,9103,818096,818237,46
9394,43,9103,818237,818280,49
9371,203,9103,818280,818483,50
3878,206,9104,818482,818688,16
4710,242,9104,1431833,1432075,19
9270,206,9104,818903,819109,26
8975,277,9104,1431847,1432124,31
2794,166,9104,819337,819503,33
6145,113,9104,819503,819616,50
1027,221,9105,819615,819836,12
8894,125,9106,819835,819960,23
1765,207,9106,819960,820167,33
8171,225,9106,1431902,1432127,42
6956,271,9107,1431901,1432172,2
5413,146,9107,820611,820757,15
7888,216,9107,820757,820973,15
4061,88,9107,820973,821061,20
3417,75,9107,821061,821136,26
9388,150,9107,821136,821286,33
7708,80,9107,821286,821366,42
7725,173,9107,821366,821539,43
9123,289,9108,1473141,1473430,24
6579,197,9108,821757,821954,30
8995,34,9108,821954,821988,31
4361,268,9108,1432005,1432273,31
5712,23,9108,822216,822239,43
3250,115,9109,822238,822353,6
5166,260,9109,1432053,1432313,24
1843,280,9109,1432089,1432369,34
9463,38,9109,822796,822834,35
9789,93,9109,822834,822927,37
7345,211,9109,822927,823138,39
5038,176,9109,823138,823314,42
5189,62,9110,823313,823375,8
2295,219,9110,1432153,1432372,19
1197,114,9110,823590,823704,22
9289,36,9110,823704,823740,26
9772,283,9111,1473148,1473431,7
4732,109,9111,823961,824070,23
1004,231,9111,1432209,1432440,47
5623,92,9112,824288,824380,18
3914,106,9112,824380,824486,18
6488,260,9112,1432219,1432479,28
5105,5,9112,824706,824711,37
9919,274,9112,1432259,1432533,46
7315,242,9112,1432311,1432553,49
3300,124,9113,825152,825276,5
2847,166,9113,825276,825442,23
2998,122,9113,825442,825564,37
8175,229,9113,1432326,1432555,38
3670,12,9115,825788,825800,2
3641,158,9116,825799,825957,1
9036,249,9116,1432329,1432578,48
4085,232,9117,1432355,1432587,5
7043,266,9117,1432369,1432635,9
5739,291,9117,1473149,1473440,9
2187,123,9117,826837,826960,38
2060,227,9117,1432470,1432697,43
5092,249,9117,1432473,1432722,45
8311,248,9118,1432496,1432744,14
2721,296,9118,1473157,1473453,17
1974,121,9118,827855,827976,31
2282,10,9118,827976,827986,37
6942,269,9118,1432580,1432849,49
6974,46,9119,828207,828253,2
9653,89,9119,828253,828342,17
6538,18,9119,828342,828360,19
5288,174,9119,828360,828534,25
4705,47,9119,828534,828581,39
3674,101,9120,828580,828681,16
5455,275,9121,1432621,1432896,1
6479,241,9121,1432675,1432916,4
4966,266,9121,1432694,1432960,40
2691,154,9122,829347,829501,7
6156,152,9122,829501,829653,14
2313,252,9122,1432729,1432981,36
3998,157,9122,829883,830040,45
7501,192,9123,830039,830231,7
8565,195,9123,830231,830426,20
2430,34,9123,830426,830460,22
7402,287,9123,1473166,1473453,46
8838,164,9124,830679,830843,21
7869,233,9124,1432817,1433050,21
5274,230,9124,1432830,1433060,28
2667,140,9125,831286,831426,10
5909,205,9125,831426,831631,16
7258,201,9125,831631,831832,33
6298,66,9125,831832,831898,35
7729,91,9125,831898,831989,39
2442,121,9125,831989,832110,43
9632,264,9126,1432836,1433100,5
1056,157,9126,832331,832488,24
7764,88,9126,832488,832576,37
9095,88,9126,832576,832664,46
9330,97,9127,832663,832760,1
8989,285,9127,1473166,1473451,21
2180,283,9127,1473171,1473454,40
7720,299,9128,1475813,1476112,14
5337,16,9128,833430,833446,25
1639,147,9128,833446,833593,30
2220,295,9129,1475817,1476112,13
9905,178,9129,833820,833998,32
3176,84,9129,833998,834082,38
3730,171,9130,834081,834252,14
9881,179,9130,834252,834431,33
2902,260,9130,1433101,1433361,43
3937,93,9131,834653,834746,9
5290,295,9131,1473193,1473488,20
3496,112,9131,834973,835085,25
2554,279,9131,1433196,1433475,28
2453,19,9131,835305,835324,31
7289,155,9132,835323,835478,1
4082,170,9132,835478,835648,2
4853,275,9132,1433252,1433527,6
6274,288,9132,1473213,1473501,22
3593,260,9132,1433366,1433626,32
8032,217,9133,836304,836521,16
7960,22,9134,836520,836542,17
3301,129,9134,836542,836671,19
9057,2,9134,836671,836673,24
3001,25,9134,836673,836698,25
2234,258,9134,1433400,1433658,26
2763,59,9134,836922,836981,42
1255,208,9134,836981,837189,49
8141,181,9135,837188,837369,3
3799,226,9135,1433435,1433661,6
2558,236,9135,1433437,1433673,21
3285,248,9135,1433456,1433704,33
2692,262,9135,1433478,1433740,38
4299,185,9135,838258,838443,41
8121,286,9136,1473223,1473509,4
4769,46,9136,838663,838709,9
6210,59,9136,838709,838768,9
5474,201,9136,838768,838969,12
2280,222,9136,838969,839191,16
8720,114,9136,839191,839305,40
4634,206,9136,839305,839511,42
9546,292,9137,1473227,1473519,3
4898,260,9137,1433627,1433887,7
6006,197,9137,839955,840152,16
9053,206,9138,840151,840357,4
2850,120,9138,840357,840477,8
2196,9,9138,840477,840486,9
1546,3,9138,840486,840489,11
8783,242,9138,1433658,1433900,13
1277,203,9138,840717,840920,22
2873,244,9138,1433681,1433925,29
1980,193,9138,841139,841332,35
2294,293,9138,1473234,1473527,41
3743,154,9138,841557,841711,42
8713,242,9138,1433761,1434003,50
1961,128,9139,841933,842061,10
4011,292,9139,1473244,1473536,12
2095,122,9139,842284,842406,17
1065,20,9139,842406,842426,21
2970,215,9139,842426,842641,23
4622,226,9139,842641,842867,36
1829,292,9140,1473253,1473545,2
1899,35,9140,843091,843126,5
6343,195,9140,843126,843321,5
5217,75,9140,843321,843396,38
9876,255,9140,1433892,1434147,41
9957,219,9140,843621,843840,43
4713,279,9141,1433920,1434199,30
9291,271,9141,1433979,1434250,42
4068,29,9141,844285,844314,44
3019,69,9141,844314,844383,44
5806,125,9141,844383,844508,48
1937,192,9141,844508,844700,49
4584,127,9141,844700,844827,50
9610,93,9142,844826,844919,17
4550,177,9142,844919,845096,28
9857,108,9142,845096,845204,30
1430,182,9142,845204,845386,37
1923,3,9142,845386,845389,41
8468,167,9142,845389,845556,44
5459,62,9143,845555,845617,1
5342,163,9143,845617,845780,14
9917,37,9143,845780,845817,49
8802,180,9144,845816,845996,8
1685,291,9144,1473257,1473548,14
6858,161,9145,846220,846381,33
1146,125,9146,846380,846505,10
7774,93,9146,846505,846598,30
5431,187,9147,846597,846784,25
9758,150,9147,846784,846934,35
3427,264,9147,1434080,1434344,43
4045,202,9148,847156,847358,1
3045,5,9148,847358,847363,5
8501,129,9148,847363,847492,21
5873,131,9148,847492,847623,30
8795,56,9149,847622,847678,17
8259,242,9149,1434118,1434360,17
6747,278,9149,1434133,1434411,20
8690,116,9149,848129,848245,21
4621,8,9149,848245,848253,28
5979,60,9149,848253,848313,30
7713,295,9149,1473261,1473556,46
5820,15,9149,848533,848548,49
1037,40,9150,848547,848587,4
6994,160,9150,848587,848747,13
6020,59,9150,848747,848806,16
9355,283,9150,1473274,1473557,38
8080,227,9151,1434301,1434528,1
1180,73,9151,849256,849329,13
4407,108,9151,849329,849437,18
3345,20,9151,849437,849457,19
6162,226,9151,849457,849683,20
7316,32,9151,849683,849715,21
4279,249,9151,1434294,1434543,35
4430,151,9152,849948,850099,25
1348,65,9152,850099,850164,36
5805,255,9152,1434319,1434574,50
7366,272,9153,1434349,1434621,11
1529,237,9153,1434393,1434630,13
1325,101,9153,850838,850939,15
3865,5,9153,850939,850944,22
6289,289,9153,1473280,1473569,22
4798,78,9153,851158,851236,45
5412,223,9153,851236,851459,48
9672,49,9154,851458,851507,13
2360,292,9154,1473287,1473579,31
1787,243,9155,1434518,1434761,3
4130,54,9155,851957,852011,42
1191,285,9155,1473302,1473587,42
7099,268,9156,1434591,1434859,14
4420,71,9156,852455,852526,23
3757,11,9156,852526,852537,26
2355,274,9156,1434633,1434907,30
8442,296,9157,1473301,1473597,14
5877,291,9157,1473316,1473607,30
7355,177,9157,853213,853390,36
9756,220,9157,853390,853610,36
5467,164,9158,853609,853773,7
9272,181,9158,853773,853954,26
9697,119,9158,853954,854073,27
4965,258,9158,1434794,1435052,41
9113,271,9159,1434834,1435105,33
1157,64,9159,854514,854578,39
2483,53,9160,854577,854630,15
5004,142,9160,854630,854772,26
2316,24,9161,854771,854795,5
1016,90,9161,854795,854885,15
6255,107,9161,854885,854992,16
5529,236,9161,1434876,1435112,16
5499,144,9161,855219,855363,34
1345,54,9161,855363,855417,38
9645,254,9161,1434886,1435140,38
6725,121,9161,855643,855764,48
3923,250,9162,1434916,1435166,3
9712,16,9162,855986,856002,16
9888,172,9162,856002,856174,18
9041,40,9162,856174,856214,37
2328,165,9162,856214,856379,45
7173,27,9162,856379,856406,47
1408,199,9162,856406,856605,50
5545,130,9163,856604,856734,3
3532,222,9163,1434951,1435173,22
4472,40,9163,856948,856988,36
9446,263,9163,1434948,1435211,41
5283,38,9163,857213,857251,45
3672,175,9164,857250,857425,27
1170,173,9164,857425,857598,43
6528,129,9165,857597,857726,20
5297,299,9165,1475995,1476294,37
8448,100,9166,857950,858050,6
8984,1,9166,858050,858051,19
4589,242,9166,1435044,1435286,24
9886,120,9166,858270,858390,25
5326,175,9166,858390,858565,29
1125,266,9166,1435062,1435328,34
5454,127,9166,858789,858916,46
7769,200,9167,858915,859115,10
3658,140,9167,859115,859255,15
2175,213,9167,859255,859468,47
5644,176,9167,859468,859644,48
3419,138,9167,859644,859782,49
6600,142,9168,859781,859923,17
4692,268,9168,1435106,1435374,28
6829,82,9168,860143,860225,33
3175,246,9168,1435152,1435398,40
9839,65,9169,860446,860511,7
1740,193,9169,860511,860704,20
5256,49,9169,860704,860753,39
1825,271,9169,1435178,1435449,47
7221,20,9170,860971,860991,6
9940,169,9170,860991,861160,9
8789,279,9170,1435220,1435499,13
5566,218,9170,861388,861606,28
7765,248,9171,1435277,1435525,4
5515,111,9171,861826,861937,33
9485,65,9171,861937,862002,34
7089,154,9171,862002,862156,42
6844,65,9171,862156,862221,50
5934,192,9171,862221,862413,50
6234,254,9173,1435302,1435556,4
2536,231,9173,1435337,1435568,24
2106,283,9173,1473325,1473608,34
6804,81,9173,863075,863156,37
7649,194,9174,863155,863349,7
2731,17,9174,863349,863366,8
8771,210,9174,863366,863576,44
3821,223,9175,863575,863798,38
9162,245,9175,1435401,1435646,49
3360,113,9176,864019,864132,5
7918,118,9176,864132,864250,12
9493,37,9176,864250,864287,42
2956,87,9177,864286,864373,9
7978,62,9177,864373,864435,21
5955,226,9177,1435420,1435646,34
5812,183,9178,864658,864841,38
9924,46,9179,864840,864886,17
5620,169,9179,864886,865055,20
4152,291,9179,1473321,1473612,24
7833,11,9179,865274,865285,32
5553,192,9179,865285,865477,38
9226,144,9180,865476,865620,11
6346,189,9180,865620,865809,33
1728,218,9180,865809,866027,38
6348,177,9180,866027,866204,47
3339,154,9181,866203,866357,1
9024,76,9182,866356,866432,3
5663,148,9182,866432,866580,3
4301,256,9182,1435485,1435741,9
9216,130,9182,866798,866928,12
8973,96,9182,866928,867024,21
4512,64,9182,867024,867088,29
9211,63,9182,867088,867151,31
2148,210,9182,867151,867361,32
2681,218,9182,867361,867579,34
4534,290,9182,1473328,1473618,34
2363,134,9182,867803,867937,41
8571,72,9182,867937,868009,44
3104,69,9182,868009,868078,46
5368,68,9183,868077,868145,21
6602,40,9183,868145,868185,25
8415,32,9183,868185,868217,26
9306,115,9183,868217,868332,43
1763,153,9184,868331,868484,2
9051,84,9184,868484,868568,7
7306,178,9184,868568,868746,46
7678,93,9185,868745,868838,5
1380,17,9185,868838,868855,7
9141,198,9185,868855,869053,8
8536,78,9185,869053,869131,39
9301,99,9185,869131,869230,43
1320,213,9185,869230,869443,43
2817,106,9185,869443,869549,44
1184,289,9185,1473333,1473622,46
2530,37,9186,869768,869805,8
2393,98,9186,869805,869903,17
3548,88,9186,869903,869991,19
6570,107,9186,869991,870098,25
9738,28,9186,870098,870126,38
1831,272,9186,1435633,1435905,39
5292,298,9186,1475763,1476061,42
1267,114,9187,870568,870682,3
8570,292,9187,1473358,1473650,3
5679,183,9187,870905,871088,14
1352,283,9187,1473370,1473653,18
5790,204,9187,871310,871514,20
4892,36,9187,871514,871550,24
4676,66,9187,871550,871616,29
3072,163,9187,871616,871779,38
7461,71,9187,871779,871850,40
7731,170,9188,871849,872019,3
2633,214,9188,872019,872233,3
6470,136,9188,872233,872369,8
7267,184,9188,872369,872553,40
9621,228,9189,1435847,1436075,16
2465,25,9189,872779,872804,22
6914,60,9189,872804,872864,34
2988,40,9190,873088,873128,40
3852,250,9189,1435850,1436100,41
9154,48,9191,873127,873175,13
9027,156,9191,873175,873331,16
3354,227,9191,1435875,1436102,27
2336,81,9191,873554,873635,34
3759,159,9191,873635,873794,41
3055,114,9191,873794,873908,47
6173,138,9192,873907,874045,7
3438,18,9192,874045,874063,8
9823,185,9192,874063,874248,15
6723,11,9192,874248,874259,21
6580,127,9192,874259,874386,29
2967,72,9193,874385,874457,5
5964,205,9193,874457,874662,24
9122,99,9194,874661,874760,8
5583,232,9194,1435876,1436108,10
4010,210,9194,874983,875193,16
9536,112,9194,875193,875305,28
5032,55,9194,875305,875360,29
3620,195,9194,875360,875555,33
5870,31,9195,875554,875585,35
7922,227,9194,875586,875813,35
3649,154,9196,875811,875965,6
1607,156,9196,875965,876121,12
4406,107,9196,876121,876228,38
5067,79,9196,876228,876307,39
2712,214,9196,876307,876521,41
6737,163,9196,876521,876684,47
5779,193,9197,876683,876876,1
8765,124,9197,876876,877000,16
2177,240,9197,1435890,1436130,19
6308,252,9197,1435905,1436157,23
2469,210,9197,877440,877650,27
9852,279,9197,1435937,1436216,28
9841,218,9197,877870,878088,29
5630,17,9197,878088,878105,42
3241,157,9198,878104,878261,9
6028,144,9198,878261,878405,11
9150,107,9198,878405,878512,16
8915,72,9198,878512,878584,34
6916,140,9198,878584,878724,43
7367,95,9198,878724,878819,47
4950,215,9199,878818,879033,6
9039,162,9199,879033,879195,32
1102,271,9199,1435990,1436261,45
7675,68,9200,879418,879486,11
7139,45,9200,879486,879531,21
9189,190,9200,879531,879721,25
1447,29,9200,879721,879750,27
6598,206,9200,879750,879956,32
2922,52,9201,879955,880007,7
3126,17,9201,880007,880024,15
8329,145,9201,880024,880169,16
9490,268,9201,1436032,1436300,16
4525,24,9201,880396,880420,22
9643,25,9201,880420,880445,40
7236,219,9202,880444,880663,13
2668,102,9202,880663,880765,20
8820,189,9202,880765,880954,36
5912,76,9202,880954,881030,47
8440,109,9202,881030,881139,50
1250,146,9203,881138,881284,28
9184,123,9203,881284,881407,29
4503,147,9203,881407,881554,48
6018,43,9204,881553,881596,7
2202,230,9204,1436082,1436312,19
6268,185,9204,881811,881996,22
8490,136,9204,881996,882132,24
5733,261,9204,1436089,1436350,27
8411,50,9204,882355,882405,30
4133,135,9204,882405,882540,32
6385,201,9204,882540,882741,34
8344,184,9204,882741,882925,45
8474,259,9205,1436131,1436390,9
6594,244,9205,1436160,1436404,36
5212,110,9205,883372,883482,47
7669,107,9206,883481,883588,10
2785,264,9206,1436176,1436440,16
7170,103,9206,883815,883918,38
7933,53,9207,883917,883970,27
8829,280,9207,1436211,1436491,31
7148,43,9207,884198,884241,32
9813,183,9207,884241,884424,41
5502,273,9208,1436265,1436538,1
5716,79,9208,884648,884727,5
9447,97,9208,884727,884824,7
5992,201,9208,884824,885025,22
8081,194,9208,885025,885219,32
6995,205,9208,885219,885424,37
4143,105,9208,885424,885529,44
3883,300,9208,1475952,1476252,44
6503,13,9209,885750,885763,2
3445,81,9209,885763,885844,4
4980,262,9209,1436376,1436638,4
1683,157,9209,886065,886222,20
2183,281,9209,1436412,1436693,30
9245,248,9209,1436469,1436717,34
7743,191,9209,886672,886863,46
1594,59,9210,886862,886921,2
5685,68,9210,886921,886989,20
7992,262,9210,1436502,1436764,22
6369,27,9210,887203,887230,29
5857,233,9210,1436545,1436778,29
3916,178,9210,887449,887627,35
2861,143,9210,887627,887770,42
5377,147,9211,887769,887916,3
2526,131,9211,887916,888047,7
4823,227,9211,1436553,1436780,11
9683,192,9211,888271,888463,16
9698,257,9211,1436553,1436810,20
7091,284,9211,1473370,1473654,22
3208,50,9211,888904,888954,33
6265,23,9211,888954,888977,39
2834,210,9211,888977,889187,50
3708,210,9211,889187,889397,50
5952,54,9212,889396,889450,7
9239,74,9212,889450,889524,8
6615,253,9212,1436646,1436899,12
2724,126,9212,889747,889873,44
2820,186,9212,889873,890059,48
5095,58,9213,890058,890116,25
5469,229,9213,1436674,1436903,26
3573,161,9213,890340,890501,36
1209,130,9213,890501,890631,43
1464,169,9214,890630,890799,3
9850,212,9214,890799,891011,3
1117,54,9214,891011,891065,24
7478,195,9214,891065,891260,42
7138,121,9215,891259,891380,5
8328,284,9215,1473372,1473656,16
1556,91,9215,891607,891698,26
8797,112,9215,891698,891810,36
2937,252,9215,1436728,1436980,45
6903,19,9216,892033,892052,29
4504,109,9216,892052,892161,32
3484,193,9216,892161,892354,46
9896,258,9217,1436755,1437013,12
4411,9,9217,892576,892585,31
1876,245,9217,1436792,1437037,32
7006,188,9217,892806,892994,45
5316,83,9218,892993,893076,5
5048,283,9218,1436816,1437099,28
4815,116,9218,893296,893412,43
9166,82,9219,893411,893493,12
5656,74,9219,893493,893567,15
9478,77,9219,893567,893644,22
2191,12,9219,893644,893656,24
7270,54,9219,893656,893710,34
8020,161,9219,893710,893871,46
6877,289,9220,1473369,1473658,1
5748,277,9221,1436925,1437202,13
6407,267,9221,1436987,1437254,19
1370,201,9221,894537,894738,33
8620,6,9221,894738,894744,37
7530,71,9221,894744,894815,43
4816,293,9221,1475736,1476029,48
8310,64,9222,895037,895101,10
7990,183,9222,895101,895284,14
8642,72,9222,895284,895356,18
1869,73,9222,895356,895429,22
9927,200,9222,895429,895629,29
6578,17,9222,895629,895646,30
6048,21,9222,895646,895667,30
2705,240,9222,1437086,1437326,39
1261,252,9222,1437103,1437355,50
4042,192,9223,896112,896304,18
4459,126,9223,896304,896430,27
4433,9,9223,896430,896439,33
6958,195,9223,896439,896634,46
6411,72,9223,896634,896706,50
3080,118,9224,896705,896823,2
1087,116,9224,896823,896939,14
5329,64,9224,896939,897003,28
3379,294,9224,1473391,1473685,42
6392,278,9225,1437183,1437461,14
7753,36,9225,897447,897483,21
6296,136,9226,897482,897618,31
6728,272,9226,1437234,1437506,38
2498,172,9226,897844,898016,40
7816,167,9226,898016,898183,41
6483,46,9227,898182,898228,22
4306,283,9228,1473402,1473685,6
2699,261,9228,1437341,1437602,15
6019,271,9228,1437382,1437653,15
9229,278,9228,1437429,1437707,21
7123,59,9228,899113,899172,24
3307,228,9228,1437484,1437712,27
9714,254,9228,1437492,1437746,28
1401,288,9228,1473401,1473689,41
8981,167,9229,899839,900006,1
5985,201,9229,900006,900207,21
6067,97,9229,900207,900304,28
6366,19,9229,900304,900323,44
9299,36,9229,900323,900359,45
7996,192,9230,900358,900550,2
1526,206,9230,900550,900756,3
5240,242,9230,1437585,1437827,9
5999,72,9230,900974,901046,13
2884,290,9230,1473406,1473696,29
7962,117,9230,901265,901382,44
1547,126,9230,901382,901508,44
7435,58,9231,901507,901565,6
1156,118,9231,901565,901683,13
5372,192,9231,901683,901875,20
1412,155,9231,901875,902030,25
3137,63,9231,902030,902093,42
4699,41,9232,902092,902133,27
5101,102,9232,902133,902235,38
4863,92,9232,902235,902327,50
7873,6,9233,902326,902332,15
2704,56,9233,902332,902388,19
6376,237,9233,1437665,1437902,32
3763,277,9233,1437677,1437954,37
6695,299,9234,1475954,1476253,4
3590,157,9234,903054,903211,34
5885,196,9235,903210,903406,2
4753,50,9235,903406,903456,12
6477,59,9235,903456,903515,22
9862,176,9235,903515,903691,23
6500,66,9235,903691,903757,24
9673,111,9235,903757,903868,32
3813,1,9235,903868,903869,43
4641,180,9236,903868,904048,17
3266,94,9236,904048,904142,19
8130,63,9236,904142,904205,22
3858,102,9236,904205,904307,43
6202,2,9236,904307,904309,45
4334,295,9236,1473426,1473721,45
2894,96,9236,904533,904629,47
6738,137,9237,904628,904765,3
3673,181,9237,904765,904946,6
7928,281,9237,1473441,1473722,6
4691,167,9237,905168,905335,10
5823,31,9237,905335,905366,15
9695,284,9237,1473443,1473727,26
8493,167,9237,905590,905757,34
9581,133,9237,905757,905890,45
5332,265,9238,1437948,1438213,10
7166,280,9239,1473446,1473726,15
4445,185,9239,906331,906516,22
4158,4,9240,906515,906519,1
6167,224,9240,1438048,1438272,5
9993,57,9240,906741,906798,30
9359,281,9240,1438049,1438330,39
1662,45,9240,907021,907066,45
3702,156,9241,907065,907221,8
4124,24,9241,907221,907245,11
5860,50,9241,907245,907295,14
2349,149,9241,907295,907444,29
1262,186,9241,907444,907630,34
5622,75,9242,907629,907704,3
8083,192,9242,907704,907896,9
6712,128,9242,907896,908024,16
8054,84,9242,908024,908108,49
3403,72,9242,908108,908180,50
4660,228,9243,1438103,1438331,11
3092,170,9243,908403,908573,22
4642,131,9243,908573,908704,39
3754,178,9243,908704,908882,41
7639,34,9243,908882,908916,47
7803,60,9244,908915,908975,4
4693,295,9244,1473440,1473735,31
6397,293,9245,1473457,1473750,10
3845,220,9245,909425,909645,23
1545,76,9245,909645,909721,35
5651,178,9245,909721,909899,42
3264,184,9245,909899,910083,50
8354,123,9246,910082,910205,25
6052,49,9246,910205,910254,28
4102,260,9247,1438211,1438471,10
5494,191,9247,910476,910667,21
8856,249,9247,1438243,1438492,31
7457,214,9247,910895,911109,35
9965,48,9247,911109,911157,37
5982,170,9247,911157,911327,41
1175,131,9247,911327,911458,47
2663,36,9247,911458,911494,49
6105,40,9248,911493,911533,21
6888,115,9248,911533,911648,36
3583,55,9249,911647,911702,22
2215,297,9249,1475712,1476009,34
9068,170,9250,911925,912095,4
3038,259,9250,1438322,1438581,17
3860,262,9250,1438354,1438616,20
9267,70,9250,912546,912616,28
2041,67,9250,912616,912683,32
9262,122,9250,912683,912805,33
4787,174,9250,912805,912979,45
1875,36,9251,912978,913014,3
9573,295,9251,1475713,1476008,13
7175,213,9252,913241,913454,6
1301,155,9252,913454,913609,12
2630,254,9252,1438444,1438698,18
6304,144,9252,913831,913975,19
1469,66,9252,913975,914041,20
3442,186,9252,914041,914227,35
2693,268,9252,1438473,1438741,41
5126,29,9253,914451,914480,8
5188,214,9253,914480,914694,8
2110,206,9253,914694,914900,13
7026,89,9253,914900,914989,18
7024,289,9253,1473495,1473784,22
1718,277,9253,1438577,1438854,27
8215,276,9253,1438626,1438902,31
2713,166,9253,915654,915820,36
1445,266,9254,1438677,1438943,34
5936,123,9254,916043,916166,35
5899,195,9254,916166,916361,41
4175,231,9255,1438715,1438946,16
6894,98,9255,916587,916685,17
6617,294,9255,1475914,1476208,47
6487,104,9256,916903,917007,15
8527,186,9256,917007,917193,19
1924,255,9256,1438777,1439032,26
4598,125,9257,917416,917541,3
6593,284,9257,1438806,1439090,14
3209,11,9257,917766,917777,23
4662,50,9257,917777,917827,28
2092,212,9257,917827,918039,39
6246,27,9257,918039,918066,46
7049,29,9257,918066,918095,47
8397,58,9258,918094,918152,13
6565,14,9258,918152,918166,19
4909,156,9258,918166,918322,21
3862,241,9258,1438859,1439100,36
5376,14,9259,918551,918565,14
3382,144,9259,918565,918709,45
9140,180,9260,918708,918888,7
1678,206,9260,918888,919094,10
5990,124,9261,919093,919217,5
3237,175,9261,919217,919392,8
8506,172,9261,919392,919564,23
6395,143,9261,919564,919707,30
6213,147,9261,919707,919854,31
1332,175,9261,919854,920029,32
7695,199,9261,920029,920228,43
7663,36,9262,920227,920263,3
2229,86,9262,920263,920349,22
3308,64,9262,920349,920413,35
6469,122,9263,920412,920534,46
2300,222,9263,1438875,1439097,46
5976,41,9264,920753,920794,8
8165,67,9264,920794,920861,9
6655,13,9264,920861,920874,12
4672,300,9264,1475707,1476007,15
1446,123,9264,921094,921217,22
8891,32,9264,921217,921249,35
2454,292,9265,1473516,1473808,39
9986,116,9265,921471,921587,48
8027,7,9266,921586,921593,22
6800,181,9266,921593,921774,36
6788,212,9266,921774,921986,36
9531,10,9267,921985,921995,6
7088,131,9267,921995,922126,16
2172,120,9267,922126,922246,43
4581,224,9267,1438989,1439213,48
1620,152,9268,922468,922620,13
9026,9,9268,922620,922629,33
5852,2,9268,922629,922631,44
7741,65,9269,922630,922695,14
8588,178,9269,922695,922873,21
6537,197,9269,922873,923070,24
2216,13,9269,923070,923083,40
1099,136,9270,923082,923218,9
5418,227,9270,1438987,1439214,10
3361,172,9270,923441,923613,30
6886,241,9271,1438988,1439229,2
6284,82,9271,923837,923919,8
6489,63,9271,923919,923982,21
3791,261,9271,1439009,1439270,28
4402,110,9271,924202,924312,32
7212,62,9271,924312,924374,46
3096,187,9272,924373,924560,32
4450,27,9272,924560,924587,39
5302,139,9272,924587,924726,44
9757,3,9273,924725,924728,2
6777,56,9273,924728,924784,7
3682,283,9273,1473518,1473801,12
9594,108,9273,925007,925115,25
2808,70,9274,925114,925184,7
7863,94,9274,925184,925278,11
5980,262,9274,1439102,1439364,11
4978,159,9274,925502,925661,19
2291,250,9274,1439141,1439391,39
1403,213,9274,925884,926097,50
6347,68,9275,926096,926164,1
8828,86,9275,926164,926250,8
6666,104,9275,926250,926354,24
9224,258,9275,1439171,1439429,25
9489,9,9275,926573,926582,28
3174,226,9275,1439206,1439432,48
9687,201,9275,926805,927006,49
2111,12,9276,927005,927017,19
4785,149,9276,927017,927166,27
4817,133,9276,927166,927299,37
9300,277,9276,1439209,1439486,44
7044,211,9276,927521,927732,48
9201,298,9277,1475698,1475996,35
8946,143,9277,927965,928108,38
4289,234,9278,1439309,1439543,1
5209,213,9278,928332,928545,5
1172,135,9278,928545,928680,6
5945,5,9278,928680,928685,12
4566,195,9278,928685,928880,14
7032,300,9278,1475886,1476186,32
3982,168,9278,929101,929269,40
1046,228,9278,1439380,1439608,42
5588,180,9279,929488,929668,16
1789,98,9279,929668,929766,20
8481,255,9279,1439385,1439640,49
5450,115,9280,929987,930102,9
6899,161,9280,930102,930263,33
8716,255,9280,1439422,1439677,33
8124,292,9280,1473538,1473830,35
1435,175,9280,930714,930889,44
8517,130,9281,930888,931018,23
2866,232,9281,1439501,1439733,23
2372,9,9281,931243,931252,40
6155,149,9281,931252,931401,44
5082,276,9281,1439509,1439785,45
6291,2,9281,931625,931627,49
5776,22,9282,931626,931648,17
6330,75,9282,931648,931723,23
7994,2,9282,931723,931725,35
7442,211,9282,931725,931936,35
9767,287,9282,1473544,1473831,41
3366,86,9282,932161,932247,45
8970,51,9283,932246,932297,5
9003,2,9283,932297,932299,12
3932,59,9283,932299,932358,32
3507,109,9283,932358,932467,36
6630,28,9283,932467,932495,46
6678,190,9283,932495,932685,47
2399,166,9284,932684,932850,4
4890,127,9284,932850,932977,10
1505,155,9284,932977,933132,21
3272,161,9285,933131,933292,25
5599,263,9286,1439620,1439883,29
5724,33,9287,933509,933542,8
5184,53,9287,933542,933595,9
4159,123,9287,933595,933718,10
6961,22,9287,933718,933740,30
7237,46,9287,933740,933786,32
5933,49,9287,933786,933835,38
1791,266,9287,1439659,1439925,43
3481,16,9287,934058,934074,45
4560,197,9287,934074,934271,47
3519,63,9288,934270,934333,20
1107,146,9289,934332,934478,4
6287,67,9289,934478,934545,19
1713,265,9289,1439699,1439964,21
6714,176,9289,934769,934945,35
9818,76,9289,934945,935021,38
3833,241,9289,1439741,1439982,48
4121,215,9290,935243,935458,36
1910,282,9290,1473542,1473824,38
7793,135,9290,935684,935819,40
2384,125,9290,935819,935944,45
8214,224,9291,1439813,1440037,5
3375,172,9291,936165,936337,12
3874,134,9291,936337,936471,23
4262,114,9291,936471,936585,32
4831,210,9291,936585,936795,39
1304,105,9291,936795,936900,46
4470,158,9291,936900,937058,48
3454,225,9292,1439815,1440040,4
5219,12,9292,937278,937290,7
9825,254,9292,1439816,1440070,17
7352,267,9292,1439856,1440123,22
7400,252,9292,1439898,1440150,23
4866,233,9292,1439927,1440160,27
2741,248,9292,1439937,1440185,27
8292,265,9292,1439964,1440229,32
8637,59,9292,938620,938679,36
5824,164,9293,938678,938842,20
7389,262,9293,1440001,1440263,20
5349,107,9293,939069,939176,40
1297,191,9293,939176,939367,44
8025,254,9294,1440039,1440293,12
9092,224,9294,1440073,1440297,15
9323,160,9294,939809,939969,26
7796,55,9294,939969,940024,42
8895,220,9295,940023,940243,10
6536,40,9295,940243,940283,12
1575,118,9295,940283,940401,18
2402,90,9295,940401,940491,27
1615,58,9295,940491,940549,30
8888,293,9295,1473538,1473831,34
6396,159,9295,940773,940932,49
9261,105,9296,940931,941036,22
5649,147,9296,941036,941183,22
4396,283,9296,1473548,1473831,23
2266,68,9296,941408,941476,37
3334,67,9296,941476,941543,50
4192,248,9297,1440190,1440438,9
3221,260,9297,1440215,1440475,10
5121,252,9297,1440251,1440503,26
2843,81,9297,942207,942288,28
3983,294,9297,1475688,1475982,30
3348,228,9297,942514,942742,36
7815,215,9297,942742,942957,44
4974,216,9297,942957,943173,48
2806,49,9298,943172,943221,5
1162,209,9298,943221,943430,17
5215,274,9298,1440334,1440608,39
1236,77,9298,943653,943730,49
5573,158,9298,943730,943888,50
6050,61,9299,943887,943948,3
8129,223,9299,1440385,1440608,7
3263,250,9299,1440386,1440636,40
5185,10,9299,944392,944402,43
1906,201,9299,944402,944603,44
8177,41,9300,944602,944643,3
8581,289,9300,1473563,1473852,9
8923,89,9300,944861,944950,12
1417,166,9300,944950,945116,16
3922,281,9300,1440466,1440747,20
5458,17,9301,945342,945359,22
5781,296,9301,1473570,1473866,36
1358,195,9302,945588,945783,1
5077,298,9302,1475685,1475983,11
1603,214,9302,946007,946221,16
2046,39,9302,946221,946260,17
3289,132,9302,946260,946392,25
9799,40,9303,946391,946431,24
6920,252,9303,1440621,1440873,31
3303,290,9303,1473600,1473890,32
3180,187,9303,946880,947067,39
9125,105,9304,947066,947171,18
4989,115,9304,947171,947286,22
9048,199,9304,947286,947485,25
7290,198,9304,947485,947683,37
2898,174,9305,947682,947856,14
4308,80,9306,947855,947935,47
8232,97,9307,947934,948031,6
5165,134,9307,948031,948165,28
3068,197,9307,948165,948362,28
9069,176,9307,948362,948538,33
2652,213,9307,948538,948751,37
1274,280,9307,1440703,1440983,39
1711,86,9308,948973,949059,15
5680,127,9308,949059,949186,15
7242,172,9308,949186,949358,15
6432,34,9308,949358,949392,29
1161,141,9309,949391,949532,3
4154,279,9309,1440759,1441038,5
3634,190,9309,949754,949944,8
9963,54,9309,949944,949998,22
8836,84,9309,949998,950082,34
2199,249,9309,1440814,1441063,34
8677,98,9309,950306,950404,43
8679,156,9309,950404,950560,46
2011,76,9309,950560,950636,48
8914,278,9310,1440837,1441115,1
8098,292,9310,1473601,1473893,1
2256,152,9310,951085,951237,24
7864,150,9310,951237,951387,29
7017,201,9311,951386,951587,3
2333,59,9311,951587,951646,5
8150,239,9311,1440950,1441189,32
1106,171,9311,951867,952038,35
3217,178,9311,952038,952216,39
4208,272,9312,1440968,1441240,15
7144,274,9312,1441020,1441294,15
3182,131,9312,952655,952786,16
7384,65,9312,952786,952851,18
9274,291,9312,1473608,1473899,28
6880,205,9313,953070,953275,20
2462,164,9313,953275,953439,43
5331,33,9313,953439,953472,48
9444,50,9314,953471,953521,1
9265,36,9314,953521,953557,23
4618,172,9314,953557,953729,27
5301,110,9314,953729,953839,33
4629,12,9314,953839,953851,46
9555,154,9315,953850,954004,7
1986,144,9315,954004,954148,24
2236,264,9315,1441128,1441392,30
3342,243,9315,1441171,1441414,32
8010,44,9315,954595,954639,50
5853,248,9316,1441191,1441439,6
4300,76,9316,954860,954936,7
2409,11,9316,954936,954947,19
3679,186,9316,954947,955133,29
1851,192,9316,955133,955325,32
5125,137,9316,955325,955462,33
7565,227,9317,1441215,1441442,10
2669,101,9317,955684,955785,14
4284,143,9317,955785,955928,39
4908,251,9317,1441222,1441473,46
8910,222,9318,1441251,1441473,4
4661,4,9318,956368,956372,6
8091,266,9318,1441249,1441515,21
6791,202,9318,956596,956798,23
6380,156,9318,956798,956954,29
9539,31,9318,956954,956985,33
3951,252,9318,1441281,1441533,35
3942,132,9318,957219,957351,42
2684,88,9318,957351,957439,48
1279,104,9319,957438,957542,4
1308,61,9319,957542,957603,11
2910,256,9319,1441312,1441568,15
8231,300,9319,1475846,1476146,23
4467,115,9319,958048,958163,28
7310,267,9319,1441399,1441666,30
4297,3,9319,958389,958392,34
6569,281,9319,1473625,1473906,40
9327,65,9320,958613,958678,10
5584,239,9320,1441495,1441734,13
6834,229,9321,1441512,1441741,4
6297,219,9321,959126,959345,14
8358,29,9321,959345,959374,45
6673,222,9322,959373,959595,5
7229,290,9322,1473625,1473915,11
5950,8,9322,959819,959827,14
5134,257,9322,1441567,1441824,16
7704,110,9322,960054,960164,35
1245,133,9322,960164,960297,35
5834,113,9323,960296,960409,7
3385,61,9323,960409,960470,26
3630,294,9323,1473635,1473929,26
4304,22,9323,960694,960716,33
2492,232,9323,1441659,1441891,47
9626,143,9324,960934,961077,1
1171,264,9324,1441667,1441931,10
2952,14,9324,961300,961314,44
1958,84,9325,961313,961397,2
4777,73,9325,961397,961470,15
4115,56,9325,961470,961526,34
5169,137,9325,961526,961663,35
1457,242,9325,1441708,1441950,49
5581,131,9326,961884,962015,3
2171,243,9326,1441728,1441971,4
8366,191,9326,962236,962427,24
2211,185,9326,962427,962612,34
9784,279,9326,1441749,1442028,44
1570,239,9326,1441806,1442045,49
3820,216,9327,963055,963271,5
6608,174,9327,963271,963445,10
2195,122,9327,963445,963567,16
6273,22,9327,963567,963589,19
4949,181,9327,963589,963770,23
8764,230,9327,1441820,1442050,26
4987,191,9327,963994,964185,31
6409,165,9328,964184,964349,30
3740,186,9328,964349,964535,34
6559,299,9328,1475839,1476138,50
9627,149,9329,964757,964906,12
1746,101,9329,964906,965007,26
1797,240,9329,1441881,1442121,26
3963,147,9329,965231,965378,48
5591,283,9330,1473654,1473937,2
2245,50,9330,965602,965652,18
5086,202,9330,965652,965854,30
9094,103,9331,965853,965956,6
8193,192,9331,965956,966148,7
3511,164,9331,966148,966312,18
9215,241,9331,1441957,1442198,25
6838,61,9331,966531,966592,26
7771,89,9333,966590,966679,4
3864,231,9333,1441975,1442206,4
7549,120,9333,966900,967020,15
8173,174,9333,967020,967194,22
9625,87,9333,967194,967281,28
5929,16,9334,967280,967296,7
2099,210,9334,967296,967506,14
3336,12,9334,967506,967518,26
7573,68,9335,967517,967585,3
1518,300,9335,1475832,1476132,14
4508,3,9335,967810,967813,27
3993,92,9336,967812,967904,14
4649,159,9337,967903,968062,4
8223,138,9337,968062,968200,12
9467,264,9337,1442037,1442301,26
5160,144,9338,968423,968567,1
6873,172,9338,968567,968739,2
5282,280,9338,1473667,1473947,4
3392,77,9338,968960,969037,33
8087,283,9338,1473666,1473949,34
6267,119,9338,969261,969380,39
7791,261,9338,1442188,1442449,44
7238,159,9339,969601,969760,7
7075,8,9339,969760,969768,29
3265,90,9339,969768,969858,31
1405,38,9339,969858,969896,40
3281,8,9339,969896,969904,42
4764,92,9340,969903,969995,5
4745,142,9340,969995,970137,13
2176,177,9340,970137,970314,28
7399,185,9340,970314,970499,47
7886,121,9341,970498,970619,6
8921,53,9341,970619,970672,10
7249,228,9341,1442221,1442449,14
8388,64,9341,970897,970961,16
1324,251,9341,1442223,1442474,30
1524,201,9341,971187,971388,37
8241,168,9342,971387,971555,1
5547,70,9342,971555,971625,7
6789,193,9342,971625,971818,9
8561,31,9342,971818,971849,25
9973,88,9342,971849,971937,40
2052,129,9343,971936,972065,5
9246,48,9344,972064,972112,6
5986,204,9344,972112,972316,10
2374,132,9344,972316,972448,15
7284,156,9344,972448,972604,31
4464,224,9344,972604,972828,41
6716,192,9344,972828,973020,50
6032,222,9345,973019,973241,5
9706,86,9345,973241,973327,22
1036,11,9345,973327,973338,35
5205,107,9346,973337,973444,2
6391,214,9346,973444,973658,28
3618,262,9346,1442245,1442507,45
9073,3,9347,973881,973884,4
1503,80,9347,973884,973964,21
6947,49,9347,973964,974013,28
8908,62,9347,974013,974075,34
8090,80,9347,974075,974155,40
3974,225,9347,1442283,1442508,50
9926,259,9348,1442282,1442541,2
1517,9,9348,974602,974611,16
7877,260,9348,1442314,1442574,20
6283,52,9348,974838,974890,35
7802,145,9348,974890,975035,37
6727,189,9348,975035,975224,41
5862,33,9349,975223,975256,2
7912,107,9349,975256,975363,6
7987,230,9349,1442353,1442583,28
8577,191,9350,975582,975773,19
2087,233,9350,975773,976006,35
5804,111,9350,976006,976117,40
5881,283,9350,1442357,1442640,41
2899,154,9350,976342,976496,42
7705,68,9350,976496,976564,50
1205,77,9351,976563,976640,9
7659,296,9351,1473653,1473949,20
3352,36,9351,976867,976903,28
9854,222,9351,1442475,1442697,42
2556,196,9352,977122,977318,3
9116,73,9352,977318,977391,9
6917,74,9352,977391,977465,17
7692,9,9352,977465,977474,22
3801,54,9352,977474,977528,33
8792,46,9352,977528,977574,44
8932,178,9352,977574,977752,47
6669,35,9353,977751,977786,16
2801,7,9353,977786,977793,22
5757,71,9353,977793,977864,29
4465,253,9353,1442469,1442722,30
9357,81,9353,978090,978171,40
3459,180,9354,978170,978350,3
5318,24,9354,978350,978374,4
5533,179,9354,978374,978553,17
3992,274,9354,1442497,1442771,17
1959,7,9354,978777,978784,25
8391,223,9354,978784,979007,26
8656,257,9354,1442547,1442804,45
2947,3,9354,979231,979234,49
3585,11,9355,979233,979244,3
7656,150,9355,979244,979394,11
1511,185,9355,979394,979579,27
3269,40,9355,979579,979619,32
6499,280,9355,1442579,1442859,45
2522,256,9356,1442638,1442894,15
4752,7,9356,980062,980069,20
5810,234,9356,980069,980303,35
5461,41,9356,980303,980344,38
9902,71,9356,980344,980415,42
5099,64,9356,980415,980479,45
2768,209,9357,980478,980687,1
7529,248,9357,1442668,1442916,2
8823,194,9357,980912,981106,13
5162,260,9357,1442689,1442949,20
8892,158,9357,981333,981491,23
5437,25,9357,981491,981516,41
5225,206,9358,981515,981721,20
6907,73,9358,981721,981794,22
1058,270,9358,1442723,1442993,23
7584,260,9358,1442763,1443023,36
2312,133,9358,982249,982382,40
7682,187,9358,982382,982569,40
3034,85,9359,982568,982653,4
6934,242,9359,1442797,1443039,14
2941,43,9359,982878,982921,19
8737,253,9359,1442819,1443072,28
1321,214,9360,983140,983354,3
8832,194,9360,983354,983548,5
1127,298,9360,1475639,1475937,44
3892,79,9360,983770,983849,47
9217,232,9361,1442902,1443134,13
3538,84,9361,984076,984160,15
7655,185,9361,984160,984345,15
1368,42,9361,984345,984387,19
4309,64,9361,984387,984451,26
2386,87,9361,984451,984538,30
6707,268,9361,1442914,1443182,42
4779,170,9362,984757,984927,12
5026,136,9362,984927,985063,24
2841,171,9362,985063,985234,32
5995,252,9362,1442959,1443211,44
1886,286,9362,1473678,1473964,47
8072,251,9363,1443044,1443295,7
3556,224,9363,985896,986120,11
9337,108,9363,986120,986228,17
1477,81,9363,986228,986309,18
1312,164,9363,986309,986473,44
5328,252,9364,1443070,1443322,17
7101,237,9365,1443101,1443338,15
5291,189,9365,986915,987104,16
6954,139,9365,987104,987243,21
8431,148,9365,987243,987391,25
8955,162,9365,987391,987553,34
3377,69,9365,987553,987622,46
5308,31,9366,987621,987652,22
5066,99,9367,987651,987750,9
9507,40,9367,987750,987790,23
8652,23,9367,987790,987813,25
5175,159,9367,987813,987972,25
1738,178,9367,987972,988150,44
3576,6,9367,988150,988156,46
2448,165,9368,988155,988320,7
1313,36,9368,988320,988356,9
6115,59,9368,988356,988415,17
9339,94,9368,988415,988509,19
1929,66,9368,988509,988575,36
1817,264,9368,1443105,1443369,36
3610,74,9368,988805,988879,48
5568,207,9369,988878,989085,17
7524,247,9370,1443143,1443390,11
8034,199,9371,989307,989506,22
1271,30,9372,989505,989535,7
9987,94,9372,989535,989629,30
4463,265,9372,1443171,1443436,33
7728,154,9372,989846,990000,38
1240,131,9373,989999,990130,7
3786,234,9373,1443212,1443446,10
7248,34,9373,990353,990387,21
3062,42,9373,990387,990429,33
3350,241,9373,1443212,1443453,35
4997,206,9373,990663,990869,44
1116,77,9374,990868,990945,9
2569,23,9374,990945,990968,34
3571,33,9375,990967,991000,8
1631,69,9375,991000,991069,12
5336,3,9375,991069,991072,38
1599,82,9376,991071,991153,14
5928,211,9376,991153,991364,27
9534,39,9377,991363,991402,10
4507,76,9377,991402,991478,12
2982,246,9377,1443222,1443468,20
2823,213,9377,991705,991918,27
2584,191,9377,991918,992109,28
5072,44,9377,992109,992153,40
9264,65,9377,992153,992218,42
2504,103,9378,992217,992320,4
8770,224,9378,1443248,1443472,29
2830,143,9378,992539,992682,33
1966,252,9378,1443247,1443499,37
4681,33,9379,992906,992939,34
4967,89,9379,992939,993028,38
3669,174,9379,993028,993202,42
7339,176,9380,993201,993377,19
7246,55,9380,993377,993432,29
8644,266,9380,1443273,1443539,34
9552,111,9380,993656,993767,42
7783,76,9381,993766,993842,12
9008,172,9381,993842,994014,33
1178,83,9381,994014,994097,40
5532,151,9382,994096,994247,2
3616,280,9382,1473670,1473950,4
5811,238,9382,1443356,1443594,35
3780,175,9383,994701,994876,12
1571,136,9383,994876,995012,20
3418,190,9383,995012,995202,31
1009,30,9383,995202,995232,45
2871,61,9384,995231,995292,6
8206,157,9384,995292,995449,17
3751,211,9384,995449,995660,44
5263,30,9385,995659,995689,21
2835,57,9385,995689,995746,21
1207,196,9385,995746,995942,26
3500,189,9385,995942,996131,30
8951,37,9385,996131,996168,44
2259,8,9385,996168,996176,49
4437,31,9386,996175,996206,3
4119,108,9386,996206,996314,7
5100,37,9386,996314,996351,28
2658,47,9386,996351,996398,29
2764,284,9387,1473665,1473949,13
7583,205,9387,996625,996830,27
9465,73,9387,996830,996903,34
6613,222,9387,996903,997125,34
8454,123,9387,997125,997248,44
7979,166,9388,997247,997413,19
5586,23,9389,997412,997435,1
1186,10,9389,997435,997445,19
4543,278,9389,1473672,1473950,47
7074,121,9389,997664,997785,50
2761,223,9390,997784,998007,3
1051,16,9390,998007,998023,18
7594,14,9390,998023,998037,21
2156,153,9390,998037,998190,38
3155,188,9390,998190,998378,43
8403,192,9390,998378,998570,43
1769,10,9390,998570,998580,49
5475,170,9391,998579,998749,20
2783,19,9391,998749,998768,27
4346,292,9392,1473664,1473956,20
1846,107,9392,998994,999101,34
7785,285,9392,1473675,1473960,34
9209,147,9393,999324,999471,14
1989,283,9393,1473681,1473964,32
9452,208,9393,999692,999900,40
8573,124,9394,999899,1000023,5
9207,122,9394,1000023,1000145,18
3279,229,9394,1443633,1443862,20
8343,168,9394,1000372,1000540,36
8398,219,9394,1000540,1000759,37
7424,230,9394,1443636,1443866,38
6424,234,9394,1443644,1443878,40
1549,141,9394,1001207,1001348,48
5257,109,9394,1001348,1001457,50
1673,251,9395,1443655,1443906,18
6096,299,9395,1475608,1475907,39
6753,176,9396,1001900,1002076,12
1470,44,9396,1002076,1002120,15
1155,203,9396,1002120,1002323,32
7552,274,9396,1443745,1444019,46
9358,111,9396,1002543,1002654,47
9177,183,9397,1002653,1002836,2
7217,145,9397,1002836,1002981,16
1208,147,9397,1002981,1003128,26
6781,41,9397,1003128,1003169,36
5596,236,9397,1443788,1444024,36
3489,160,9397,1003399,1003559,45
4856,87,9398,1003558,1003645,1
5674,223,9398,1003645,1003868,13
8166,275,9398,1443808,1444083,19
7474,279,9398,1443859,1444138,21
3683,78,9398,1004307,1004385,31
8743,225,9398,1443921,1444146,33
7521,208,9399,1004601,1004809,20
3398,224,9399,1004809,1005033,36
7110,104,9399,1005033,1005137,38
2449,292,9399,1473690,1473982,48
8674,218,9400,1005359,1005577,4
6743,22,9400,1005577,1005599,11
6134,145,9400,1005599,1005744,16
7895,151,9400,1005744,1005895,17
2642,229,9400,1443975,1444204,37
1249,268,9400,1443978,1444246,38
1653,67,9400,1006346,1006413,40
9054,33,9400,1006413,1006446,42
5399,100,9400,1006446,1006546,47
3997,291,9401,1473701,1473992,8
5107,150,9401,1006762,1006912,17
3468,141,9402,1006911,1007052,10
5891,48,9402,1007052,1007100,19
6761,112,9402,1007100,1007212,26
4585,223,9402,1007212,1007435,45
6996,271,9403,1444081,1444352,34
8070,207,9403,1007658,1007865,38
7817,60,9403,1007865,1007925,42
4964,188,9403,1007925,1008113,49
1247,150,9404,1008112,1008262,11
3516,222,9404,1008262,1008484,35
3936,258,9404,1444125,1444383,38
7845,261,9404,1444160,1444421,43
8324,113,9405,1008932,1009045,8
5017,171,9405,1009045,1009216,36
4303,1,9406,1009215,1009216,5
2606,129,9406,1009216,1009345,19
2934,103,9407,1009344,1009447,7
4049,131,9407,1009447,1009578,23
6519,193,9407,1009578,1009771,31
4625,151,9407,1009771,1009922,40
6410,223,9408,1009921,1010144,20
6531,129,9408,1010144,1010273,27
8065,294,9408,1473707,1474001,33
2919,238,9408,1444255,1444493,39
1273,263,9409,1444258,1444521,35
3102,122,9411,1010944,1011066,1
2444,272,9411,1444294,1444566,2
5749,45,9411,1011291,1011336,6
8725,68,9411,1011336,1011404,7
9479,26,9411,1011404,1011430,19
2925,157,9411,1011430,1011587,23
3934,295,9411,1473717,1474012,36
9439,65,9411,1011817,1011882,43
7235,174,9411,1011882,1012056,44
9579,277,9411,1473737,1474014,47
6467,223,9412,1012274,1012497,1
9475,123,9413,1012496,1012619,32
7697,247,9413,1444446,1444693,37
2525,252,9413,1444474,1444726,47
2189,43,9413,1013063,1013106,50
5468,177,9414,1013105,1013282,29
6126,142,9415,1013281,1013423,26
9028,57,9415,1013423,1013480,32
2591,248,9415,1444490,1444738,35
5525,185,9415,1013714,1013899,40
5875,29,9415,1013899,1013928,46
4793,238,9416,1444522,1444760,19
5554,242,9417,1444536,1444778,10
9893,271,9417,1444555,1444826,27
1832,264,9417,1444592,1444856,35
1863,177,9417,1014821,1014998,50
5128,176,9418,1014997,1015173,2
9684,219,9418,1015173,1015392,11
5901,291,9418,1473725,1474016,17
7755,156,9418,1015616,1015772,28
8238,233,9418,1444693,1444926,46
2565,202,9419,1015991,1016193,2
7131,294,9419,1473732,1474026,20
8627,128,9419,1016420,1016548,24
5721,215,9419,1016548,1016763,50
9966,124,9420,1016762,1016886,10
4285,239,9420,1444756,1444995,11
1465,101,9420,1017110,1017211,13
8467,92,9420,1017211,1017303,22
1968,97,9420,1017303,1017400,35
7588,297,9421,1475750,1476047,8
8554,252,9421,1444841,1445093,19
7540,219,9421,1017831,1018050,25
1176,298,9421,1475590,1475888,26
1145,245,9421,1444925,1445170,27
8807,214,9421,1018497,1018711,44
4052,148,9422,1018710,1018858,1
6241,87,9422,1018858,1018945,2
8302,117,9422,1018945,1019062,12
6796,232,9422,1444954,1445186,19
7109,296,9422,1475592,1475888,21
8567,68,9422,1019501,1019569,43
6924,158,9423,1019568,1019726,6
3613,53,9423,1019726,1019779,14
6705,190,9423,1019779,1019969,19
8959,189,9423,1019969,1020158,23
6172,200,9423,1020158,1020358,25
9764,33,9423,1020358,1020391,28
3274,94,9423,1020391,1020485,35
4610,283,9424,1473784,1474067,11
2659,5,9424,1020708,1020713,28
9875,2,9424,1020713,1020715,47
9904,264,9425,1445074,1445338,7
7222,53,9425,1020936,1020989,9
9585,112,9425,1020989,1021101,23
1616,84,9425,1021101,1021185,29
6526,236,9426,1445115,1445351,7
9088,129,9426,1021406,1021535,14
8212,91,9426,1021535,1021626,34
3128,16,9426,1021626,1021642,35
6756,234,9426,1445131,1445365,42
5049,51,9427,1021861,1021912,44
4697,198,9429,1021910,1022108,25
9110,133,9429,1022108,1022241,47
7330,267,9430,1445136,1445403,1
5300,165,9430,1022465,1022630,22
2463,76,9431,1022629,1022705,9
8318,153,9431,1022705,1022858,12
2226,237,9431,1445182,1445419,15
3026,193,9431,1023078,1023271,48
5012,14,9432,1023270,1023284,1
6194,205,9432,1023284,1023489,4
5097,249,9432,1445197,1445446,4
1645,273,9432,1445218,1445491,13
5774,114,9432,1023938,1024052,16
8913,51,9432,1024052,1024103,26
6060,140,9432,1024103,1024243,35
6936,200,9432,1024243,1024443,42
9220,231,9432,1445268,1445499,43
8293,133,9433,1024665,1024798,10
9488,191,9433,1024798,1024989,10
2613,53,9433,1024989,1025042,14
4195,270,9433,1445273,1445543,23
3817,128,9433,1025267,1025395,27
5648,75,9433,1025395,1025470,28
6053,14,9434,1025469,1025483,8
9428,211,9434,1025483,1025694,11
7677,274,9434,1445317,1445591,14
1568,295,9434,1473775,1474070,44
9248,71,9434,1026141,1026212,50
8671,169,9434,1026212,1026381,50
3947,209,9435,1026380,1026589,8
8427,120,9435,1026589,1026709,39
1219,109,9435,1026709,1026818,43
1758,176,9435,1026818,1026994,46
7233,37,9436,1026993,1027030,28
4375,275,9436,1445429,1445704,28
2647,8,9436,1027250,1027258,42
1793,13,9436,1027258,1027271,48
9404,182,9437,1027270,1027452,49
6720,74,9438,1027451,1027525,2
8706,266,9438,1445482,1445748,15
5884,35,9438,1027745,1027780,27
3151,93,9438,1027780,1027873,28
7040,239,9438,1445531,1445770,33
9991,71,9438,1028090,1028161,37
2980,152,9438,1028161,1028313,39
7482,280,9438,1445548,1445828,44
7811,155,9440,1028533,1028688,17
3369,215,9441,1028687,1028902,25
2412,95,9441,1028902,1028997,36
8353,95,9441,1028997,1029092,43
7788,295,9442,1473781,1474076,3
5284,298,9442,1475729,1476027,5
7963,75,9442,1029536,1029611,15
9795,229,9442,1445717,1445946,21
3546,105,9443,1029834,1029939,2
6610,18,9443,1029939,1029957,9
2165,240,9443,1445720,1445960,14
8352,11,9443,1030182,1030193,15
3675,228,9443,1445733,1445961,20
3191,229,9443,1445742,1445971,24
1226,103,9443,1030639,1030742,32
6863,178,9443,1030742,1030920,34
9618,120,9444,1030919,1031039,4
6643,201,9444,1031039,1031240,11
9396,164,9444,1031240,1031404,37
3022,181,9444,1031404,1031585,39
8994,192,9444,1031585,1031777,43
6893,272,9444,1445751,1446023,47
4536,200,9445,1031995,1032195,6
8041,180,9445,1032195,1032375,8
1094,275,9445,1445805,1446080,8
7403,248,9445,1445861,1446109,25
7140,169,9445,1032811,1032980,47
8557,265,9445,1445890,1446155,47
5874,239,9446,1445940,1446179,22
7908,179,9446,1033412,1033591,34
9221,242,9446,1445954,1446196,41
5551,256,9447,1445969,1446225,30
9007,11,9447,1034041,1034052,38
2145,243,9447,1446006,1446249,47
6233,83,9448,1034270,1034353,2
8289,250,9448,1446021,1446271,16
3283,136,9448,1034580,1034716,40
7446,205,9448,1034716,1034921,50
2451,116,9449,1034920,1035036,1
3254,26,9449,1035036,1035062,14
8477,280,9449,1473802,1474082,48
8085,150,9450,1035284,1035434,28
3515,112,9450,1035434,1035546,47
1759,249,9451,1446099,1446348,14
4648,91,9451,1035770,1035861,47
3040,115,9452,1035860,1035975,1
8985,146,9452,1035975,1036121,8
7861,22,9452,1036121,1036143,22
8162,235,9452,1446128,1446363,24
8052,138,9452,1036362,1036500,34
4374,181,9452,1036500,1036681,35
3859,260,9452,1446137,1446397,38
7419,266,9453,1446181,1446447,19
3512,20,9453,1037121,1037141,50
2065,56,9454,1037140,1037196,29
6000,138,9454,1037196,1037334,36
1722,256,9454,1446221,1446477,37
3504,99,9454,1037559,1037658,46
8665,2,9455,1037657,1037659,4
4403,214,9455,1037659,1037873,38
5714,226,9455,1446256,1446482,42
5096,271,9456,1446259,1446530,5
5827,224,9456,1446313,1446537,8
5111,163,9456,1038531,1038694,9
3054,239,9456,1446309,1446548,13
8127,38,9456,1038922,1038960,19
5611,102,9456,1038960,1039062,25
8604,46,9456,1039062,1039108,28
2137,227,9456,1446324,1446551,45
9451,4,9457,1039331,1039335,20
6812,41,9457,1039335,1039376,30
6108,287,9457,1473798,1474085,42
7269,121,9458,1039595,1039716,11
4075,61,9458,1039716,1039777,13
6758,111,9458,1039777,1039888,16
6612,129,9458,1039888,1040017,23
9589,89,9458,1040017,1040106,49
1019,257,9459,1446379,1446636,23
3185,200,9459,1040330,1040530,34
4885,275,9459,1446406,1446681,36
9164,221,9459,1040760,1040981,38
7397,73,9460,1040980,1041053,29
3075,226,9460,1446456,1446682,34
8897,9,9460,1041277,1041286,42
4666,5,9460,1041286,1041291,49
7124,36,9461,1041290,1041326,6
5132,241,9461,1446453,1446694,31
1064,154,9462,1041553,1041707,3
4480,2,9462,1041707,1041709,15
6124,192,9462,1041709,1041901,23
8379,40,9463,1041900,1041940,2
1043,10,9463,1041940,1041950,16
4544,71,9463,1041950,1042021,23
9481,26,9463,1042021,1042047,24
4094,27,9463,1042047,1042074,31
4386,104,9463,1042074,1042178,48
2038,242,9464,1446470,1446712,4
7597,106,9464,1042398,1042504,16
2590,156,9464,1042504,1042660,23
9661,258,9465,1446483,1446741,13
1592,180,9465,1042887,1043067,16
7000,114,9465,1043067,1043181,37
6266,171,9465,1043181,1043352,41
7266,172,9466,1043351,1043523,2
7805,231,9466,1446516,1446747,26
1364,12,9466,1043747,1043759,40
9884,128,9467,1043758,1043886,9
1730,281,9467,1473800,1474081,47
2425,170,9468,1044104,1044274,36
3550,80,9468,1044274,1044354,47
3349,116,9469,1044353,1044469,4
7751,99,9469,1044469,1044568,5
2769,118,9469,1044568,1044686,7
5672,175,9469,1044686,1044861,33
6592,67,9469,1044861,1044928,47
4650,17,9469,1044928,1044945,48
2780,242,9470,1446576,1446818,10
7023,164,9470,1045167,1045331,15
6319,25,9470,1045331,1045356,27
6204,223,9470,1446596,1446819,44
3452,261,9470,1446597,1446858,49
9870,233,9470,1446635,1446868,50
1664,173,9471,1046022,1046195,7
9980,60,9471,1046195,1046255,26
3086,186,9471,1046255,1046441,35
4315,274,9471,1446642,1446916,41
8592,7,9472,1046665,1046672,6
6450,111,9472,1046672,1046783,7
3736,55,9472,1046783,1046838,8
9709,102,9472,1046838,1046940,42
5947,108,9472,1046940,1047048,43
5278,234,9473,1446697,1446931,8
9259,94,9473,1047264,1047358,16
7906,210,9473,1047358,1047568,16
9590,208,9473,1047568,1047776,28
9235,45,9473,1047776,1047821,33
4425,2,9474,1047820,1047822,32
6708,148,9474,1047822,1047970,32
2318,174,9474,1047970,1048144,35
4127,256,9474,1446704,1446960,38
6146,234,9474,1446737,1446971,43
3065,182,9474,1048593,1048775,47
6524,101,9475,1048774,1048875,2
9605,71,9475,1048875,1048946,11
8043,248,9475,1446743,1446991,16
8300,61,9476,1049172,1049233,9
9348,113,9476,1049233,1049346,22
4899,51,9476,1049346,1049397,27
2032,165,9476,1049397,1049562,47
3017,2,9478,1049560,1049562,1
7472,113,9478,1049562,1049675,5
6790,293,9478,1473791,1474084,15
4981,272,9478,1446825,1447097,18
3953,176,9478,1050117,1050293,33
4163,117,9479,1050292,1050409,18
1905,120,9479,1050409,1050529,20
6898,81,9479,1050529,1050610,21
3704,183,9480,1050609,1050792,22
3761,124,9480,1050792,1050916,27
9547,102,9480,1050916,1051018,33
6363,62,9480,1051018,1051080,37
6902,72,9480,1051080,1051152,42
8826,204,9480,1051152,1051356,45
3927,297,9480,1475538,1475835,45
4880,76,9481,1051579,1051655,32
8602,231,9481,1446926,1447157,41
3643,54,9482,1051879,1051933,6
4694,243,9482,1446929,1447172,16
2009,34,9482,1052160,1052194,19
3533,117,9482,1052194,1052311,29
7550,61,9482,1052311,1052372,31
9519,102,9482,1052372,1052474,41
5896,224,9482,1052474,1052698,45
5222,255,9483,1446949,1447204,5
3371,252,9483,1446977,1447229,20
2346,258,9483,1447006,1447264,27
8719,286,9483,1473813,1474099,34
2674,41,9483,1053593,1053634,40
4383,158,9483,1053634,1053792,44
4500,204,9484,1053791,1053995,12
6352,238,9484,1447095,1447333,41
2019,174,9485,1054219,1054393,2
1414,35,9485,1054393,1054428,25
4562,209,9485,1054428,1054637,31
6055,5,9486,1054636,1054641,11
6402,125,9486,1054641,1054766,27
5361,69,9486,1054766,1054835,48
1406,242,9487,1447107,1447349,3
4101,263,9487,1447125,1447388,17
5436,261,9487,1447165,1447426,27
7143,93,9487,1055504,1055597,33
3611,282,9487,1473817,1474099,33
4802,96,9487,1055814,1055910,44
5763,158,9488,1055909,1056067,24
9867,70,9488,1056067,1056137,30
9947,224,9488,1447265,1447489,32
1932,202,9488,1056358,1056560,36
8044,285,9488,1473816,1474101,43
5769,140,9489,1056782,1056922,11
5516,226,9489,1447325,1447551,18
8101,218,9490,1057143,1057361,36
9276,88,9491,1057360,1057448,15
2210,15,9492,1057447,1057462,1
6700,283,9492,1473823,1474106,4
8869,142,9492,1057683,1057825,10
1808,50,9492,1057825,1057875,16
5015,136,9492,1057875,1058011,16
5207,38,9492,1058011,1058049,18
7645,256,9492,1447386,1447642,19
5371,207,9492,1058264,1058471,38
8313,230,9492,1447420,1447650,40
3255,255,9492,1447428,1447683,44
7169,172,9493,1058914,1059086,20
5339,242,9493,1447457,1447699,23
6306,175,9493,1059311,1059486,38
8597,243,9493,1447476,1447719,48
9040,219,9494,1059708,1059927,1
5321,145,9494,1059927,1060072,7
2230,212,9494,1060072,1060284,8
5325,56,9494,1060284,1060340,11
7039,62,9494,1060340,1060402,17
6711,128,9494,1060402,1060530,34
5238,71,9494,1060530,1060601,36
4002,53,9494,1060601,1060654,38
9810,78,9495,1060653,1060731,9
3042,242,9495,1447503,1447745,22
8116,189,9495,1060945,1061134,23
9258,80,9495,1061134,1061214,42
3252,171,9496,1061213,1061384,2
1233,161,9496,1061384,1061545,3
7469,11,9496,1061545,1061556,4
4215,292,9496,1473825,1474117,10
7079,112,9496,1061779,1061891,15
4791,28,9496,1061891,1061919,17
9309,30,9496,1061919,1061949,18
2931,26,9496,1061949,1061975,22
9511,63,9496,1061975,1062038,29
3887,139,9496,1062038,1062177,30
4413,6,9496,1062177,1062183,36
6331,272,9496,1447579,1447851,47
5717,281,9497,1447625,1447906,1
1375,183,9497,1062626,1062809,9
6007,205,9497,1062809,1063014,22
2971,191,9497,1063014,1063205,32
9723,78,9497,1063205,1063283,34
9316,219,9497,1063283,1063502,42
4567,230,9498,1447682,1447912,10
5129,295,9498,1473832,1474127,25
5089,62,9498,1063943,1064005,36
6964,146,9498,1064005,1064151,46
8881,245,9499,1447753,1447998,6
8132,218,9499,1064372,1064590,49
5083,268,9499,1447776,1448044,49
7153,45,9500,1064811,1064856,7
6041,147,9500,1064856,1065003,11
9907,54,9501,1065002,1065056,8
2096,261,9501,1447822,1448083,15
2143,66,9501,1065276,1065342,28
2706,173,9501,1065342,1065515,33
4078,210,9501,1065515,1065725,35
4513,281,9502,1447857,1448138,2
3555,44,9502,1065949,1065993,26
7907,51,9502,1065993,1066044,36
8800,132,9503,1066043,1066175,16
3088,20,9503,1066175,1066195,30
7885,142,9503,1066195,1066337,31
5787,183,9503,1066337,1066520,41
8744,132,9503,1066520,1066652,46
1820,3,9503,1066652,1066655,48
5641,28,9504,1066654,1066682,15
8523,122,9504,1066682,1066804,39
4644,245,9504,1447913,1448158,50
1335,270,9505,1447934,1448204,10
2261,67,9505,1067249,1067316,29
8977,183,9505,1067316,1067499,34
5345,294,9505,1473839,1474133,34
9159,211,9505,1067723,1067934,37
5204,110,9505,1067934,1068044,44
7662,87,9506,1068043,1068130,6
2524,136,9506,1068130,1068266,22
9455,60,9506,1068266,1068326,38
7385,231,9506,1448038,1448269,44
1185,92,9507,1068547,1068639,33
6104,196,9507,1068639,1068835,39
2628,146,9507,1068835,1068981,46
2929,211,9508,1068980,1069191,5
1229,7,9508,1069191,1069198,24
5798,188,9508,1069198,1069386,37
8301,57,9509,1069385,1069442,3
7884,166,9509,1069442,1069608,5
8404,26,9509,1069608,1069634,8
2542,4,9509,1069634,1069638,12
9487,271,9509,1448039,1448310,16
4238,99,9509,1069865,1069964,30
8574,45,9509,1069964,1070009,36
6521,80,9509,1070009,1070089,45
9241,203,9510,1070088,1070291,12
1322,220,9510,1070291,1070511,31
1757,250,9510,1448092,1448342,33
7158,245,9510,1448118,1448363,45
2184,114,9510,1070952,1071066,47
8466,239,9511,1448141,1448380,4
9778,30,9511,1071286,1071316,10
8699,225,9511,1448157,1448382,27
8593,243,9511,1448160,1448403,49
1629,245,9512,1448178,1448423,11
9693,249,9512,1448204,1448453,25
7617,37,9512,1072203,1072240,44
6258,153,9513,1072239,1072392,38
7015,94,9513,1072392,1072486,43
2097,137,9513,1072486,1072623,46
3295,106,9514,1072622,1072728,1
1715,107,9514,1072728,1072835,12
4991,5,9514,1072835,1072840,23
1034,30,9515,1072839,1072869,9
8475,153,9515,1072869,1073022,21
4046,255,9515,1448231,1448486,29
8228,230,9515,1448260,1448490,30
9083,224,9515,1073467,1073691,45
2250,52,9516,1073690,1073742,4
2994,8,9516,1073742,1073750,6
9314,298,9516,1475656,1475954,7
1359,141,9516,1073972,1074113,14
2164,64,9516,1074113,1074177,29
3541,260,9516,1448320,1448580,30
9508,51,9516,1074403,1074454,50
1655,62,9517,1074453,1074515,20
9503,14,9517,1074515,1074529,21
6393,182,9517,1074529,1074711,34
2516,267,9517,1448345,1448612,35
4717,98,9517,1074945,1075043,36
8533,105,9517,1075043,1075148,42
4212,102,9518,1075147,1075249,7
8420,46,9518,1075249,1075295,16
8402,295,9518,1475505,1475800,38
8016,183,9519,1075520,1075703,23
4998,256,9519,1448441,1448697,26
2732,296,9519,1473867,1474163,31
1584,294,9519,1473887,1474181,42
6702,148,9519,1076375,1076523,47
3826,218,9520,1076522,1076740,1
8495,12,9520,1076740,1076752,7
3837,201,9520,1076752,1076953,15
6225,87,9520,1076953,1077040,27
6663,159,9520,1077040,1077199,48
1684,56,9521,1077198,1077254,4
6063,95,9521,1077254,1077349,31
9969,232,9521,1077349,1077581,35
1468,171,9521,1077581,1077752,41
2378,29,9522,1077751,1077780,20
7063,188,9522,1077780,1077968,26
7901,290,9522,1473897,1474187,30
9770,72,9522,1078194,1078266,39
5243,137,9522,1078266,1078403,41
4563,218,9522,1078403,1078621,42
1641,256,9522,1448635,1448891,48
8430,39,9523,1078843,1078882,4
9512,68,9523,1078882,1078950,22
4531,134,9523,1078950,1079084,25
3135,34,9523,1079084,1079118,36
3783,194,9523,1079118,1079312,38
1135,176,9523,1079312,1079488,41
9510,206,9524,1079487,1079693,9
5443,251,9524,1448669,1448920,28
8222,134,9524,1079913,1080047,29
9509,31,9524,1080047,1080078,38
3623,53,9524,1080078,1080131,47
1800,147,9524,1080131,1080278,50
1632,147,9525,1080277,1080424,5
3194,125,9525,1080424,1080549,27
6950,45,9525,1080549,1080594,32
2461,288,9525,1473903,1474191,36
4090,131,9526,1080823,1080954,22
4558,63,9527,1080953,1081016,19
1502,274,9527,1448741,1449015,20
9803,237,9527,1448796,1449033,24
7295,269,9527,1448809,1449078,26
1328,10,9527,1081686,1081696,30
4345,292,9527,1473907,1474199,46
1970,300,9528,1475643,1475943,11
5765,233,9528,1448971,1449204,18
7309,173,9528,1082361,1082534,27
9085,37,9528,1082534,1082571,34
5695,71,9528,1082571,1082642,46
1045,124,9528,1082642,1082766,46
1153,253,9528,1448984,1449237,46
5144,199,9529,1082985,1083184,3
2081,265,9529,1449019,1449284,8
5429,23,9529,1083401,1083424,11
5267,111,9529,1083424,1083535,16
4362,64,9529,1083535,1083599,23
5916,98,9529,1083599,1083697,26
2996,219,9529,1083697,1083916,32
3800,180,9529,1083916,1084096,40
3692,185,9530,1084095,1084280,5
1444,75,9530,1084280,1084355,44
5348,282,9530,1473931,1474213,49
8194,168,9531,1084576,1084744,1
4018,284,9531,1473929,1474213,28
6940,206,9531,1084964,1085170,35
6986,211,9531,1085170,1085381,35
2751,257,9531,1449172,1449429,36
2457,240,9531,1449203,1449443,38
6090,297,9531,1475499,1475796,41
4457,186,9532,1086061,1086247,19
6097,29,9532,1086247,1086276,45
8108,148,9533,1086275,1086423,25
6505,192,9533,1086423,1086615,50
9464,9,9534,1086614,1086623,1
4781,273,9534,1449277,1449550,6
7762,194,9534,1086845,1087039,25
9405,158,9534,1087039,1087197,28
5334,37,9535,1087196,1087233,26
4551,292,9535,1473942,1474234,32
3697,293,9535,1473951,1474244,39
2614,293,9535,1473964,1474257,40
2759,70,9535,1087899,1087969,46
8030,282,9535,1473982,1474264,47
2491,43,9536,1088187,1088230,4
6321,287,9536,1473984,1474271,26
8157,29,9536,1088454,1088483,29
9286,178,9536,1088483,1088661,36
1316,48,9536,1088661,1088709,46
8202,104,9537,1088708,1088812,3
9734,29,9537,1088812,1088841,37
8224,276,9538,1449609,1449885,3
8384,224,9538,1449664,1449888,4
1458,237,9538,1449660,1449897,13
3012,240,9538,1449677,1449917,28
5681,3,9538,1089732,1089735,33
3134,31,9538,1089735,1089766,33
9324,121,9539,1089765,1089886,23
3276,104,9539,1089886,1089990,36
9887,262,9539,1449694,1449956,40
3977,278,9539,1449733,1450011,43
7113,178,9539,1090435,1090613,45
6486,60,9539,1090613,1090673,50
7320,181,9540,1090672,1090853,1
4201,120,9540,1090853,1090973,16
8270,256,9540,1449780,1450036,36
6221,204,9541,1091202,1091406,14
5904,260,9541,1449811,1450071,26
9387,194,9541,1091630,1091824,28
9453,230,9541,1091824,1092054,36
9408,4,9541,1092054,1092058,37
1651,228,9541,1449845,1450073,38
6058,138,9542,1092283,1092421,8
8773,154,9542,1092421,1092575,21
7889,103,9542,1092575,1092678,24
4001,94,9542,1092678,1092772,28
8822,102,9542,1092772,1092874,50
7362,231,9543,1449848,1450079,3
1119,93,9543,1093096,1093189,15
4462,211,9543,1093189,1093400,16
2398,211,9543,1093400,1093611,18
9353,80,9543,1093611,1093691,22
5503,199,9543,1093691,1093890,29
1010,23,9543,1093890,1093913,31
8039,152,9543,1093913,1094065,33
6377,186,9543,1094065,1094251,35
8009,287,9543,1473981,1474268,39
8704,211,9544,1094473,1094684,12
3560,218,9544,1094684,1094902,24
8031,177,9544,1094902,1095079,30
6448,227,9544,1449914,1450141,34
4873,27,9544,1095303,1095330,38
4418,122,9545,1095329,1095451,24
6054,99,9546,1095450,1095549,3
4794,178,9546,1095549,1095727,13
8063,138,9546,1095727,1095865,21
9753,205,9546,1095865,1096070,30
3244,138,9547,1096069,1096207,29
4716,79,9547,1096207,1096286,44
7539,288,9547,1473983,1474271,45
6327,221,9548,1096509,1096730,4
3332,13,9548,1096730,1096743,7
9077,202,9548,1096743,1096945,24
3476,135,9548,1096945,1097080,31
5484,201,9549,1097079,1097280,12
6830,103,9549,1097280,1097383,23
4857,268,9549,1449967,1450235,30
7174,14,9549,1097609,1097623,49
5887,193,9550,1097622,1097815,3
5692,196,9550,1097815,1098011,17
6751,81,9550,1098011,1098092,18
1838,54,9550,1098092,1098146,21
9816,70,9550,1098146,1098216,28
8284,159,9550,1098216,1098375,39
5357,95,9550,1098375,1098470,41
1644,106,9550,1098470,1098576,43
1381,118,9550,1098576,1098694,49
4226,280,9551,1450008,1450288,14
6302,47,9551,1098918,1098965,20
2551,94,9551,1098965,1099059,21
6417,193,9551,1099059,1099252,27
4491,72,9552,1099251,1099323,7
8939,150,9552,1099323,1099473,18
4600,210,9552,1099473,1099683,18
1976,208,9552,1099683,1099891,39
5084,6,9553,1099890,1099896,3
8646,70,9553,1099896,1099966,39
8147,282,9553,1450061,1450343,41
8941,188,9554,1100190,1100378,2
2740,3,9554,1100378,1100381,27
3446,91,9554,1100381,1100472,29
1093,95,9554,1100472,1100567,44
6478,24,9555,1100566,1100590,11
1224,215,9555,1100590,1100805,13
1663,12,9555,1100805,1100817,15
5557,157,9555,1100817,1100974,15
4320,177,9555,1100974,1101151,16
3954,206,9555,1101151,1101357,18
1076,161,9555,1101357,1101518,26
6388,260,9556,1450115,1450375,1
2723,84,9556,1101742,1101826,3
7133,154,9556,1101826,1101980,5
6182,14,9556,1101980,1101994,10
2069,179,9556,1101994,1102173,22
1818,204,9556,1102173,1102377,37
9923,127,9556,1102377,1102504,40
1008,87,9557,1102503,1102590,5
5968,51,9557,1102590,1102641,9
5683,245,9557,1450160,1450405,22
9540,91,9557,1102855,1102946,39
7640,189,9557,1102946,1103135,42
9564,260,9557,1450183,1450443,49
4837,202,9558,1103356,1103558,16
1198,272,9558,1450223,1450495,29
2447,258,9558,1450271,1450529,45
4040,159,9558,1104001,1104160,50
4855,220,9559,1104159,1104379,14
3367,158,9559,1104379,1104537,33
5127,244,9559,1450305,1450549,50
4371,125,9560,1104759,1104884,10
3462,231,9560,1450321,1450552,16
2253,102,9560,1105111,1105213,18
4571,145,9560,1105213,1105358,18
6383,146,9560,1105358,1105504,28
9996,292,9561,1473974,1474266,39
4286,151,9561,1105726,1105877,50
9097,67,9562,1105876,1105943,12
7561,196,9562,1105943,1106139,23
7730,56,9563,1106138,1106194,14
9932,180,9563,1106194,1106374,17
8096,205,9563,1106374,1106579,21
5962,181,9563,1106579,1106760,29
6554,32,9563,1106760,1106792,49
2766,93,9564,1106791,1106884,3
8243,250,9564,1450382,1450632,30
4635,143,9564,1107110,1107253,36
4419,203,9565,1107252,1107455,20
2747,35,9565,1107455,1107490,30
3444,110,9565,1107490,1107600,32
8833,2,9565,1107600,1107602,35
2893,122,9565,1107602,1107724,39
5170,75,9565,1107724,1107799,44
1456,121,9565,1107799,1107920,44
9741,35,9566,1107919,1107954,3
5640,5,9566,1107954,1107959,19
3213,16,9566,1107959,1107975,22
8983,31,9566,1107975,1108006,33
5994,244,9566,1450413,1450657,33
9175,218,9567,1108222,1108440,11
7392,235,9567,1450433,1450668,12
6003,123,9567,1108663,1108786,13
5023,291,9567,1473977,1474268,21
2108,38,9567,1109010,1109048,22
8135,264,9567,1450502,1450766,23
8516,42,9568,1109272,1109314,2
2503,181,9568,1109314,1109495,7
5957,266,9568,1450543,1450809,7
5319,12,9568,1109717,1109729,24
5007,248,9568,1450590,1450838,29
4180,89,9568,1109948,1110037,33
6828,291,9568,1473983,1474274,35
5062,62,9569,1110270,1110332,25
8400,141,9569,1110332,1110473,26
6684,49,9569,1110473,1110522,37
8510,150,9569,1110522,1110672,43
7062,109,9569,1110672,1110781,48
9506,230,9570,1450665,1450895,4
1543,159,9570,1111001,1111160,14
2639,190,9571,1111159,1111349,17
6482,183,9571,1111349,1111532,23
3824,286,9571,1473992,1474278,26
7436,280,9571,1474003,1474283,47
7328,105,9571,1111975,1112080,48
4514,253,9572,1450781,1451034,10
3492,38,9572,1112302,1112340,37
9873,207,9572,1112340,1112547,47
6071,128,9573,1112546,1112674,13
8338,94,9573,1112674,1112768,24
1580,200,9573,1112768,1112968,26
3722,48,9573,1112968,1113016,35
3171,14,9574,1113015,1113029,10
6455,166,9574,1113029,1113195,13
8504,108,9574,1113195,1113303,30
9935,45,9574,1113303,1113348,32
5430,64,9574,1113348,1113412,47
6818,223,9575,1113411,1113634,11
1601,29,9575,1113634,1113663,25
7444,136,9575,1113663,1113799,39
4447,39,9575,1113799,1113838,40
6216,109,9575,1113838,1113947,44
7691,15,9576,1113946,1113961,9
1242,240,9576,1450807,1451047,10
5971,274,9576,1450827,1451101,15
6372,66,9576,1114404,1114470,21
4735,113,9576,1114470,1114583,23
8924,272,9576,1450882,1451154,29
9906,206,9576,1114802,1115008,32
5700,93,9576,1115008,1115101,38
2523,264,9577,1450932,1451196,4
5604,122,9577,1115321,1115443,9
2876,33,9577,1115443,1115476,12
6212,138,9577,1115476,1115614,12
5244,153,9577,1115614,1115767,19
5253,192,9577,1115767,1115959,20
5972,23,9577,1115959,1115982,41
4185,61,9578,1115981,1116042,3
2406,18,9578,1116042,1116060,6
1448,273,9578,1450961,1451234,35
7156,283,9578,1451011,1451294,39
4062,2,9579,1116516,1116518,13
1963,286,9579,1473994,1474280,24
7037,172,9579,1116737,1116909,42
4451,266,9579,1451132,1451398,43
7880,252,9579,1451175,1451427,48
1822,11,9580,1117354,1117365,10
3031,204,9580,1117365,1117569,45
8958,45,9581,1117568,1117613,23
8274,131,9581,1117613,1117744,41
2323,144,9582,1117743,1117887,2
3543,174,9582,1117887,1118061,7
2641,181,9582,1118061,1118242,26
6901,53,9582,1118242,1118295,27
8312,126,9582,1118295,1118421,41
1159,259,9583,1451204,1451463,25
9250,156,9583,1118639,1118795,29
4272,56,9583,1118795,1118851,36
7022,137,9583,1118851,1118988,46
3756,19,9584,1118987,1119006,3
6165,164,9584,1119006,1119170,4
1810,49,9584,1119170,1119219,9
2338,294,9584,1475450,1475744,9
7449,141,9584,1119437,1119578,10
3386,168,9584,1119578,1119746,39
4381,173,9584,1119746,1119919,39
4780,164,9585,1119918,1120082,3
4469,179,9585,1120082,1120261,27
3107,257,9585,1451296,1451553,48
5951,232,9586,1451330,1451562,5
9004,65,9586,1120705,1120770,8
2094,289,9586,1474011,1474300,15
1337,163,9586,1120990,1121153,20
7081,143,9586,1121153,1121296,21
9859,66,9586,1121296,1121362,39
7657,54,9586,1121362,1121416,50
8912,239,9587,1451398,1451637,7
8368,191,9587,1121637,1121828,9
3431,282,9587,1474022,1474304,10
4561,289,9587,1474020,1474309,14
7813,67,9587,1122276,1122343,27
1849,98,9588,1122342,1122440,1
2936,71,9588,1122440,1122511,28
5025,207,9589,1122510,1122717,19
4800,221,9589,1451534,1451755,22
8458,160,9589,1122931,1123091,24
4790,89,9589,1123091,1123180,42
4587,297,9590,1475442,1475739,1
4225,108,9590,1123404,1123512,11
1772,189,9590,1123512,1123701,11
3296,300,9590,1475583,1475883,19
3544,267,9590,1451649,1451916,23
2315,268,9590,1451692,1451960,26
4251,265,9590,1451737,1452002,43
3009,109,9590,1124588,1124697,44
6652,63,9590,1124697,1124760,49
9728,1,9591,1124759,1124760,5
3742,163,9591,1124760,1124923,9
1773,188,9591,1124923,1125111,18
4557,271,9591,1451775,1452046,38
5684,47,9591,1125337,1125384,50
7210,66,9592,1125383,1125449,15
2807,28,9592,1125449,1125477,16
6706,41,9592,1125477,1125518,20
1841,141,9592,1125518,1125659,22
4084,40,9592,1125659,1125699,27
4405,195,9592,1125699,1125894,32
9920,274,9592,1451819,1452093,38
2074,227,9593,1451867,1452094,1
6892,219,9593,1126344,1126563,16
5627,76,9593,1126563,1126639,37
8040,150,9593,1126639,1126789,38
8064,205,9593,1126789,1126994,42
1538,220,9594,1126993,1127213,6
2975,270,9594,1451871,1452141,6
4994,30,9594,1127435,1127465,13
8092,33,9594,1127465,1127498,26
4196,138,9594,1127498,1127636,43
8295,133,9595,1127635,1127768,3
5961,239,9595,1451926,1452165,22
3168,148,9595,1127982,1128130,31
4951,74,9596,1128129,1128203,4
7532,61,9596,1128203,1128264,12
3918,227,9596,1451944,1452171,15
2560,241,9596,1451957,1452198,22
1741,89,9596,1128698,1128787,32
1491,123,9596,1128787,1128910,34
1023,115,9596,1128910,1129025,39
9591,12,9597,1129024,1129036,7
4952,243,9597,1451983,1452226,22
9558,25,9597,1129250,1129275,23
9237,257,9597,1452003,1452260,39
5051,152,9598,1129497,1129649,9
5230,26,9598,1129649,1129675,21
1235,125,9598,1129675,1129800,27
2193,26,9598,1129800,1129826,28
5438,169,9598,1129826,1129995,32
5652,140,9598,1129995,1130135,37
2983,218,9599,1130134,1130352,3
3337,18,9599,1130352,1130370,14
2331,200,9599,1130370,1130570,15
2622,143,9599,1130570,1130713,20
4859,214,9599,1130713,1130927,29
5764,145,9599,1130927,1131072,33
6509,295,9599,1474046,1474341,45
1847,125,9600,1131295,1131420,34
3785,293,9600,1474058,1474351,46
7308,85,9601,1131639,1131724,9
7835,48,9601,1131724,1131772,19
5247,186,9601,1131772,1131958,24
9312,2,9601,1131958,1131960,34
8662,22,9601,1131960,1131982,48
1834,83,9601,1131982,1132065,49
7365,173,9602,1132064,1132237,3
3316,75,9602,1132237,1132312,5
9729,239,9603,1452151,1452390,6
3739,135,9603,1132533,1132668,11
1113,184,9603,1132668,1132852,17
5080,166,9603,1132852,1133018,48
7925,195,9603,1133018,1133213,50
8784,153,9604,1133212,1133365,5
8850,237,9604,1452165,1452402,17
7452,155,9604,1133589,1133744,29
4643,211,9604,1133744,1133955,35
3078,55,9604,1133955,1134010,36
8077,270,9604,1452179,1452449,50
2637,31,9605,1134232,1134263,48
8615,80,9606,1134485,1134565,47
3123,287,9605,1474067,1474354,48
6651,122,9606,1134565,1134687,48
2883,40,9606,1134687,1134727,50
3149,255,9607,1452278,1452533,11
7547,206,9607,1134950,1135156,12
2490,119,9607,1135156,1135275,24
9376,15,9607,1135275,1135290,29
9361,98,9607,1135290,1135388,38
4919,116,9607,1135388,1135504,46
8889,292,9608,1474073,1474365,11
3552,262,9608,1452362,1452624,34
3931,216,9609,1135950,1136166,1
7559,38,9609,1136166,1136204,17
9021,172,9609,1136204,1136376,26
3268,77,9609,1136376,1136453,41
2270,36,9610,1136452,1136488,23
8877,130,9610,1136488,1136618,24
3163,10,9610,1136618,1136628,33
4845,167,9610,1136628,1136795,33
5022,231,9611,1452400,1452631,4
8998,246,9611,1452407,1452653,11
2100,164,9611,1137239,1137403,28
4295,251,9611,1452425,1452676,31
3441,119,9611,1137631,1137750,37
6129,189,9611,1137750,1137939,39
1985,88,9612,1137938,1138026,32
4421,299,9612,1475563,1475862,42
9102,102,9612,1138246,1138348,50
1466,140,9613,1138347,1138487,15
9730,179,9613,1138487,1138666,24
7386,78,9613,1138666,1138744,46
9899,274,9613,1452507,1452781,48
8916,154,9614,1138966,1139120,4
8048,156,9614,1139120,1139276,5
9234,175,9614,1139276,1139451,8
2689,142,9614,1139451,1139593,11
9930,264,9614,1452565,1452829,19
8286,8,9614,1139808,1139816,30
6355,110,9614,1139816,1139926,30
4341,100,9614,1139926,1140026,42
9093,150,9615,1140025,1140175,5
9197,212,9615,1140175,1140387,5
7468,232,9615,1452610,1452842,9
4110,228,9615,1452618,1452846,26
4108,199,9616,1140828,1141027,14
8867,122,9616,1141027,1141149,21
9572,282,9616,1474095,1474377,34
5181,123,9616,1141373,1141496,36
9238,121,9616,1141496,1141617,39
8444,147,9616,1141617,1141764,43
3755,258,9617,1452676,1452934,2
2101,288,9617,1474097,1474385,7
2635,46,9617,1142210,1142256,15
8363,237,9617,1452767,1453004,17
1946,81,9617,1142480,1142561,28
3320,37,9617,1142561,1142598,29
5701,116,9617,1142598,1142714,36
6271,78,9617,1142714,1142792,43
3828,110,9619,1142790,1142900,39
3491,218,9619,1142900,1143118,43
2836,17,9619,1143118,1143135,45
3587,226,9620,1452787,1453013,22
9031,162,9620,1143348,1143510,23
6066,225,9620,1452790,1453015,39
8636,15,9620,1143733,1143748,48
3292,206,9621,1143747,1143953,3
1253,154,9621,1143953,1144107,6
7334,31,9621,1144107,1144138,48
8190,265,9622,1452788,1453053,1
3351,186,9622,1144362,1144548,6
5713,234,9622,1452831,1453065,6
8607,112,9622,1144770,1144882,23
5894,268,9622,1452842,1453110,39
6889,81,9622,1145105,1145186,43
7875,89,9623,1145185,1145274,19
1879,106,9623,1145274,1145380,20
5076,297,9623,1475418,1475715,24
1671,48,9624,1145598,1145646,1
9343,282,9624,1452945,1453227,14
7606,41,9624,1145871,1145912,18
4789,247,9624,1453008,1453255,24
7709,169,9624,1146131,1146300,44
5830,212,9624,1146300,1146512,47
6166,78,9625,1146511,1146589,1
8073,161,9625,1146589,1146750,9
7086,9,9625,1146750,1146759,12
7430,264,9625,1453027,1453291,16
5882,232,9625,1453072,1453304,47
7932,149,9626,1147204,1147353,3
4928,161,9626,1147353,1147514,3
9174,152,9626,1147514,1147666,31
8126,42,9627,1147665,1147707,3
7234,44,9627,1147707,1147751,36
7329,298,9628,1475414,1475712,25
5490,272,9628,1453146,1453418,29
2851,20,9628,1148188,1148208,30
7754,106,9628,1148208,1148314,37
6439,223,9628,1148314,1148537,38
5226,168,9629,1148536,1148704,17
3119,279,9629,1453192,1453471,23
9260,4,9629,1148929,1148933,48
8853,246,9630,1453247,1453493,3
6023,289,9630,1474117,1474406,17
1060,61,9630,1149379,1149440,37
8899,109,9630,1149440,1149549,38
4494,84,9630,1149549,1149633,49
5809,173,9631,1149632,1149805,4
5223,268,9631,1453332,1453600,9
3961,244,9631,1453377,1453621,12
2040,24,9631,1150246,1150270,32
1472,53,9631,1150270,1150323,46
9204,45,9632,1150322,1150367,11
5472,167,9632,1150367,1150534,14
3840,152,9632,1150534,1150686,36
9624,170,9633,1150685,1150855,9
6094,91,9633,1150855,1150946,11
3869,58,9633,1150946,1151004,21
7634,263,9633,1453400,1453663,29
6815,159,9633,1151223,1151382,40
7494,254,9633,1453444,1453698,47
4003,266,9634,1453474,1453740,12
9532,260,9634,1453515,1453775,23
7466,195,9634,1152048,1152243,24
7858,31,9634,1152243,1152274,28
4626,35,9635,1152273,1152308,47
3170,55,9635,1152308,1152363,47
7837,230,9636,1453551,1453781,6
4161,47,9636,1152584,1152631,30
4924,110,9636,1152631,1152741,30
1467,223,9636,1152741,1152964,34
7635,266,9636,1453558,1453824,39
4404,5,9636,1153187,1153192,45
6813,52,9636,1153192,1153244,49
1668,69,9637,1153243,1153312,6
4088,36,9637,1153312,1153348,22
9111,37,9637,1153348,1153385,27
4439,178,9637,1153385,1153563,32
5391,129,9637,1153563,1153692,43
6458,82,9638,1153691,1153773,3
5120,255,9638,1453597,1453852,37
7680,175,9638,1153998,1154173,45
1283,212,9639,1154172,1154384,9
1309,148,9639,1154384,1154532,21
4914,184,9639,1154532,1154716,25
3888,295,9639,1474114,1474409,25
2949,38,9639,1154935,1154973,34
4416,222,9639,1154973,1155195,34
5031,46,9639,1155195,1155241,41
5354,107,9639,1155241,1155348,45
2544,160,9640,1155347,1155507,5
9787,167,9640,1155507,1155674,15
4943,70,9640,1155674,1155744,22
1088,136,9640,1155744,1155880,22
4580,294,9640,1474124,1474418,35
5963,115,9640,1156114,1156229,40
4282,102,9640,1156229,1156331,44
5658,157,9641,1156330,1156487,11
7127,121,9641,1156487,1156608,19
8507,290,9641,1474136,1474426,36
1638,201,9641,1156838,1157039,40
9400,261,9642,1453791,1454052,5
9851,176,9642,1157260,1157436,8
6008,208,9642,1157436,1157644,19
7324,228,9642,1453831,1454059,32
8688,29,9643,1157864,1157893,11
6089,211,9643,1157893,1158104,13
2891,191,9643,1158104,1158295,16
2600,143,9643,1158295,1158438,38
5815,267,9644,1453835,1454102,6
6201,239,9644,1453878,1454117,21
7920,224,9645,1453898,1454122,9
5659,31,9645,1159100,1159131,33
6970,99,9645,1159131,1159230,37
8268,289,9645,1474142,1474431,50
9000,175,9646,1159452,1159627,18
2867,254,9646,1453952,1454206,30
8168,49,9646,1159853,1159902,47
4489,101,9647,1159901,1160002,15
1495,130,9647,1160002,1160132,18
6757,262,9647,1453980,1454242,23
7332,224,9647,1160357,1160581,36
6943,171,9647,1160581,1160752,41
9331,73,9648,1160751,1160824,9
8169,176,9648,1160824,1161000,27
7503,229,9648,1454019,1454248,40
2006,258,9648,1454029,1454287,47
8151,98,9649,1161440,1161538,5
1548,244,9649,1454059,1454303,20
5203,58,9649,1161765,1161823,21
3502,152,9649,1161823,1161975,23
1654,229,9649,1454083,1454312,28
1801,265,9649,1454084,1454349,31
3228,171,9649,1162423,1162594,39
7413,128,9649,1162594,1162722,49
3177,192,9649,1162722,1162914,50
9525,300,9650,1475394,1475694,2
8074,119,9650,1163138,1163257,18
9879,299,9650,1475399,1475698,23
4444,211,9650,1163482,1163693,31
6337,258,9651,1454239,1454497,6
2091,41,9651,1163914,1163955,9
5956,35,9651,1163955,1163990,28
5460,278,9651,1454272,1454550,37
6998,197,9651,1164215,1164412,41
8287,300,9651,1475524,1475824,45
6408,101,9652,1164635,1164736,28
5755,114,9652,1164736,1164850,32
7758,257,9652,1454386,1454643,42
3231,119,9652,1165070,1165189,43
7036,202,9652,1165189,1165391,48
4369,56,9652,1165391,1165447,49
9385,90,9653,1165446,1165536,5
6588,247,9653,1454419,1454666,10
6752,289,9653,1474183,1474472,17
8572,252,9653,1454510,1454762,22
9834,9,9653,1166197,1166206,28
5932,278,9653,1454542,1454820,28
1656,72,9653,1166426,1166498,29
4938,173,9653,1166498,1166671,41
6660,228,9653,1454596,1454824,45
5931,85,9654,1166894,1166979,3
4992,137,9654,1166979,1167116,45
8511,194,9655,1167115,1167309,21
8265,14,9655,1167309,1167323,33
2238,277,9655,1454598,1454875,45
6928,275,9656,1454649,1454924,1
3721,147,9656,1167771,1167918,2
8264,105,9656,1167918,1168023,6
7298,193,9657,1168022,1168215,12
7525,263,9656,1454701,1454964,12
9070,4,9657,1168438,1168442,14
8131,215,9657,1168442,1168657,24
1804,42,9657,1168657,1168699,26
8351,270,9657,1454739,1455009,34
7787,159,9657,1168923,1169082,37
8788,225,9657,1454786,1455011,39
7600,281,9657,1454788,1455069,43
8530,288,9657,1474186,1474474,46
8778,190,9657,1169748,1169938,50
7422,164,9658,1169937,1170101,4
1949,273,9658,1454912,1455185,9
8598,107,9658,1170319,1170426,16
4559,282,9658,1474199,1474481,22
7651,23,9658,1170640,1170663,23
8628,276,9658,1455028,1455304,33
4542,250,9658,1455074,1455324,36
1676,20,9659,1171109,1171129,29
5922,102,9659,1171129,1171231,30
5482,6,9659,1171231,1171237,43
4291,25,9659,1171237,1171262,46
4690,279,9660,1474201,1474480,16
5287,242,9660,1455154,1455396,24
7116,266,9660,1455162,1455428,35
6923,142,9661,1171940,1172082,17
6960,231,9661,1455200,1455431,20
9498,295,9661,1474198,1474493,29
4921,228,9661,1455274,1455502,47
5822,141,9662,1172746,1172887,24
3192,255,9662,1455273,1455528,31
4033,104,9662,1173115,1173219,39
9749,191,9663,1173218,1173409,13
6640,48,9663,1173409,1173457,19
1101,54,9663,1173457,1173511,32
5541,277,9663,1455297,1455574,36
4189,1,9663,1173741,1173742,38
7084,293,9663,1474209,1474502,43
2155,134,9663,1173965,1174099,46
2124,221,9664,1174098,1174319,3
8457,163,9664,1174319,1174482,20
8255,283,9664,1455412,1455695,28
1030,32,9664,1174702,1174734,31
4805,106,9664,1174734,1174840,33
8911,164,9664,1174840,1175004,46
4606,206,9665,1175003,1175209,20
6932,182,9665,1175209,1175391,37
1533,87,9665,1175391,1175478,41
7427,101,9665,1175478,1175579,42
7522,4,9666,1175578,1175582,17
2123,131,9666,1175582,1175713,27
6195,160,9666,1175713,1175873,35
8733,94,9666,1175873,1175967,39
2582,90,9666,1175967,1176057,42
6207,96,9666,1176057,1176153,49
2728,4,9666,1176153,1176157,50
5664,16,9667,1176156,1176172,31
9662,204,9667,1176172,1176376,45
6582,300,9668,1475387,1475687,1
8195,156,9668,1176600,1176756,3
3784,100,9668,1176756,1176856,8
2296,142,9668,1176856,1176998,24
3635,124,9668,1176998,1177122,30
8909,87,9668,1177122,1177209,42
6658,279,9669,1455522,1455801,23
6745,4,9669,1177433,1177437,32
7942,26,9669,1177437,1177463,48
3059,221,9669,1177463,1177684,50
2870,151,9670,1177683,1177834,30
3827,74,9670,1177834,1177908,32
6125,193,9671,1177907,1178100,8
5560,84,9671,1178100,1178184,11
5958,235,9671,1455576,1455811,27
2033,45,9671,1178407,1178452,41
1223,217,9672,1178451,1178668,3
1954,123,9672,1178668,1178791,16
7745,103,9672,1178791,1178894,24
6816,224,9672,1178894,1179118,30
7752,202,9672,1179118,1179320,36
7812,70,9673,1179319,1179389,8
1103,168,9673,1179389,1179557,8
7853,150,9673,1179557,1179707,20
4882,168,9673,1179707,1179875,20
1565,60,9674,1179874,1179934,2
3153,207,9674,1179934,1180141,4
8059,85,9674,1180141,1180226,9
1293,232,9674,1455590,1455822,9
4293,57,9674,1180444,1180501,26
6457,101,9674,1180501,1180602,45
6449,269,9675,1455599,1455868,7
1476,204,9675,1180823,1181027,42
7738,234,9675,1455648,1455882,42
6232,209,9676,1181246,1181455,17
9351,9,9676,1181455,1181464,19
1590,68,9676,1181464,1181532,28
1719,88,9676,1181532,1181620,29
9366,217,9676,1181620,1181837,40
6938,87,9676,1181837,1181924,44
3103,60,9677,1181923,1181983,12
1522,102,9677,1181983,1182085,19
3897,137,9677,1182085,1182222,21
4053,160,9677,1182222,1182382,48
9804,209,9678,1182381,1182590,5
4109,154,9678,1182590,1182744,16
4134,25,9678,1182744,1182769,25
7693,50,9678,1182769,1182819,27
2995,217,9678,1182819,1183036,42
7211,260,9679,1455656,1455916,5
9390,33,9679,1183257,1183290,17
2012,25,9679,1183290,1183315,34
1951,206,9679,1183315,1183521,44
4759,295,9679,1475382,1475677,49
4698,247,9680,1455748,1455995,26
8049,156,9680,1183966,1184122,27
6859,193,9681,1184121,1184314,15
4983,17,9681,1184314,1184331,18
6247,254,9681,1455773,1456027,32
3013,70,9682,1184551,1184621,1
6121,122,9682,1184621,1184743,4
1410,240,9682,1455799,1456039,20
6345,181,9682,1184970,1185151,28
8843,58,9682,1185151,1185209,32
1001,204,9682,1185209,1185413,35
9080,50,9682,1185413,1185463,36
5427,221,9683,1185462,1185683,6
8037,204,9683,1185683,1185887,18
9763,2,9683,1185887,1185889,20
8769,267,9683,1455814,1456081,21
5464,72,9683,1186113,1186185,24
7134,224,9683,1186185,1186409,35
9524,200,9683,1186409,1186609,37
2710,117,9684,1186608,1186725,1
1723,36,9684,1186725,1186761,6
2770,219,9684,1455863,1456082,8
9147,190,9684,1186978,1187168,30
9914,108,9684,1187168,1187276,32
3114,4,9684,1187276,1187280,42
3819,285,9685,1474229,1474514,50
5888,18,9686,1187501,1187519,1
9091,196,9686,1187519,1187715,24
1672,192,9686,1187715,1187907,38
1038,227,9686,1455911,1456138,38
1953,110,9686,1188133,1188243,43
6362,129,9686,1188243,1188372,45
3033,97,9686,1188372,1188469,46
8846,83,9687,1188468,1188551,4
3052,24,9687,1188551,1188575,6
2960,249,9687,1455913,1456162,21
2811,226,9687,1455948,1456174,22
3640,194,9687,1189013,1189207,24
8491,124,9687,1189207,1189331,26
2477,258,9687,1455955,1456213,29
9989,186,9687,1189550,1189736,36
4098,6,9687,1189736,1189742,41
2272,53,9687,1189742,1189795,43
2356,132,9687,1189795,1189927,49
8001,98,9688,1189926,1190024,42
4638,81,9689,1190023,1190104,15
7956,182,9689,1190104,1190286,27
3969,100,9689,1190286,1190386,39
2701,207,9689,1190386,1190593,45
8056,143,9690,1190592,1190735,8
4838,284,9690,1474226,1474510,20
6826,120,9690,1190962,1191082,35
6670,139,9690,1191082,1191221,47
6556,169,9691,1191220,1191389,5
5428,180,9691,1191389,1191569,9
5435,50,9691,1191569,1191619,47
8676,180,9691,1191619,1191799,49
5476,4,9692,1191798,1191802,5
5595,170,9692,1191802,1191972,37
7423,171,9693,1191971,1192142,3
9416,119,9693,1192142,1192261,7
2188,47,9693,1192261,1192308,15
3686,90,9693,1192308,1192398,15
9494,261,9693,1456037,1456298,38
5404,288,9693,1474224,1474512,39
4888,242,9694,1456142,1456384,19
2838,70,9694,1193061,1193131,40
7947,35,9694,1193131,1193166,42
7923,116,9695,1193165,1193281,16
6835,45,9695,1193281,1193326,17
3030,71,9695,1193326,1193397,17
7768,150,9695,1193397,1193547,17
9344,100,9695,1193547,1193647,32
8435,189,9695,1193647,1193836,46
2414,4,9695,1193836,1193840,47
8619,121,9695,1193840,1193961,47
7685,32,9696,1193960,1193992,20
2497,280,9696,1456155,1456435,20
9775,175,9697,1194218,1194393,3
5768,138,9697,1194393,1194531,20
1216,17,9697,1194531,1194548,46
1454,279,9698,1456213,1456492,15
7650,70,9698,1194767,1194837,42
3359,87,9698,1194837,1194924,44
6895,275,9699,1456267,1456542,21
7489,300,9699,1475478,1475778,26
3948,135,9699,1195371,1195506,42
4434,159,9699,1195506,1195665,44
4668,56,9700,1195664,1195720,6
4221,223,9700,1456378,1456601,9
7052,157,9700,1195938,1196095,16
1461,299,9700,1475479,1475778,25
9072,269,9701,1456443,1456712,4
9378,64,9701,1196534,1196598,12
7859,11,9701,1196598,1196609,13
2276,167,9701,1196609,1196776,13
7054,160,9701,1196776,1196936,44
1828,200,9702,1196935,1197135,7
3461,27,9702,1197135,1197162,17
9030,149,9702,1197162,1197311,35
7356,290,9702,1474249,1474539,46
1085,95,9702,1197531,1197626,48
1845,53,9703,1197625,1197678,24
6896,40,9703,1197678,1197718,25
1044,150,9703,1197718,1197868,48
9411,255,9704,1456544,1456799,16
2054,148,9704,1198094,1198242,18
4847,137,9704,1198242,1198379,20
8870,98,9704,1198379,1198477,24
8378,242,9704,1456576,1456818,27
8335,102,9704,1198700,1198802,46
8377,166,9705,1198801,1198967,2
8712,120,9705,1198967,1199087,19
3857,74,9705,1199087,1199161,21
7890,275,9705,1456593,1456868,34
1760,212,9705,1199385,1199597,50
2756,37,9706,1199596,1199633,2
8684,31,9706,1199633,1199664,7
8337,222,9706,1199664,1199886,12
7542,123,9706,1199886,1200009,31
4941,209,9706,1200009,1200218,37
2612,100,9707,1200217,1200317,10
7432,151,9707,1200317,1200468,39
9718,227,9707,1456644,1456871,40
2113,226,9707,1456647,1456873,45
1005,166,9708,1200913,1201079,7
8456,159,9708,1201079,1201238,9
1331,186,9708,1201238,1201424,15
4944,79,9708,1201424,1201503,32
4599,284,9708,1474253,1474537,37
7596,4,9708,1201728,1201732,48
5131,13,9709,1201731,1201744,4
4415,297,9709,1475359,1475656,26
4080,190,9709,1201968,1202158,29
9486,106,9710,1202157,1202263,16
3517,214,9710,1202263,1202477,21
8535,178,9710,1202477,1202655,24
4006,240,9710,1456761,1457001,24
3872,258,9710,1456777,1457035,26
7009,59,9710,1203098,1203157,35
2267,282,9710,1456810,1457092,41
7187,23,9711,1203381,1203404,5
6506,122,9711,1203404,1203526,15
7119,206,9711,1203526,1203732,20
8992,265,9711,1456867,1457132,34
4081,224,9711,1456910,1457134,40
1827,300,9711,1475468,1475768,46
8528,289,9712,1474282,1474571,6
7218,22,9712,1204619,1204641,10
3409,106,9712,1204641,1204747,26
5650,152,9712,1204747,1204899,28
7673,135,9712,1204899,1205034,45
4044,47,9713,1205033,1205080,35
9675,209,9714,1205079,1205288,5
8630,203,9714,1205288,1205491,13
5924,95,9714,1205491,1205586,15
4089,11,9714,1205586,1205597,20
4778,212,9714,1205597,1205809,23
1374,204,9714,1205809,1206013,37
9206,49,9714,1206013,1206062,39
4166,221,9714,1457030,1457251,42
7688,49,9715,1206281,1206330,1
6857,174,9715,1206330,1206504,4
7357,63,9715,1206504,1206567,7
7798,11,9715,1206567,1206578,12
2510,211,9715,1206578,1206789,45
9279,1,9715,1206789,1206790,48
9342,138,9715,1206790,1206928,48
6667,230,9716,1457026,1457256,12
1866,15,9716,1207150,1207165,15
5784,267,9716,1457029,1457296,16
3188,285,9716,1474284,1474569,20
7781,45,9716,1207619,1207664,41
4564,129,9717,1207663,1207792,7
8164,151,9717,1207792,1207943,15
6087,2,9717,1207943,1207945,16
4454,21,9717,1207945,1207966,24
1721,116,9717,1207966,1208082,32
2142,1,9717,1208082,1208083,42
9903,8,9718,1208082,1208090,5
3554,196,9718,1208090,1208286,10
5629,57,9718,1208286,1208343,21
4848,164,9718,1208343,1208507,41
7104,24,9719,1208506,1208530,14
3343,207,9719,1208530,1208737,16
6220,2,9719,1208737,1208739,17
8772,223,9719,1208739,1208962,20
6160,136,9719,1208962,1209098,31
1112,215,9719,1209098,1209313,46
2023,132,9719,1209313,1209445,49
3539,74,9720,1209444,1209518,19
5000,255,9720,1457114,1457369,35
5116,24,9721,1209751,1209775,1
3471,156,9721,1209775,1209931,25
8756,236,9721,1457149,1457385,29
2237,212,9721,1210150,1210362,41
8525,230,9721,1457163,1457393,49
8142,144,9722,1210583,1210727,1
7891,259,9722,1457170,1457429,6
2268,106,9722,1210949,1211055,7
6913,279,9722,1474285,1474564,11
3615,126,9722,1211279,1211405,17
4875,46,9722,1211405,1211451,24
9587,268,9722,1457259,1457527,26
6277,106,9722,1211675,1211781,44
7706,252,9723,1457301,1457553,1
7830,140,9723,1212005,1212145,7
6153,106,9723,1212145,1212251,9
6016,23,9723,1212251,1212274,14
4232,238,9723,1457338,1457576,19
6820,9,9723,1212489,1212498,38
4824,37,9724,1212497,1212534,11
4903,93,9724,1212534,1212627,16
4230,139,9724,1212627,1212766,26
1220,274,9724,1457352,1457626,27
3410,286,9724,1474281,1474567,31
7287,262,9724,1457456,1457718,43
5011,242,9725,1457493,1457735,17
6026,123,9725,1213663,1213786,36
6787,176,9725,1213786,1213962,44
6625,275,9725,1457513,1457788,49
2127,149,9726,1214183,1214332,25
8645,103,9726,1214332,1214435,43
2897,187,9727,1214434,1214621,6
9149,190,9727,1214621,1214811,20
7516,232,9727,1457561,1457793,23
7393,287,9727,1474281,1474568,39
2752,120,9728,1215258,1215378,31
1354,112,9728,1215378,1215490,33
5039,292,9728,1474285,1474577,43
1132,2,9728,1215713,1215715,46
4869,289,9729,1474295,1474584,5
7313,78,9729,1215936,1216014,6
1561,272,9729,1457747,1458019,6
6490,131,9729,1216236,1216367,13
7021,266,9729,1457794,1458060,23
7721,149,9729,1216592,1216741,29
6056,21,9730,1216740,1216761,4
4377,88,9730,1216761,1216849,11
9160,244,9730,1457839,1458083,28
1098,202,9730,1217069,1217271,43
1576,66,9730,1217271,1217337,45
5140,52,9730,1217337,1217389,46
8812,203,9731,1217388,1217591,6
9379,12,9731,1217591,1217603,7
7609,96,9731,1217603,1217699,18
6501,205,9731,1217699,1217904,18
2042,255,9732,1457867,1458122,22
7163,108,9732,1218117,1218225,24
1669,26,9732,1218225,1218251,26
6546,193,9732,1218251,1218444,27
1725,20,9732,1218444,1218464,47
9458,278,9732,1457899,1458177,48
4317,299,9733,1475448,1475747,25
5250,221,9733,1218905,1219126,34
3286,237,9734,1458014,1458251,2
8545,2,9734,1219350,1219352,18
5146,64,9734,1219352,1219416,26
5252,266,9734,1458021,1458287,36
7750,221,9734,1458067,1458288,42
4422,252,9734,1458068,1458320,42
1136,284,9734,1474313,1474597,49
7499,277,9735,1458161,1458438,19
9384,20,9735,1220522,1220542,21
8066,118,9735,1220542,1220660,41
2297,248,9735,1458215,1458463,48
2509,288,9736,1474313,1474601,1
5192,69,9736,1221107,1221176,9
1042,203,9736,1221176,1221379,12
6576,45,9736,1221379,1221424,13
1521,105,9736,1221424,1221529,13
3782,122,9736,1221529,1221651,16
6029,272,9736,1458294,1458566,41
9232,200,9737,1221875,1222075,4
4651,28,9737,1222075,1222103,28
1455,35,9738,1222102,1222137,8
2725,97,9738,1222137,1222234,14
9699,84,9738,1222234,1222318,16
4922,240,9738,1458340,1458580,17
4103,183,9738,1222542,1222725,39
4750,229,9738,1458358,1458587,40
9891,187,9739,1222946,1223133,2
6081,192,9739,1223133,1223325,15
5248,109,9739,1223325,1223434,17
8242,157,9739,1223434,1223591,30
9922,225,9739,1223591,1223816,35
6200,66,9739,1223816,1223882,40
1018,179,9740,1223881,1224060,13
2935,202,9740,1224060,1224262,24
1771,139,9740,1224262,1224401,44
7702,172,9741,1224400,1224572,13
5359,132,9741,1224572,1224704,16
6827,281,9741,1458360,1458641,21
8216,10,9741,1224928,1224938,26
8600,10,9741,1224938,1224948,26
3047,36,9741,1224948,1224984,42
5448,284,9741,1474316,1474600,50
5151,163,9742,1225206,1225369,11
6118,79,9742,1225369,1225448,21
1891,167,9742,1225448,1225615,30
4905,128,9742,1225615,1225743,43
6912,27,9742,1225743,1225770,45
2853,69,9743,1225769,1225838,15
7846,278,9743,1458474,1458752,18
3602,179,9743,1226060,1226239,22
9689,222,9743,1458531,1458753,32
1003,240,9743,1458529,1458769,45
3355,86,9744,1226683,1226769,14
1743,202,9744,1226769,1226971,14
4608,37,9744,1226971,1227008,37
8987,257,9744,1458546,1458803,40
5814,182,9745,1227229,1227411,5
6326,257,9745,1458580,1458837,18
9059,22,9745,1227633,1227655,20
7448,239,9745,1458613,1458852,26
6865,100,9745,1227879,1227979,37
9785,265,9746,1458626,1458891,2
8804,296,9746,1474313,1474609,1
9607,61,9746,1228428,1228489,6
9655,49,9746,1228489,1228538,29
5699,252,9747,1458725,1458977,7
1063,155,9747,1228759,1228914,17
3169,152,9748,1228913,1229065,21
5969,227,9748,1458755,1458982,32
4312,142,9748,1229286,1229428,35
8011,6,9748,1229428,1229434,47
8350,85,9749,1229433,1229518,3
7213,153,9749,1229518,1229671,7
9340,174,9749,1229671,1229845,10
5600,93,9749,1229845,1229938,11
3955,285,9749,1474328,1474613,11
2818,274,9749,1458816,1459090,25
4022,27,9749,1230381,1230408,32
2746,34,9749,1230408,1230442,45
4768,276,9750,1458865,1459141,17
5055,72,9750,1230665,1230737,25
1232,180,9750,1230737,1230917,26
5743,205,9750,1230917,1231122,29
9016,98,9751,1231121,1231219,8
4891,74,9751,1231219,1231293,14
1955,206,9751,1231293,1231499,33
1579,196,9751,1231499,1231695,34
2583,189,9752,1231694,1231883,2
7470,191,9752,1231883,1232074,29
7303,93,9752,1232074,1232167,32
10000,118,9752,1232167,1232285,35
1265,192,9752,1232285,1232477,38
1485,144,9753,1232476,1232620,10
7434,146,9753,1232620,1232766,11
1884,207,9753,1232766,1232973,11
3374,233,9753,1458910,1459143,13
5227,287,9753,1474331,1474618,16
7641,184,9753,1233428,1233612,20
3633,263,9753,1458967,1459230,20
7281,239,9753,1458996,1459235,35
1873,28,9753,1234073,1234101,43
3996,197,9753,1234101,1234298,48
9711,172,9754,1234297,1234469,26
8669,246,9754,1459011,1459257,27
2939,185,9754,1234692,1234877,31
4055,279,9755,1459031,1459310,2
4664,167,9755,1235101,1235268,27
5989,292,9755,1474333,1474625,28
7224,182,9755,1235488,1235670,31
9636,156,9755,1235670,1235826,41
8367,12,9755,1235826,1235838,49
1306,16,9756,1235837,1235853,7
1442,227,9756,1459154,1459381,9
2687,13,9756,1236071,1236084,22
2695,174,9756,1236084,1236258,22
2855,12,9756,1236258,1236270,33
9807,139,9756,1236270,1236409,45
8275,191,9757,1236408,1236599,23
4264,123,9757,1236599,1236722,33
6989,270,9757,1459163,1459433,33
7926,92,9757,1236939,1237031,36
7268,265,9757,1459211,1459476,40
9967,157,9758,1237252,1237409,14
4613,122,9758,1237409,1237531,24
8949,148,9758,1237531,1237679,24
8498,213,9758,1237679,1237892,25
5198,104,9758,1237892,1237996,37
7319,253,9759,1459251,1459504,3
3210,273,9759,1459281,1459554,48
3950,166,9760,1238440,1238606,15
4792,73,9760,1238606,1238679,19
2726,21,9760,1238679,1238700,41
4473,4,9760,1238700,1238704,43
2645,16,9760,1238704,1238720,45
5378,130,9760,1238720,1238850,47
8635,209,9761,1238849,1239058,1
9889,104,9761,1239058,1239162,8
3911,218,9761,1239162,1239380,28
1716,266,9761,1459326,1459592,30
2169,239,9761,1459371,1459610,32
9218,4,9762,1239826,1239830,2
4217,190,9762,1239830,1240020,37
9779,258,9762,1459387,1459645,40
2488,3,9763,1240241,1240244,1
1319,274,9763,1459422,1459696,6
8834,25,9763,1240466,1240491,10
9649,256,9763,1459472,1459728,17
2428,221,9763,1459508,1459729,28
8345,98,9763,1240935,1241033,32
8948,9,9763,1241033,1241042,39
7589,59,9763,1241042,1241101,47
7734,194,9764,1241100,1241294,1
5389,264,9764,1459508,1459772,42
1799,296,9764,1475312,1475608,46
6281,227,9765,1241733,1241960,16
7098,184,9766,1241959,1242143,4
8898,280,9766,1459609,1459889,12
8068,197,9766,1242366,1242563,14
1659,145,9766,1242563,1242708,23
9943,196,9766,1242708,1242904,23
2432,104,9766,1242904,1243008,31
9335,109,9766,1243008,1243117,35
7838,254,9766,1459655,1459909,35
2912,298,9766,1475309,1475607,44
1513,269,9766,1459746,1460015,50
4495,290,9767,1474359,1474649,1
9584,120,9767,1244020,1244140,6
1288,89,9767,1244140,1244229,13
7459,31,9767,1244229,1244260,41
2632,207,9767,1244260,1244467,48
2909,123,9767,1244467,1244590,49
4488,254,9768,1459845,1460099,2
5506,244,9768,1459873,1460117,30
8252,298,9768,1475309,1475607,35
1660,74,9768,1245274,1245348,38
3229,59,9768,1245348,1245407,40
1193,10,9768,1245407,1245417,49
5753,200,9769,1245416,1245616,7
6968,295,9769,1475313,1475608,8
7872,3,9769,1245833,1245836,14
3589,277,9769,1460006,1460283,44
7618,97,9769,1246058,1246155,45
4568,290,9770,1474390,1474680,12
1853,265,9770,1460116,1460381,14
8330,146,9770,1246602,1246748,28
9727,142,9770,1246748,1246890,44
2799,57,9770,1246890,1246947,48
6256,209,9772,1246945,1247154,6
6870,295,9771,1474400,1474695,6
4686,50,9772,1247376,1247426,24
4953,251,9772,1460212,1460463,26
7325,256,9772,1460240,1460496,39
3087,60,9772,1247873,1247933,40
3091,178,9773,1247932,1248110,7
6564,130,9773,1248110,1248240,19
9682,100,9773,1248240,1248340,23
7775,272,9773,1460273,1460545,40
8931,48,9773,1248562,1248610,42
6313,287,9773,1474412,1474699,45
6803,94,9774,1248833,1248927,11
9195,201,9774,1248927,1249128,13
9948,190,9774,1249128,1249318,14
9017,73,9774,1249318,1249391,39
8544,231,9774,1460381,1460612,42
7949,147,9775,1249610,1249757,3
4179,180,9775,1249757,1249937,7
6925,216,9775,1249937,1250153,31
8902,265,9775,1460390,1460655,32
5686,68,9775,1250374,1250442,35
4556,161,9775,1250442,1250603,45
6059,80,9776,1250602,1250682,4
7112,156,9776,1250682,1250838,8
7380,42,9776,1250838,1250880,40
4595,100,9776,1250880,1250980,46
5462,130,9777,1250979,1251109,14
5534,243,9777,1460433,1460676,15
2886,134,9777,1251329,1251463,21
8178,148,9777,1251463,1251611,32
8793,160,9777,1251611,1251771,33
3183,226,9778,1460452,1460678,3
5442,36,9778,1251993,1252029,17
3455,251,9778,1460454,1460705,26
3181,4,9778,1252253,1252257,39
9252,232,9778,1460485,1460717,46
2531,236,9780,1460493,1460729,18
3603,35,9781,1252696,1252731,2
3771,47,9781,1252731,1252778,25
5913,206,9781,1252778,1252984,28
4429,46,9781,1252984,1253030,31
1805,184,9781,1253030,1253214,49
3020,64,9782,1253213,1253277,32
5147,12,9782,1253277,1253289,49
6131,266,9782,1460505,1460771,49
8333,34,9783,1253510,1253544,15
3809,84,9783,1253544,1253628,16
5696,47,9783,1253628,1253675,24
5731,100,9783,1253675,1253775,39
8095,287,9783,1474405,1474692,41
9127,62,9783,1254000,1254062,42
4255,124,9784,1254061,1254185,4
1128,259,9784,1460604,1460863,17
3121,288,9784,1474409,1474697,23
4333,46,9784,1254634,1254680,33
8239,280,9784,1460696,1460976,34
3302,39,9784,1254904,1254943,49
8962,269,9784,1460754,1461023,49
2275,138,9785,1255164,1255302,16
2837,254,9785,1460803,1461057,29
8174,183,9785,1255521,1255704,37
6338,217,9786,1255703,1255920,1
3358,106,9786,1255920,1256026,3
3463,44,9786,1256026,1256070,15
4047,149,9786,1256070,1256219,29
2064,162,9787,1256218,1256380,5
8694,33,9787,1256380,1256413,7
5880,179,9787,1256413,1256592,11
4063,65,9787,1256592,1256657,21
6929,258,9787,1460835,1461093,28
9108,189,9787,1256877,1257066,36
5737,285,9787,1474412,1474697,44
2138,201,9788,1257287,1257488,29
2872,45,9788,1257488,1257533,36
5634,142,9788,1257533,1257675,39
5085,126,9788,1257675,1257801,50
5380,160,9788,1257801,1257961,50
1057,276,9789,1460927,1461203,26
5872,276,9789,1460980,1461256,43
9671,121,9790,1258406,1258527,36
5275,274,9790,1461033,1461307,44
9269,12,9790,1258749,1258761,48
3201,113,9790,1258761,1258874,50
4029,129,9791,1258873,1259002,33
8857,199,9791,1259002,1259201,36
4235,264,9792,1461088,1461352,8
4925,56,9792,1259417,1259473,19
1978,260,9792,1461133,1461393,29
2501,37,9792,1259692,1259729,44
5609,58,9793,1259728,1259786,1
4843,40,9793,1259786,1259826,6
4019,223,9793,1259826,1260049,16
9418,185,9793,1260049,1260234,25
3625,38,9793,1260234,1260272,34
9566,6,9794,1260271,1260277,1
9666,266,9794,1461168,1461434,3
6476,149,9794,1260500,1260649,9
9975,157,9794,1260649,1260806,16
5898,269,9794,1461219,1461488,19
5619,167,9794,1261021,1261188,26
6638,23,9794,1261188,1261211,27
9296,153,9795,1261210,1261363,19
8013,296,9795,1475288,1475584,26
3651,2,9795,1261587,1261589,29
8553,207,9795,1261589,1261796,32
3981,275,9795,1461318,1461593,45
2043,268,9795,1461371,1461639,49
5613,240,9796,1461416,1461656,18
7993,278,9796,1461433,1461711,27
2017,5,9797,1262685,1262690,6
5742,8,9797,1262690,1262698,11
8521,43,9797,1262698,1262741,13
9445,236,9797,1461491,1461727,29
5137,97,9797,1262960,1263057,30
6116,29,9797,1263057,1263086,39
1904,27,9797,1263086,1263113,41
1693,259,9798,1461508,1461767,9
4173,225,9798,1461547,1461772,15
5833,61,9798,1263550,1263611,16
7777,197,9798,1263611,1263808,18
3322,122,9798,1263808,1263930,31
8441,25,9798,1263930,1263955,44
4351,95,9798,1263955,1264050,49
8187,223,9798,1461550,1461773,49
7839,257,9799,1461550,1461807,7
7763,161,9799,1264493,1264654,16
3067,254,9799,1461583,1461837,17
9287,276,9799,1461614,1461890,48
6637,109,9800,1265100,1265209,5
9409,3,9800,1265209,1265212,15
9606,253,9800,1461670,1461923,25
6093,248,9800,1461699,1461947,26
4820,163,9800,1265655,1265818,30
7937,83,9800,1265818,1265901,40
8515,297,9801,1475283,1475580,18
2973,276,9801,1461779,1462055,37
2708,214,9803,1266345,1266559,18
9739,39,9803,1266559,1266598,20
4246,153,9803,1266598,1266751,24
8695,146,9803,1266751,1266897,35
9422,289,9804,1474430,1474719,13
9615,250,9804,1461879,1462129,14
3267,247,9804,1461902,1462149,16
4811,18,9804,1267576,1267594,22
7792,169,9804,1267594,1267763,41
4573,72,9805,1267762,1267834,12
5789,135,9805,1267834,1267969,40
9527,138,9806,1267968,1268106,1
3448,237,9806,1461922,1462159,2
2314,49,9806,1268331,1268380,11
1602,259,9806,1461931,1462190,13
8502,239,9806,1461965,1462204,41
2605,20,9807,1268832,1268852,4
6871,20,9807,1268852,1268872,33
6749,223,9807,1268872,1269095,37
1982,4,9808,1269094,1269098,19
4280,208,9808,1269098,1269306,23
4683,289,9808,1474436,1474725,26
2798,284,9808,1474443,1474727,46
9824,13,9809,1269749,1269762,19
6922,156,9809,1269762,1269918,28
7130,134,9809,1269918,1270052,42
4515,24,9809,1270052,1270076,44
6466,98,9809,1270076,1270174,49
6244,80,9810,1270173,1270253,6
9063,202,9810,1270253,1270455,13
1072,226,9810,1462097,1462323,15
5311,12,9810,1270675,1270687,21
8661,109,9810,1270687,1270796,27
8623,95,9811,1270795,1270890,20
3775,176,9811,1270890,1271066,39
3219,110,9812,1271065,1271175,4
4872,99,9812,1271175,1271274,6
3401,189,9812,1271274,1271463,11
8862,98,9812,1271463,1271561,14
3750,176,9812,1271561,1271737,28
6979,66,9813,1271736,1271802,35
6764,266,9813,1462100,1462366,42
1626,126,9813,1272022,1272148,50
2375,250,9814,1462142,1462392,3
7502,185,9814,1272370,1272555,11
2604,132,9814,1272555,1272687,17
6219,276,9814,1462169,1462445,27
2567,24,9814,1272910,1272934,29
9370,206,9814,1272934,1273140,29
5647,86,9814,1273140,1273226,41
2888,284,9814,1474441,1474725,50
1287,194,9815,1273448,1273642,4
9395,54,9815,1273642,1273696,35
3863,281,9816,1474449,1474730,22
1483,197,9816,1273909,1274106,44
4389,18,9817,1274105,1274123,6
9981,146,9817,1274123,1274269,7
2080,217,9817,1274269,1274486,7
8763,185,9817,1274486,1274671,10
1298,270,9817,1462334,1462604,23
4829,114,9817,1274896,1275010,29
5024,224,9817,1462384,1462608,42
4708,140,9818,1275229,1275369,49
7416,7,9819,1275368,1275375,1
6445,263,9819,1462378,1462641,31
7735,57,9819,1275603,1275660,48
6098,50,9820,1275659,1275709,20
8858,289,9820,1474443,1474732,21
5709,189,9820,1275933,1276122,29
5405,296,9820,1474451,1474747,29
5172,139,9820,1276341,1276480,32
9322,139,9820,1276480,1276619,47
7285,196,9821,1276618,1276814,8
7807,60,9821,1276814,1276874,10
8486,216,9821,1276874,1277090,10
9263,78,9821,1277090,1277168,17
4547,41,9821,1277168,1277209,32
8608,113,9821,1277209,1277322,34
6208,50,9821,1277322,1277372,36
6566,158,9821,1277372,1277530,36
5708,275,9822,1462534,1462809,2
5001,292,9822,1474463,1474755,1
6864,109,9822,1277979,1278088,3
9609,145,9822,1278088,1278233,10
3429,80,9822,1278233,1278313,23
5008,199,9822,1278313,1278512,26
4632,215,9822,1278512,1278727,30
1114,78,9822,1278727,1278805,33
8522,183,9822,1278805,1278988,45
2543,235,9823,1462637,1462872,13
3200,53,9823,1279215,1279268,24
7929,103,9823,1279268,1279371,31
9308,140,9823,1279371,1279511,46
4150,131,9824,1279510,1279641,6
2903,160,9824,1279641,1279801,9
7145,292,9824,1474470,1474762,21
3154,68,9824,1280025,1280093,24
5606,63,9824,1280093,1280156,40
5698,84,9824,1280156,1280240,42
3043,169,9825,1280239,1280408,10
5382,42,9825,1280408,1280450,22
3522,44,9825,1280450,1280494,26
2186,1,9825,1280494,1280495,42
9843,297,9826,1475262,1475559,5
3688,49,9826,1280716,1280765,38
7581,259,9827,1462764,1463023,6
9389,209,9827,1280986,1281195,10
9497,15,9827,1281195,1281210,15
8186,198,9827,1281210,1281408,17
5907,140,9827,1281408,1281548,21
3497,296,9827,1475264,1475560,26
1024,199,9827,1281772,1281971,39
8237,247,9827,1462856,1463103,49
7661,211,9828,1282192,1282403,1
9548,136,9828,1282403,1282539,23
5479,87,9829,1282538,1282625,26
6983,93,9829,1282625,1282718,37
1356,217,9829,1282718,1282935,42
7515,237,9830,1462875,1463112,1
4727,169,9830,1283159,1283328,4
8321,95,9830,1283328,1283423,25
7369,131,9830,1283423,1283554,35
2321,266,9830,1462893,1463159,47
8103,47,9831,1283772,1283819,2
2616,186,9831,1283819,1284005,23
1528,90,9831,1284005,1284095,30
1935,17,9831,1284095,1284112,33
2304,84,9832,1284111,1284195,21
1427,168,9832,1284195,1284363,29
8702,106,9832,1284363,1284469,31
3383,188,9832,1284469,1284657,42
1142,100,9832,1284657,1284757,44
8534,70,9832,1284757,1284827,49
7341,178,9832,1284827,1285005,50
8686,184,9833,1285004,1285188,1
7445,23,9833,1285188,1285211,4
1812,35,9833,1285211,1285246,12
2578,35,9834,1285245,1285280,21
7228,52,9834,1285280,1285332,24
2475,239,9834,1462931,1463170,34
1606,201,9834,1285556,1285757,48
6248,95,9835,1285756,1285851,18
5850,143,9835,1285851,1285994,18
9294,160,9835,1285994,1286154,20
9817,173,9835,1286154,1286327,23
8854,70,9836,1286326,1286396,12
9044,279,9836,1462948,1463227,28
1055,117,9836,1286616,1286733,43
5728,92,9837,1286732,1286824,14
1129,289,9837,1474495,1474784,24
4239,46,9837,1287043,1287089,41
4631,178,9838,1287088,1287266,23
1586,66,9838,1287266,1287332,26
7216,113,9838,1287332,1287445,32
8499,87,9838,1287445,1287532,39
8886,110,9839,1287531,1287641,6
7849,214,9839,1287641,1287855,26
3558,5,9839,1287855,1287860,35
3480,134,9839,1287860,1287994,45
3081,40,9840,1287993,1288033,4
5949,87,9840,1288033,1288120,38
8734,132,9841,1288119,1288251,13
8875,86,9841,1288251,1288337,27
9595,149,9841,1288337,1288486,31
6755,221,9841,1288486,1288707,32
7484,112,9841,1288707,1288819,33
6168,136,9842,1288818,1288954,3
7966,245,9842,1463060,1463305,12
1964,14,9843,1289176,1289190,4
6507,242,9843,1463082,1463324,7
1699,119,9843,1289412,1289531,9
4665,21,9843,1289531,1289552,17
7828,95,9843,1289552,1289647,19
3889,24,9844,1289646,1289670,3
5601,96,9844,1289670,1289766,14
4328,94,9844,1289766,1289860,18
1894,164,9844,1289860,1290024,21
6668,54,9844,1290024,1290078,34
4889,216,9844,1290078,1290294,38
5578,129,9845,1290293,1290422,10
9071,265,9845,1463101,1463366,32
8926,123,9846,1290642,1290765,33
7898,68,9846,1290765,1290833,34
3978,231,9847,1463139,1463370,23
2819,210,9847,1291057,1291267,36
8848,56,9847,1291267,1291323,47
9762,191,9847,1291323,1291514,48
1786,281,9848,1474493,1474774,13
7517,43,9848,1291741,1291784,16
2242,271,9848,1463197,1463468,45
4703,77,9849,1292007,1292084,12
2671,277,9849,1463244,1463521,12
1398,214,9849,1292307,1292521,20
1967,293,9849,1474489,1474782,35
9295,23,9849,1292755,1292778,43
6120,263,9850,1463347,1463610,3
1257,279,9850,1474505,1474784,9
1574,71,9850,1293218,1293289,11
4844,220,9850,1293289,1293509,14
2529,195,9850,1293509,1293704,24
2634,275,9850,1463444,1463719,34
8341,154,9851,1293927,1294081,21
6324,88,9851,1294081,1294169,46
1138,12,9852,1294168,1294180,1
2765,23,9852,1294180,1294203,16
5799,282,9852,1474504,1474786,16
7699,7,9852,1294430,1294437,39
5879,4,9853,1294436,1294440,19
2022,277,9854,1463540,1463817,38
7940,295,9854,1474502,1474797,44
5694,193,9854,1294887,1295080,45
7142,167,9855,1295079,1295246,17
8560,204,9855,1295246,1295450,21
5633,230,9855,1463657,1463887,24
3205,151,9855,1295669,1295820,30
2413,228,9855,1463666,1463894,32
8658,9,9855,1296041,1296050,47
5449,219,9856,1296049,1296268,7
5518,282,9856,1474516,1474798,8
7437,266,9856,1463731,1463997,11
5752,165,9856,1296709,1296874,15
5836,102,9856,1296874,1296976,28
1415,248,9856,1463775,1464023,40
7479,149,9856,1297198,1297347,46
5639,188,9856,1297347,1297535,49
4976,235,9857,1463804,1464039,9
3005,186,9857,1297752,1297938,32
7587,299,9858,1475233,1475532,14
9500,153,9858,1298162,1298315,47
3531,289,9859,1474524,1474813,25
6379,106,9859,1298533,1298639,32
3884,217,9859,1298639,1298856,46
8672,33,9860,1298855,1298888,4
6148,294,9860,1475237,1475531,5
8153,256,9860,1463996,1464252,7
4471,269,9860,1464025,1464294,20
3904,21,9860,1299559,1299580,46
2566,300,9861,1475320,1475620,6
3503,54,9861,1299801,1299855,25
7905,274,9861,1464131,1464405,47
2737,212,9861,1300074,1300286,49
9401,132,9862,1300285,1300417,7
6697,216,9862,1300417,1300633,11
2571,130,9862,1300633,1300763,29
5522,50,9862,1300763,1300813,34
3097,166,9862,1300813,1300979,42
9169,103,9862,1300979,1301082,43
1280,196,9862,1301082,1301278,45
4256,72,9862,1301278,1301350,49
6386,259,9862,1464182,1464441,49
8371,181,9863,1301571,1301752,7
4296,89,9864,1301751,1301840,18
5492,279,9864,1464215,1464494,26
6014,38,9864,1302064,1302102,40
2868,98,9864,1302102,1302200,44
6891,13,9865,1302199,1302212,15
8872,69,9865,1302212,1302281,21
8423,230,9865,1464268,1464498,23
9865,137,9865,1302506,1302643,36
3365,29,9865,1302643,1302672,38
8038,282,9865,1474560,1474842,42
3684,205,9865,1302892,1303097,43
6229,173,9865,1303097,1303270,50
2365,262,9866,1464331,1464593,7
9551,234,9866,1464369,1464603,26
7256,207,9866,1303715,1303922,39
2223,81,9867,1303921,1304002,7
7736,96,9867,1304002,1304098,7
3842,54,9867,1304098,1304152,8
7724,139,9867,1304152,1304291,21
6083,230,9867,1304291,1304521,36
3879,254,9868,1464376,1464630,1
1947,147,9868,1304745,1304892,27
7305,224,9868,1464407,1464631,27
6252,203,9868,1305115,1305318,42
5110,212,9869,1305317,1305529,39
5946,218,9869,1305529,1305747,41
2720,171,9870,1305746,1305917,11
2179,170,9870,1305917,1306087,28
3605,149,9870,1306087,1306236,31
8139,206,9870,1306236,1306442,46
2555,111,9871,1306441,1306552,15
5313,178,9871,1306552,1306730,17
2494,79,9871,1306730,1306809,20
3814,191,9871,1306809,1307000,36
4896,91,9872,1306999,1307090,11
4836,81,9872,1307090,1307171,15
4353,226,9872,1464405,1464631,18
2944,212,9872,1307393,1307605,22
3597,65,9872,1307605,1307670,24
9737,175,9872,1307670,1307845,45
8210,195,9872,1307845,1308040,45
1499,293,9872,1474553,1474846,46
6254,78,9872,1308260,1308338,50
8871,184,9873,1308337,1308521,4
8541,221,9873,1308521,1308742,12
8816,182,9873,1308742,1308924,14
3141,186,9873,1308924,1309110,19
1650,150,9873,1309110,1309260,20
3710,161,9873,1309260,1309421,26
5677,242,9874,1464467,1464709,26
8612,222,9874,1309644,1309866,44
7111,237,9874,1464485,1464722,45
9012,63,9875,1310089,1310152,15
5505,165,9875,1310152,1310317,22
2415,8,9875,1310317,1310325,33
2082,281,9875,1474563,1474844,37
9329,217,9875,1310550,1310767,43
2822,127,9876,1310766,1310893,5
7654,204,9876,1310893,1311097,6
4455,117,9876,1311097,1311214,33
9702,166,9876,1311214,1311380,36
2718,2,9876,1311380,1311382,45
4169,278,9876,1464553,1464831,49
8519,56,9877,1311603,1311659,3
2441,250,9877,1464608,1464858,7
7042,269,9877,1464641,1464910,8
8308,206,9877,1312098,1312304,17
6748,252,9877,1464691,1464943,24
1149,295,9877,1475223,1475518,33
5920,217,9877,1312740,1312957,40
7028,219,9877,1312957,1313176,41
8218,202,9878,1313175,1313377,9
5381,44,9878,1313377,1313421,19
8664,69,9878,1313421,1313490,42
9794,88,9878,1313490,1313578,44
2664,11,9878,1313578,1313589,50
4957,49,9878,1313589,1313638,50
1768,52,9879,1313637,1313689,8
4774,289,9879,1474573,1474862,21
2364,142,9879,1313913,1314055,33
4135,218,9880,1314054,1314272,18
4186,15,9880,1314272,1314287,20
5063,273,9880,1464836,1465109,21
9774,109,9880,1314511,1314620,42
1140,28,9881,1314619,1314647,18
7943,299,9882,1475218,1475517,3
4803,278,9882,1464942,1465220,39
5407,82,9882,1315092,1315174,49
3131,153,9882,1315174,1315327,49
4738,245,9883,1464995,1465240,11
7244,127,9883,1315550,1315677,25
6586,203,9883,1315677,1315880,25
8603,290,9883,1474593,1474883,27
5498,36,9883,1316103,1316139,31
6767,225,9883,1465075,1465300,32
2158,275,9883,1465066,1465341,35
2181,142,9884,1316593,1316735,9
9231,140,9884,1316735,1316875,11
6782,168,9884,1316875,1317043,31
7191,17,9884,1317043,1317060,36
6132,209,9884,1317060,1317269,37
7480,114,9885,1317268,1317382,11
2954,57,9885,1317382,1317439,15
9104,264,9885,1465111,1465375,31
6741,69,9885,1317667,1317736,43
4111,244,9885,1465155,1465399,46
8008,204,9886,1317955,1318159,5
8798,218,9886,1318159,1318377,6
3453,140,9886,1318377,1318517,20
7633,256,9886,1465173,1465429,37
6575,118,9886,1318742,1318860,40
9196,52,9886,1318860,1318912,43
1527,226,9887,1465205,1465431,39
8933,189,9888,1319133,1319322,4
1737,261,9888,1465208,1465469,7
2090,90,9888,1319544,1319634,33
9459,265,9888,1465243,1465508,38
6915,206,9888,1319860,1320066,39
3695,29,9888,1320066,1320095,40
7718,57,9888,1320095,1320152,42
2552,285,9889,1474598,1474883,15
1749,35,9889,1320371,1320406,47
9275,9,9890,1320405,1320414,8
5590,67,9890,1320414,1320481,9
6311,58,9890,1320481,1320539,15
4497,31,9890,1320539,1320570,16
9132,58,9890,1320570,1320628,22
9107,89,9890,1320628,1320717,23
3112,10,9890,1320717,1320727,29
2161,105,9890,1320727,1320832,45
2496,278,9891,1465341,1465619,3
9318,98,9891,1321054,1321152,18
9311,6,9891,1321152,1321158,25
9885,149,9891,1321158,1321307,25
5846,9,9891,1321307,1321316,26
5059,139,9892,1321315,1321454,3
9953,214,9892,1321454,1321668,8
2859,135,9892,1321668,1321803,35
4721,258,9892,1465395,1465653,39
3335,178,9892,1322026,1322204,41
1687,231,9893,1465429,1465660,3
3713,31,9893,1322426,1322457,20
7510,75,9893,1322457,1322532,22
4688,53,9893,1322532,1322585,28
7862,135,9893,1322585,1322720,29
6154,257,9893,1465434,1465691,30
5585,199,9893,1322946,1323145,32
7066,176,9893,1323145,1323321,36
5691,28,9893,1323321,1323349,43
8518,288,9894,1474597,1474885,5
4656,246,9894,1465526,1465772,10
5770,2,9894,1323793,1323795,14
4342,274,9894,1465552,1465826,15
1383,146,9894,1324015,1324161,27
5433,288,9894,1474602,1474890,39
3604,178,9894,1324384,1324562,41
8736,224,9894,1324562,1324786,45
7114,45,9895,1324785,1324830,23
6677,227,9895,1324830,1325057,31
1393,18,9895,1325057,1325075,39
2279,228,9895,1465660,1465888,41
2502,283,9896,1474606,1474889,1
7665,8,9896,1325524,1325532,5
2574,233,9896,1465720,1465953,11
8622,200,9896,1325756,1325956,28
1806,29,9896,1325956,1325985,29
3690,185,9896,1325985,1326170,30
2167,8,9896,1326170,1326178,33
1361,88,9897,1326177,1326265,4
2098,240,9897,1465730,1465970,5
7832,79,9897,1326487,1326566,7
7847,47,9897,1326566,1326613,26
5305,70,9897,1326613,1326683,46
7871,12,9897,1326683,1326695,50
9035,298,9898,1475286,1475584,9
3328,184,9898,1326912,1327096,26
2940,191,9898,1327096,1327287,50
7426,220,9899,1465812,1466032,22
2938,286,9899,1474620,1474906,25
9345,130,9899,1327719,1327849,50
2001,209,9900,1327848,1328057,1
3258,180,9900,1328057,1328237,7
2443,217,9900,1328237,1328454,13
9285,187,9900,1328454,1328641,24
9950,29,9900,1328641,1328670,43
9450,269,9901,1465869,1466138,1
3211,215,9901,1328894,1329109,16
4436,111,9901,1329109,1329220,42
5662,87,9902,1329219,1329306,12
7188,240,9902,1465917,1466157,42
1727,10,9903,1329525,1329535,1
1089,272,9903,1465930,1466202,30
9307,25,9903,1329761,1329786,31
7214,51,9903,1329786,1329837,41
2408,24,9903,1329837,1329861,45
3053,169,9904,1329860,1330029,16
3805,37,9904,1330029,1330066,40
5602,71,9905,1330065,1330136,9
3726,35,9905,1330136,1330171,13
4588,156,9905,1330171,1330327,15
9328,59,9905,1330327,1330386,18
1021,37,9905,1330386,1330423,36
6224,101,9905,1330423,1330524,39
6493,240,9906,1465978,1466218,4
6315,34,9906,1330744,1330778,12
2537,257,9906,1465994,1466251,26
3475,87,9906,1331002,1331089,27
4247,228,9906,1466025,1466253,30
6517,126,9906,1331315,1331441,34
1562,205,9907,1331440,1331645,15
8849,166,9907,1331645,1331811,29
4452,278,9907,1466022,1466300,36
7825,46,9907,1332041,1332087,49
2405,298,9908,1475200,1475498,3
7566,126,9908,1332309,1332435,28
7687,81,9908,1332435,1332516,36
9842,286,9908,1474630,1474916,38
8451,43,9908,1332742,1332785,44
3880,267,9909,1466186,1466453,14
8717,229,9909,1466231,1466460,40
6988,151,9909,1333231,1333382,50
4461,237,9910,1466235,1466472,11
8419,208,9910,1333605,1333813,16
7824,236,9910,1466258,1466494,22
8601,54,9910,1334027,1334081,25
5044,53,9910,1334081,1334134,31
9377,224,9911,1466275,1466499,9
7251,229,9911,1466280,1466509,29
6852,152,9911,1334570,1334722,40
7568,140,9911,1334722,1334862,48
5344,64,9912,1334861,1334925,8
3079,133,9912,1334925,1335058,10
4711,1,9912,1335058,1335059,24
9705,66,9912,1335059,1335125,27
1141,195,9912,1335125,1335320,33
7513,26,9913,1335319,1335345,24
2341,283,9914,1474634,1474917,9
3893,35,9914,1335562,1335597,39
3242,74,9914,1335597,1335671,43
2153,110,9915,1335670,1335780,15
7433,103,9915,1335780,1335883,36
1848,257,9916,1466340,1466597,5
3850,249,9916,1466373,1466622,21
4628,16,9916,1336328,1336344,28
8361,177,9916,1336344,1336521,33
5788,72,9917,1336520,1336592,5
2353,285,9917,1474634,1474919,13
8263,23,9917,1336820,1336843,41
4107,151,9918,1336842,1336993,2
2446,47,9918,1336993,1337040,25
1182,48,9919,1337039,1337087,5
8650,131,9919,1337087,1337218,15
8376,255,9919,1466451,1466706,15
5398,41,9919,1337438,1337479,23
2342,285,9919,1474634,1474919,28
9533,29,9919,1337699,1337728,36
5414,289,9920,1474636,1474925,17
2945,13,9920,1337951,1337964,31
2711,270,9920,1466600,1466870,38
7893,270,9920,1466650,1466920,46
4181,153,9921,1338409,1338562,1
4712,105,9921,1338562,1338667,5
2057,140,9921,1338667,1338807,6
3486,60,9921,1338807,1338867,7
9861,66,9921,1338867,1338933,10
7443,135,9921,1338933,1339068,22
7155,190,9921,1339068,1339258,23
7031,37,9921,1339258,1339295,29
9430,108,9921,1339295,1339403,30
1120,100,9921,1339403,1339503,49
3567,130,9922,1339502,1339632,13
6433,57,9922,1339632,1339689,19
3570,34,9922,1339689,1339723,24
2882,113,9922,1339723,1339836,26
6541,183,9922,1339836,1340019,27
7171,296,9922,1475190,1475486,32
3457,275,9922,1466751,1467026,34
4761,249,9922,1466800,1467049,38
3580,65,9922,1340690,1340755,50
6279,257,9923,1466823,1467080,2
4424,37,9923,1340979,1341016,10
9152,98,9923,1341016,1341114,23
2735,122,9923,1341114,1341236,27
9578,40,9923,1341236,1341276,30
4714,195,9923,1341276,1341471,31
5520,3,9923,1341471,1341474,40
4142,86,9923,1341474,1341560,42
8023,196,9924,1341559,1341755,2
6642,118,9924,1341755,1341873,4
2842,134,9924,1341873,1342007,10
4630,103,9924,1342007,1342110,28
3093,269,9924,1466853,1467122,30
8825,208,9924,1342336,1342544,36
9491,129,9925,1342543,1342672,37
3720,75,9926,1342671,1342746,19
6170,135,9926,1342746,1342881,19
1419,165,9926,1342881,1343046,40
6759,153,9926,1343046,1343199,41
9915,264,9927,1466895,1467159,17
4496,211,9928,1343421,1343632,40
3162,185,9928,1343632,1343817,48
1814,204,9928,1343817,1344021,50
5043,204,9929,1344020,1344224,26
8198,195,9929,1344224,1344419,29
5538,149,9930,1344418,1344567,28
6607,261,9930,1466932,1467193,34
6021,85,9930,1344791,1344876,36
4030,222,9930,1344876,1345098,36
5998,71,9930,1345098,1345169,42
3048,293,9930,1475186,1475479,48
7637,73,9931,1345391,1345464,8
5174,145,9931,1345464,1345609,12
5156,78,9931,1345609,1345687,28
6797,267,9931,1467014,1467281,35
3294,157,9931,1345921,1346078,45
4970,6,9931,1346078,1346084,49
6307,157,9932,1346083,1346240,3
7441,177,9932,1346240,1346417,30
8226,273,9932,1467063,1467336,33
2278,12,9933,1346633,1346645,25
8568,39,9933,1346645,1346684,29
4393,154,9933,1346684,1346838,29
2028,169,9934,1346837,1347006,6
9880,61,9934,1347006,1347067,29
7622,165,9934,1347067,1347232,32
4314,48,9934,1347232,1347280,33
5657,179,9934,1347280,1347459,33
3058,213,9934,1347459,1347672,42
1041,59,9935,1347671,1347730,15
1701,272,9935,1467118,1467390,19
8768,240,9935,1467171,1467411,25
3373,11,9935,1348164,1348175,26
9800,164,9935,1348175,1348339,33
9468,296,9936,1474654,1474950,14
4616,101,9936,1348563,1348664,18
1710,68,9936,1348664,1348732,27
2890,198,9936,1348732,1348930,34
6946,74,9937,1348929,1349003,15
9588,249,9937,1467240,1467489,31
4064,29,9937,1349231,1349260,40
7253,19,9938,1349259,1349278,12
5445,124,9938,1349278,1349402,12
3271,215,9938,1349402,1349617,32
3854,99,9938,1349617,1349716,39
9797,118,9938,1349716,1349834,39
7671,267,9938,1467265,1467532,48
6340,253,9939,1467314,1467567,8
7259,26,9939,1350273,1350299,12
6282,235,9940,1467341,1467576,1
4586,31,9940,1350523,1350554,22
6068,45,9940,1350554,1350599,43
7850,149,9940,1350599,1350748,48
7716,280,9941,1474667,1474947,11
3426,263,9941,1467409,1467672,15
3994,165,9941,1351191,1351356,16
9516,280,9941,1467450,1467730,18
6043,108,9941,1351578,1351686,22
2877,246,9941,1467505,1467751,23
4685,246,9941,1467532,1467778,25
5612,154,9941,1352130,1352284,26
5242,219,9941,1352284,1352503,27
4511,20,9941,1352503,1352523,45
2426,236,9941,1467555,1467791,48
5323,72,9942,1352745,1352817,2
5426,77,9942,1352817,1352894,5
3886,121,9942,1352894,1353015,29
2860,186,9942,1353015,1353201,46
4323,245,9943,1467562,1467807,20
1340,26,9944,1353426,1353452,14
4250,253,9944,1467580,1467833,30
1029,224,9945,1467610,1467834,6
9847,139,9945,1353899,1354038,7
8408,148,9945,1354038,1354186,12
4249,205,9945,1354186,1354391,20
7797,90,9945,1354391,1354481,22
7630,197,9945,1354481,1354678,34
5925,87,9945,1354678,1354765,36
3411,234,9945,1467615,1467849,47
6657,284,9946,1474661,1474945,3
7335,62,9946,1355206,1355268,5
4958,95,9946,1355268,1355363,11
4354,206,9946,1355363,1355569,12
4639,108,9946,1355569,1355677,13
6985,275,9946,1467679,1467954,20
8531,182,9946,1355904,1356086,24
3074,189,9946,1356086,1356275,32
3733,205,9946,1356275,1356480,35
3760,174,9947,1356479,1356653,9
5206,131,9947,1356653,1356784,10
8785,60,9948,1356783,1356843,2
1661,29,9948,1356843,1356872,31
4522,56,9949,1356871,1356927,5
8972,58,9949,1356927,1356985,5
3612,191,9949,1356985,1357176,6
4128,135,9949,1357176,1357311,26
1702,149,9950,1357310,1357459,14
3465,46,9950,1357459,1357505,20
2058,49,9950,1357505,1357554,22
2166,8,9950,1357554,1357562,23
8315,13,9950,1357562,1357575,26
4523,183,9950,1357575,1357758,47
3172,43,9950,1357758,1357801,48
4066,192,9951,1357800,1357992,1
4376,287,9951,1474666,1474953,4
9838,85,9951,1358213,1358298,9
6382,74,9951,1358298,1358372,48
6203,15,9952,1358371,1358386,11
9667,96,9952,1358386,1358482,11
3108,157,9952,1358482,1358639,20
3142,130,9952,1358639,1358769,23
1558,38,9952,1358769,1358807,27
9504,216,9952,1358807,1359023,29
6419,142,9952,1359023,1359165,34
7904,31,9952,1359165,1359196,41
7199,106,9953,1359195,1359301,29
9708,59,9953,1359301,1359360,46
8057,52,9953,1359360,1359412,50
2262,74,9954,1359411,1359485,1
1943,136,9954,1359485,1359621,9
5261,218,9954,1359621,1359839,12
6149,26,9954,1359839,1359865,21
5705,74,9954,1359865,1359939,22
6978,88,9954,1359939,1360027,27
6939,148,9954,1360027,1360175,42
6694,281,9954,1467776,1468057,43
6874,120,9954,1360398,1360518,47
5889,76,9955,1360517,1360593,3
7534,220,9955,1360593,1360813,23
7265,37,9956,1360812,1360849,20
9638,4,9956,1360849,1360853,47
4799,67,9957,1360852,1360919,30
4032,14,9958,1360918,1360932,16
1169,29,9958,1360932,1360961,16
7077,284,9958,1474667,1474951,27
2827,42,9958,1361184,1361226,35
6012,171,9959,1361225,1361396,2
9633,201,9959,1361396,1361597,24
7381,169,9959,1361597,1361766,38
1069,135,9959,1361766,1361901,39
1095,151,9960,1361900,1362051,45
6339,15,9961,1362050,1362065,9
4985,43,9961,1362065,1362108,25
7003,126,9962,1362107,1362233,1
1050,43,9962,1362233,1362276,16
8485,269,9962,1467886,1468155,29
9476,194,9963,1362494,1362688,33
5942,168,9963,1362688,1362856,47
8099,122,9964,1362855,1362977,3
3943,140,9964,1362977,1363117,4
8381,95,9964,1363117,1363212,11
6618,55,9964,1363212,1363267,14
2307,48,9964,1363267,1363315,22
2657,65,9964,1363315,1363380,35
5537,248,9964,1467931,1468179,40
8209,213,9964,1363602,1363815,41
5281,184,9964,1363815,1363999,42
4254,85,9965,1363998,1364083,21
4428,45,9965,1364083,1364128,24
5892,109,9965,1364128,1364237,43
6494,46,9965,1364237,1364283,47
2271,300,9965,1475219,1475519,49
9284,98,9966,1364504,1364602,2
2455,170,9966,1364602,1364772,5
3808,32,9966,1364772,1364804,38
9398,217,9967,1364803,1365020,14
7342,201,9967,1365020,1365221,16
6817,7,9967,1365221,1365228,22
6731,147,9967,1365228,1365375,25
2367,24,9967,1365375,1365399,32
4706,76,9967,1365399,1365475,38
1285,169,9967,1365475,1365644,42
6471,51,9967,1365644,1365695,45
1681,9,9967,1365695,1365704,50
3015,59,9968,1365703,1365762,8
8279,181,9968,1365762,1365943,49
7220,14,9969,1365942,1365956,10
2908,299,9969,1475217,1475516,24
6729,75,9970,1366174,1366249,4
8159,151,9970,1366249,1366400,28
1836,272,9970,1468066,1468338,30
1131,128,9970,1366626,1366754,34
3010,268,9971,1468111,1468379,38
7150,253,9971,1468156,1468409,48
3524,234,9972,1468184,1468418,11
5411,30,9972,1367425,1367455,21
1865,104,9972,1367455,1367559,22
6239,70,9972,1367559,1367629,24
7818,297,9972,1475149,1475446,37
9431,165,9973,1367853,1368018,1
2557,136,9973,1368018,1368154,13
9710,4,9973,1368154,1368158,45
6223,216,9975,1368156,1368372,2
6733,49,9975,1368372,1368421,3
3189,134,9975,1368421,1368555,8
5041,218,9975,1368555,1368773,11
1068,231,9975,1468245,1468476,14
3143,140,9975,1368998,1369138,43
4773,231,9976,1468258,1468489,8
4993,91,9976,1369354,1369445,17
1770,300,9976,1475146,1475446,17
3542,87,9976,1369669,1369756,26
5997,245,9976,1468321,1468566,30
9925,36,9976,1369982,1370018,45
7575,63,9977,1370017,1370080,25
5444,73,9977,1370080,1370153,43
1680,278,9978,1468342,1468620,7
5676,202,9978,1370374,1370576,9
3513,154,9978,1370576,1370730,17
6511,21,9978,1370730,1370751,20
9744,248,9978,1468397,1468645,50
9549,34,9979,1370973,1371007,16
4065,20,9979,1371007,1371027,19
8380,102,9979,1371027,1371129,41
4701,256,9979,1468420,1468676,45
9137,113,9979,1371353,1371466,49
2714,150,9979,1371466,1371616,49
2814,95,9979,1371616,1371711,50
3099,106,9979,1371711,1371817,50
1971,282,9980,1474708,1474990,48
6845,162,9981,1372038,1372200,3
8436,81,9981,1372200,1372281,8
7605,155,9981,1372281,1372436,31
9364,94,9981,1372436,1372530,37
8258,201,9981,1372530,1372731,39
6606,117,9982,1372730,1372847,27
2493,280,9982,1468506,1468786,43
9613,254,9983,1468564,1468818,4
6128,22,9983,1373290,1373312,7
5056,204,9983,1373312,1373516,12
6158,225,9983,1373516,1373741,30
5149,231,9983,1468598,1468829,42
2284,148,9984,1373960,1374108,4
6031,192,9984,1374108,1374300,8
8754,228,9984,1468610,1468838,9
7273,100,9984,1374518,1374618,23
4591,79,9985,1374617,1374696,9
4120,239,9985,1468607,1468846,36
4612,7,9985,1374926,1374933,44
2767,128,9986,1374932,1375060,11
4755,198,9986,1375060,1375258,11
1560,220,9986,1375258,1375478,26
5831,136,9986,1375478,1375614,36
9792,218,9986,1375614,1375832,36
4973,115,9986,1375832,1375947,38
8675,169,9986,1375947,1376116,40
5941,40,9986,1376116,1376156,47
1724,205,9987,1376155,1376360,13
7192,236,9987,1468616,1468852,13
4276,46,9987,1376588,1376634,37
2192,278,9988,1468626,1468904,2
8446,49,9988,1376858,1376907,4
6095,132,9988,1376907,1377039,8
1013,246,9988,1468686,1468932,9
5730,163,9988,1377257,1377420,10
1497,268,9988,1468709,1468977,10
6535,167,9988,1377643,1377810,11
1203,228,9988,1468757,1468985,15
7852,240,9988,1468758,1468998,16
1914,25,9988,1378257,1378282,19
6025,191,9988,1378282,1378473,38
5118,222,9988,1378473,1378695,43
8283,245,9989,1468783,1469028,22
4519,65,9989,1378908,1378973,27
9567,293,9989,1474701,1474994,37
7989,94,9990,1379197,1379291,1
5079,234,9990,1468858,1469092,11
7930,162,9990,1379515,1379677,12
9406,36,9990,1379677,1379713,26
2197,151,9990,1379713,1379864,37
7263,26,9990,1379864,1379890,43
7916,217,9991,1379889,1380106,43
9968,276,9992,1468870,1469146,15
8703,12,9992,1380325,1380337,33
7087,225,9992,1380337,1380562,37
3167,142,9992,1380562,1380704,43
3474,230,9992,1468924,1469154,44
3406,47,9993,1380925,1380972,3
5224,190,9993,1380972,1381162,4
9305,165,9993,1381162,1381327,14
6473,181,9993,1381327,1381508,16
2420,122,9993,1381508,1381630,35
8681,246,9993,1468923,1469169,36
9483,121,9993,1381860,1381981,39
2809,157,9993,1381981,1382138,40
4281,54,9993,1382138,1382192,49
1922,108,9994,1382191,1382299,11
5019,89,9994,1382299,1382388,14
2686,26,9994,1382388,1382414,17
5152,133,9994,1382414,1382547,20
9460,15,9994,1382547,1382562,35
9999,104,9994,1382562,1382666,37
8256,52,9995,1382665,1382717,8
8529,171,9995,1382717,1382888,15
1248,23,9995,1382888,1382911,16
3744,91,9995,1382911,1383002,21
2685,149,9995,1383002,1383151,45
8918,30,9996,1383150,1383180,29
8230,30,9996,1383180,1383210,31
2846,32,9996,1383210,1383242,31
1376,22,9996,1383242,1383264,33
1707,81,9996,1383264,1383345,37
1856,25,9996,1383345,1383370,45
2507,152,9997,1383369,1383521,15
6945,280,9997,1474707,1474987,15
8508,46,9997,1383741,1383787,19
1188,130,9997,1383787,1383917,21
8104,22,9997,1383917,1383939,38
1864,74,9997,1383939,1384013,38
8089,55,9998,1384012,1384067,6
1608,61,9998,1384067,1384128,8
7271,143,9998,1384128,1384271,15
7667,186,9998,1384271,1384457,18
4248,19,9998,1384457,1384476,25
1104,19,9998,1384476,1384495,43
6590,70,9999,1384494,1384564,25
7616,99,9999,1384564,1384663,36
7288,167,9999,1384663,1384830,42
1109,95,9999,1384830,1384925,47

Average Waiting Time = 844127

Average Turn Around Time = 844276
