Process,Burst Time,Arrival Time,Waiting Time,Turn Around Time,Priority
38,15,1,0,15,3
30,46,1,15,61,5
1,18,2,133632,133650,1
24,16,3,133639,133655,2
22,15,4,133644,133659,1
93,44,4,500489,500533,1
11,4,7,60,64,5
88,41,7,393021,393062,5
32,29,9,293976,294005,3
41,1,11,64,65,1
21,40,12,500493,500533,2
72,45,12,500503,500548,3
20,46,13,500515,500561,1
17,20,14,207250,207270,2
3,26,16,207250,207276,5
65,29,16,293993,294022,5
57,26,17,294002,294028,2
100,29,17,70,99,4
25,47,18,500524,500571,2
23,36,18,393056,393092,3
14,1,19,99,100,3
67,3,19,100,103,5
2,27,20,294018,294045,1
16,38,20,393065,393103,1
47,29,21,294031,294060,1
51,26,21,294041,294067,2
26,44,22,294030,294074,4
34,16,23,133698,133714,2
58,37,23,393077,393114,3
86,20,24,207304,207324,1
66,18,24,123,141,4
96,26,24,207306,207332,5
55,28,25,294060,294088,3
12,19,25,144,163,4
29,2,27,161,163,1
84,29,27,294069,294098,3
10,16,27,77016,77032,5
80,30,27,294075,294105,5
63,40,29,393079,393119,5
18,28,31,294090,294118,3
81,11,31,36305,36316,5
37,9,32,77031,77040,3
90,36,33,172,208,4
7,8,34,1901,1909,5
27,27,34,207329,207356,5
44,31,35,393090,393121,3
28,1,36,212,213,2
15,43,38,294081,294124,4
36,35,40,393091,393126,1
35,45,42,500517,500562,3
8,30,43,226,256,4
40,48,44,500528,500576,2
59,40,45,500543,500583,1
85,44,45,500551,500595,1
4,16,49,133742,133758,2
95,20,49,254,274,4
71,35,49,294120,294155,5
912,148,50,276,424,23
79,39,51,393118,393157,2
110,183,52,1415723,1415906,1
5,9,52,36320,36329,2
857,10,53,424,434,37
50,21,54,207372,207393,2
64,39,54,500564,500603,3
68,23,55,207383,207406,2
54,47,56,613788,613835,3
542,264,56,435,699,29
477,145,56,699,844,32
442,48,56,844,892,36
70,16,58,133767,133783,2
94,24,58,891,915,4
375,88,58,915,1003,41
899,191,58,1003,1194,44
985,170,58,393026,393196,46
33,19,59,207405,207424,1
60,22,59,207410,207432,1
612,65,60,735484,735549,5
811,241,60,1246,1487,17
809,132,60,1487,1619,39
489,49,62,1617,1666,46
46,5,63,36338,36343,3
623,130,63,1666,1796,49
97,49,64,613797,613846,3
83,15,64,77068,77083,5
207,287,64,1188134,1188421,24
39,23,65,294185,294208,2
61,48,65,613830,613878,2
456,271,65,1087272,1087543,45
53,41,66,500628,500669,2
69,36,66,393221,393257,4
9,3,67,2050,2053,1
49,16,67,207463,207479,2
87,29,67,294219,294248,3
539,107,67,2056,2163,36
183,37,67,207458,207495,40
74,7,68,36364,36371,3
78,7,69,36366,36373,3
76,35,69,393228,393263,4
196,213,69,1270797,1271010,25
45,36,70,393249,393285,1
729,75,70,133793,133868,22
577,110,70,393204,393314,37
717,87,70,294214,294301,48
217,13,71,77139,77152,39
121,143,72,1087441,1087584,8
126,290,73,1481995,1482285,1
75,2,73,2279,2281,3
77,36,74,393300,393336,1
91,19,74,207543,207562,2
298,46,74,613880,613926,2
649,2,74,2285,2287,29
89,36,75,393318,393354,3
92,26,77,294313,294339,3
602,198,77,1439040,1439238,3
823,14,77,2290,2304,12
173,193,77,856216,856409,27
989,230,78,1456199,1456429,2
316,293,78,1438993,1439286,17
959,151,80,1335338,1335489,2
99,48,81,613946,613994,2
42,30,82,294364,294394,4
52,17,82,77186,77203,5
276,205,82,1270914,1271119,39
82,15,83,133947,133962,2
860,235,85,1188325,1188560,11
424,148,85,613918,614066,45
760,12,86,2379,2391,50
19,1,87,2390,2391,2
712,277,87,1188319,1188596,41
62,5,88,2392,2397,1
849,116,88,393369,393485,36
798,269,88,1087506,1087775,41
454,205,88,1270956,1271161,44
13,25,89,294456,294481,1
98,37,90,393485,393522,1
56,50,90,614085,614135,2
73,27,90,294474,294501,3
274,160,90,976491,976651,49
426,36,91,134007,134043,8
321,30,91,207683,207713,30
48,10,93,36472,36482,5
43,24,95,294485,294509,1
390,223,97,1087591,1087814,48
794,65,98,735744,735809,2
937,55,98,614129,614184,2
6,25,99,207716,207741,4
31,47,99,500863,500910,4
714,211,100,1270965,1271176,50
841,62,103,2575,2637,7
787,164,103,500786,500950,18
480,229,103,1270989,1271218,50
815,222,104,1456210,1456432,1
292,187,105,1415781,1415968,5
933,80,106,393562,393642,9
502,111,106,856520,856631,20
215,151,106,856520,856671,35
866,71,107,2701,2772,45
894,202,108,1271074,1271276,25
398,228,108,1188514,1188742,46
872,8,109,36519,36527,4
435,8,109,2778,2786,6
675,299,109,1477034,1477333,10
916,94,109,500972,501066,28
523,38,111,294631,294669,6
300,69,111,614229,614298,23
194,249,112,1381608,1381857,20
148,251,112,1188577,1188828,30
907,230,114,1335330,1335560,25
840,34,114,207863,207897,26
537,103,116,501029,501132,41
682,91,116,614265,614356,47
562,146,117,1188721,1188867,8
767,291,122,1087750,1088041,33
941,191,123,1087893,1088084,47
460,116,124,856727,856843,10
184,265,124,1271104,1271369,30
758,163,125,1271224,1271387,8
844,38,126,134222,134260,41
306,224,130,1456225,1456449,6
169,2,130,2939,2941,16
297,152,131,1088011,1088163,25
339,190,132,614287,614477,18
237,228,133,1456251,1456479,4
713,161,133,1088055,1088216,25
200,295,133,1381616,1381911,35
408,8,133,14694,14702,41
546,183,133,735970,736153,42
494,220,134,1271250,1271470,50
965,66,135,393898,393964,24
629,132,135,501231,501363,42
163,288,136,1481968,1482256,2
742,29,137,2980,3009,27
622,236,138,976863,977099,41
525,33,139,208078,208111,10
453,217,139,1271298,1271515,26
422,75,139,614538,614613,46
385,11,139,36618,36629,47
308,164,140,1088157,1088321,12
687,56,140,3039,3095,21
113,196,140,856876,857072,27
396,68,141,736196,736264,6
359,74,141,614599,614673,26
598,222,142,1188820,1189042,28
947,135,142,856989,857124,46
253,251,143,1271303,1271554,47
218,206,147,856981,857187,21
935,292,147,1381685,1381977,25
862,255,149,1415762,1416017,15
889,181,149,1271444,1271625,40
382,151,149,1088323,1088474,44
547,46,150,134413,134459,28
688,58,151,3244,3302,33
335,121,152,1189028,1189149,4
595,150,154,857161,857311,46
942,78,155,394098,394176,19
388,186,157,1415845,1416031,6
376,201,157,1189007,1189208,26
822,4,157,3319,3323,26
311,253,158,1381773,1382026,49
632,125,161,977193,977318,23
634,135,164,857255,857390,35
268,156,165,614752,614908,32
651,183,168,977177,977360,28
344,218,168,857240,857458,31
786,137,170,614848,614985,34
162,209,174,977193,977402,14
213,152,174,614910,615062,34
331,266,176,857256,857522,18
535,46,177,394286,394332,6
521,233,177,1415798,1416031,12
796,46,177,501709,501755,44
226,21,179,77603,77624,30
209,180,183,614975,615155,11
779,180,184,857373,857553,27
659,1,187,3529,3530,14
271,142,188,857433,857575,28
304,227,188,1189019,1189246,46
807,9,189,36719,36728,16
693,217,190,1456249,1456466,1
190,74,190,501771,501845,15
138,2,193,3572,3574,23
952,136,193,615108,615244,41
204,51,194,295251,295302,47
997,246,195,1415818,1416064,13
871,175,195,1088449,1088624,26
439,179,195,977318,977497,38
589,294,196,1481940,1482234,1
731,101,196,977431,977532,6
897,16,196,3620,3636,24
608,19,198,208426,208445,2
203,284,200,1271444,1271728,46
265,284,201,1415828,1416112,44
252,254,203,1415899,1416153,40
510,110,206,501847,501957,27
514,253,206,1088476,1088729,36
238,107,206,857680,857787,39
413,211,207,857625,857836,45
175,165,208,1271623,1271788,8
833,124,209,977526,977650,40
663,104,211,501939,502043,19
212,227,215,1189176,1189403,47
957,74,217,615361,615435,26
923,298,218,1415890,1416188,44
908,150,221,1189292,1189442,40
122,18,222,134718,134736,29
999,77,223,502008,502085,20
950,95,223,295400,295495,42
836,73,223,3843,3916,45
119,96,224,615386,615482,50
996,162,225,1088653,1088815,12
112,68,225,394580,394648,15
604,66,227,394601,394667,10
552,133,227,615391,615524,31
391,241,229,1439050,1439291,9
630,80,230,502076,502156,50
782,285,231,977463,977748,22
563,70,231,615513,615583,44
618,216,232,1271638,1271854,25
755,218,233,1335563,1335781,15
639,258,234,1189260,1189518,37
880,12,235,77810,77822,14
455,53,235,208631,208684,28
812,12,236,4068,4080,13
635,160,239,502088,502248,22
417,133,239,736872,737005,24
281,110,240,977714,977824,44
587,166,243,502138,502304,18
703,34,245,134864,134898,9
976,217,247,1271667,1271884,17
199,95,248,736964,737059,39
594,34,249,134889,134923,13
887,261,249,1415964,1416225,40
332,23,250,208728,208751,3
854,5,250,4165,4170,47
305,160,251,615566,615726,36
367,132,254,736979,737111,30
718,146,254,736995,737141,38
370,21,255,77880,77901,19
487,283,256,1381885,1382168,50
177,114,257,857953,858067,7
732,161,257,502260,502421,18
189,279,260,1456166,1456445,12
351,134,263,857973,858107,46
327,199,263,1189406,1189605,49
101,277,265,1456203,1456480,9
421,80,265,295737,295817,42
603,63,265,394928,394991,47
445,255,266,1468215,1468470,6
793,106,266,394921,395027,27
667,282,267,1271717,1271999,38
601,149,270,977808,977957,47
972,187,271,858019,858206,43
233,211,272,1382020,1382231,9
386,173,272,1271858,1272031,10
926,1,274,4441,4442,14
949,64,275,295867,295931,12
801,229,275,1271845,1272074,29
817,133,277,737199,737332,38
642,159,277,977868,978027,49
259,286,278,1439036,1439322,17
914,194,278,1189578,1189772,23
720,209,278,1271913,1272122,29
962,249,278,1189603,1189852,30
172,281,278,1189613,1189894,41
674,130,280,1089057,1089187,8
504,239,283,1088991,1089230,16
558,234,287,1089029,1089263,48
333,292,288,1456206,1456498,15
541,60,288,208995,209055,32
751,196,288,858279,858475,32
349,72,289,209026,209098,32
301,164,290,615979,616143,11
149,138,290,395165,395303,22
420,201,291,1439148,1439349,5
330,272,292,1382033,1382305,25
404,25,293,37001,37026,18
694,288,294,1416040,1416328,44
394,168,296,737431,737599,32
468,26,297,209138,209164,17
461,179,298,502652,502831,22
757,14,299,14866,14880,32
134,100,299,502750,502850,41
885,197,299,978093,978290,48
155,64,301,616162,616226,6
568,79,301,502806,502885,8
902,45,301,296171,296216,40
536,262,303,1335724,1335986,50
222,233,306,1335782,1336015,23
269,63,307,737589,737652,4
416,57,309,616215,616272,1
783,19,309,78147,78166,26
641,251,311,1468206,1468457,5
904,102,311,502850,502952,19
726,129,311,616169,616298,27
830,28,314,296254,296282,2
451,111,314,502877,502988,43
832,85,314,616240,616325,46
221,56,317,4806,4862,7
129,103,317,737568,737671,8
681,236,317,1382112,1382348,15
934,280,317,1089160,1089440,42
585,97,319,395468,395565,11
146,169,320,502907,503076,18
781,65,324,737659,737724,4
762,73,325,296337,296410,8
771,257,326,1335800,1336057,35
211,247,329,1468226,1468473,3
958,149,330,616282,616431,21
342,228,330,1089266,1089494,48
392,104,331,737681,737785,8
533,45,331,209389,209434,35
132,20,332,78258,78278,9
167,217,332,1382154,1382371,13
548,266,332,1382160,1382426,20
790,133,334,1272207,1272340,3
749,10,336,5043,5053,37
336,119,340,858597,858716,26
927,92,341,503101,503193,12
144,236,341,1335901,1336137,25
154,97,343,395630,395727,41
943,88,344,616431,616519,8
262,148,346,1089418,1089566,20
518,286,346,1416064,1416350,44
886,45,346,5108,5153,48
986,276,347,1382214,1382490,25
284,63,347,296506,296569,41
701,70,348,296518,296588,11
513,186,348,1190009,1190195,25
206,298,348,1416081,1416379,50
915,232,349,1272255,1272487,26
186,65,350,209510,209575,27
223,165,350,978448,978613,35
881,254,350,1190027,1190281,48
554,67,351,737914,737981,1
384,108,352,737893,738001,47
153,127,352,858754,858881,49
633,180,353,1272331,1272511,9
628,67,353,395807,395874,35
968,81,354,395814,395895,9
135,135,354,1089602,1089737,44
495,207,354,1089577,1089784,46
325,4,356,5303,5307,5
362,93,357,616626,616719,13
273,183,358,503239,503422,18
340,217,358,1190099,1190316,28
315,4,359,5337,5341,4
677,127,359,616632,616759,38
870,170,361,737927,738097,36
777,284,362,1481814,1482098,2
607,127,362,616690,616817,34
150,184,362,1190185,1190369,39
964,8,365,5465,5473,18
877,26,366,135673,135699,6
982,119,366,738029,738148,47
418,189,367,858811,859000,21
403,251,367,1336016,1336267,23
637,155,368,858906,859061,30
647,73,369,209708,209781,37
267,245,370,1089665,1089910,16
310,2,370,5549,5551,17
145,3,372,5549,5552,4
512,235,372,1336057,1336292,49
258,224,373,1190193,1190417,11
705,98,375,616881,616979,12
708,172,375,738119,738291,32
572,19,375,135764,135783,44
474,69,375,396083,396152,47
176,160,376,1089798,1089958,12
567,79,376,503596,503675,50
380,59,377,396137,396196,17
545,141,377,616898,617039,32
826,10,377,5644,5654,44
171,233,379,1416153,1416386,12
527,18,379,5666,5684,28
586,275,381,1456229,1456504,10
918,228,381,1336114,1336342,15
365,145,382,503644,503789,11
888,229,382,1089802,1090031,27
648,49,382,5727,5776,34
475,271,382,1272353,1272624,38
429,294,383,1481819,1482113,4
242,202,383,1439170,1439372,6
991,252,384,1468245,1468497,4
313,78,384,617080,617158,26
329,116,386,859130,859246,7
890,207,388,978782,978989,16
896,25,389,78570,78595,8
205,36,390,209949,209985,30
198,300,392,1190286,1190586,24
272,66,394,5863,5929,34
449,65,395,503850,503915,25
151,251,395,1382357,1382608,44
379,215,397,1272499,1272714,29
188,237,397,1089953,1090190,32
501,39,400,297086,297125,39
395,94,400,5939,6033,45
940,237,406,1416218,1416455,12
837,78,406,6041,6119,34
553,145,407,859250,859395,47
168,26,408,210022,210048,39
802,277,408,1382396,1382673,44
620,32,409,210026,210058,40
105,7,409,6145,6152,44
473,144,409,859306,859450,47
109,146,410,738458,738604,38
348,30,411,135954,135984,24
656,94,412,503948,504042,14
883,158,414,978974,979132,50
939,205,415,978955,979160,27
136,29,416,6208,6237,28
734,126,416,738544,738670,35
746,123,418,503993,504116,11
165,38,418,78652,78690,27
973,115,419,738569,738684,12
763,240,420,1336233,1336473,39
322,295,420,1089988,1090283,42
230,4,424,6274,6278,8
448,285,425,1382401,1382686,11
852,34,425,6279,6313,15
111,271,425,1416196,1416467,20
346,81,427,396547,396628,24
814,46,429,6355,6401,7
735,93,429,396561,396654,11
319,1,429,6403,6404,42
827,148,430,1336381,1336529,1
706,145,430,617356,617501,31
556,60,431,738695,738755,4
616,90,431,210156,210246,18
728,222,435,1416263,1416485,7
769,300,435,978995,979295,22
557,236,436,1190527,1190763,46
987,185,437,1336379,1336564,8
141,161,438,1090248,1090409,25
497,153,438,979224,979377,35
788,3,439,6503,6506,23
875,196,440,617434,617630,18
856,195,441,859505,859700,43
431,53,442,136140,136193,38
818,297,442,1190532,1190829,41
741,197,445,1439153,1439350,4
920,37,445,78801,78838,28
893,80,446,297388,297468,27
898,51,447,504334,504385,5
990,247,447,1439136,1439383,7
661,163,449,1090316,1090479,17
853,12,450,78849,78861,3
954,19,451,78848,78867,6
846,230,452,979253,979483,45
244,133,453,979370,979503,10
719,166,454,1190707,1190873,9
381,4,454,6691,6695,19
285,115,454,396779,396894,45
529,267,455,1336351,1336618,35
256,195,459,1439199,1439394,2
775,17,459,6744,6761,27
107,155,459,738857,739012,48
317,258,462,1090303,1090561,21
361,217,462,1272691,1272908,29
254,251,463,1336416,1336667,50
838,159,464,396850,397009,18
979,106,465,504427,504533,31
409,68,466,297577,297645,11
571,247,467,1468193,1468440,6
850,107,469,297565,297672,45
816,61,470,297624,297685,8
876,177,472,859758,859935,24
606,196,473,1190808,1191004,23
353,99,475,297620,297719,45
580,134,476,1090511,1090645,7
772,200,477,979463,979663,37
644,111,478,739039,739150,35
792,166,478,1190869,1191035,40
509,88,478,297704,297792,43
181,68,480,7069,7137,22
314,76,480,617845,617921,25
360,106,481,739082,739188,17
664,69,481,7139,7208,45
910,224,482,1456268,1456492,4
270,266,483,1190815,1191081,27
530,205,485,1190916,1191121,17
522,13,485,7226,7239,24
806,280,486,859823,860103,18
922,40,489,78997,79037,18
835,222,490,739073,739295,18
956,215,490,859941,860156,34
157,193,490,859995,860188,45
318,287,492,1481742,1482029,5
627,134,492,860092,860226,15
579,198,492,860077,860275,41
789,93,495,618046,618139,35
463,282,496,1468175,1468457,9
930,36,497,136502,136538,11
696,235,502,1456317,1456552,4
753,260,502,1476814,1477074,4
373,208,503,1090591,1090799,28
293,63,505,210710,210773,32
236,13,507,79103,79116,16
774,91,507,297902,297993,37
369,200,510,860149,860349,21
593,92,513,504762,504854,24
492,231,514,1272790,1273021,26
354,219,514,1090639,1090858,38
724,166,516,1382655,1382821,1
723,58,518,504840,504898,39
407,188,519,860254,860442,16
483,224,520,1416370,1416594,8
901,207,520,1382651,1382858,9
672,199,520,1191057,1191256,29
401,248,521,1439229,1439477,10
636,7,522,7506,7513,31
831,297,523,1468195,1468492,10
662,177,523,1191130,1191307,13
142,146,523,860407,860553,30
869,224,524,1456379,1456603,2
347,58,524,298098,298156,12
932,54,524,298126,298180,16
995,245,525,1416432,1416677,40
491,293,527,1382683,1382976,29
278,195,529,1090833,1091028,30
574,194,530,1382796,1382990,7
839,5,532,7598,7603,9
722,298,532,1090781,1091079,33
414,196,532,860492,860688,45
795,137,534,397415,397552,22
859,223,538,979847,980070,16
133,182,540,1191217,1191399,20
486,92,544,618365,618457,13
925,100,545,298216,298316,42
864,60,546,397538,397598,29
892,294,547,1416402,1416696,49
879,46,550,7815,7861,20
865,203,550,1090938,1091141,46
861,212,551,979937,980149,32
704,176,554,1191256,1191432,23
450,267,554,1090947,1091214,43
193,253,556,1439262,1439515,9
756,225,556,860655,860880,42
873,230,556,1336669,1336899,49
249,159,557,1382869,1383028,2
540,46,558,298389,298435,50
511,221,560,1456368,1456589,5
551,6,560,7947,7953,35
476,76,561,397663,397739,24
605,38,562,397710,397748,44
891,135,563,1273103,1273238,2
185,74,563,505201,505275,30
921,37,564,79286,79323,27
520,2,565,7993,7995,41
532,135,568,739787,739922,38
992,1,569,8009,8010,25
115,223,569,1273050,1273273,26
813,242,569,980060,980302,42
929,263,569,980094,980357,42
277,203,571,1091117,1091320,19
498,40,571,136878,136918,41
312,275,572,1191282,1191557,41
152,280,574,1476760,1477040,6
936,116,574,397788,397904,42
645,41,575,8027,8068,48
275,31,576,211214,211245,10
984,35,577,298556,298591,5
747,116,577,739940,740056,28
670,143,577,1091246,1091389,40
255,258,578,1439300,1439558,13
197,52,580,618719,618771,2
251,31,580,211257,211288,39
399,36,585,8109,8145,22
592,162,587,860933,861095,19
761,270,588,1091184,1091454,41
613,197,592,1273117,1273314,20
438,243,593,739941,740184,18
488,179,593,860978,861157,48
500,61,595,298636,298697,8
824,245,595,1416507,1416752,13
243,134,597,980368,980502,20
423,288,597,1091243,1091531,31
621,2,599,8272,8274,11
975,112,599,861119,861231,20
279,27,599,137043,137070,50
919,93,600,618847,618940,30
478,157,601,618814,618971,36
867,146,603,618859,619005,27
610,17,604,8392,8409,13
519,205,604,1273154,1273359,20
764,229,605,1439321,1439550,8
733,215,606,861078,861293,36
227,21,606,8501,8522,38
214,199,607,1191444,1191643,15
538,71,609,619000,619071,40
851,53,611,505606,505659,44
685,174,613,1273219,1273393,7
590,33,613,8594,8627,20
611,9,614,8626,8635,13
104,203,616,1273227,1273430,20
459,4,616,8666,8670,46
358,110,617,1191572,1191682,3
245,100,618,398076,398176,27
565,292,618,1191431,1191723,36
192,12,619,8743,8755,40
419,165,620,505559,505724,22
116,87,620,298794,298881,48
791,168,622,740236,740404,43
993,181,623,740250,740431,42
496,127,623,861243,861370,49
555,102,624,8897,8999,33
576,282,624,1336684,1336966,47
671,290,628,1382800,1383090,29
804,278,629,1476751,1477029,1
960,140,630,1273378,1273518,5
900,68,630,211508,211576,32
909,94,631,298894,298988,42
400,60,632,9007,9067,45
730,55,632,398245,398300,50
174,292,636,1191547,1191839,45
447,29,637,79571,79600,12
967,244,639,1382879,1383123,15
178,75,639,9153,9228,21
295,82,643,861392,861474,5
744,269,643,1336797,1337066,26
219,30,644,298996,299026,5
234,152,644,505713,505865,33
131,142,645,861386,861528,47
994,195,647,980580,980775,24
652,194,647,861385,861579,36
437,14,649,9363,9377,24
528,172,649,1273399,1273571,40
638,45,651,211627,211672,12
507,143,654,505824,505967,11
828,163,654,1091643,1091806,13
264,69,654,619273,619342,25
485,117,656,505894,506011,37
366,32,658,299096,299128,6
334,244,658,1439306,1439550,8
928,172,658,1091692,1091864,26
288,47,659,9431,9478,22
588,233,659,740464,740697,22
524,294,661,1382876,1383170,29
953,61,666,9509,9570,34
584,98,667,861566,861664,44
225,242,667,1336886,1337128,49
195,101,669,861603,861704,44
1000,80,671,506022,506102,14
118,57,672,398492,398549,17
371,292,673,1416475,1416767,49
581,208,674,1439358,1439566,4
676,147,677,506011,506158,42
653,277,679,1091697,1091974,36
845,85,680,980828,980913,4
434,237,680,1191741,1191978,11
224,187,682,861604,861791,32
471,1,682,9722,9723,32
843,126,683,1273527,1273653,3
797,283,683,1336901,1337184,28
356,47,683,398630,398677,46
969,157,684,1191880,1192037,10
803,171,684,740726,740897,32
752,134,686,1273576,1273710,2
241,211,687,861667,861878,36
428,150,689,1091925,1092075,25
287,300,690,980738,981038,18
446,262,690,1336962,1337224,26
364,277,691,1091876,1092153,34
690,151,693,1092013,1092164,13
368,86,693,299345,299431,27
484,180,698,1416598,1416778,5
658,289,698,1191842,1192131,21
239,164,699,981011,981175,15
299,77,699,398765,398842,19
974,138,702,981059,981197,29
397,268,705,1382948,1383216,50
139,297,706,1091989,1092286,34
650,96,707,10009,10105,34
534,130,708,861997,862127,49
355,169,709,1273615,1273784,7
597,269,709,1273567,1273836,28
683,177,711,1273682,1273859,9
472,287,712,861941,862228,18
692,188,712,862095,862283,24
411,14,712,38129,38143,26
506,170,713,741107,741277,21
855,103,714,741198,741301,29
283,265,714,1191960,1192225,32
619,113,714,741237,741350,47
646,185,715,741202,741387,36
596,98,716,741307,741405,17
931,225,716,1337046,1337271,39
458,143,716,619881,620024,45
560,164,718,1092255,1092419,23
770,51,718,137654,137705,42
402,60,721,399021,399081,29
503,258,721,981140,981398,42
323,47,721,10388,10435,45
944,149,722,981284,981433,29
508,72,722,212145,212217,42
863,212,724,1273691,1273903,29
821,70,724,212181,212251,32
374,59,726,506643,506702,23
378,134,727,862279,862413,28
499,214,728,1273712,1273926,17
963,166,730,862297,862463,16
320,296,730,1337008,1337304,28
878,134,730,620049,620183,41
490,297,733,1192071,1192368,21
440,187,734,1273795,1273982,44
977,183,738,741458,741641,21
882,113,738,506715,506828,48
739,111,739,506747,506858,41
482,64,739,10607,10671,49
389,69,740,741589,741658,4
737,145,742,506774,506919,11
235,166,742,862379,862545,14
158,146,742,981414,981560,29
847,300,744,1273735,1274035,38
257,137,745,1092435,1092572,44
917,56,746,212353,212409,11
457,299,748,1476638,1476937,7
493,204,749,1383012,1383216,7
140,242,750,1273858,1274100,35
583,255,751,1192268,1192523,46
911,294,752,1416470,1416764,11
702,207,752,1192360,1192567,35
805,221,755,1456263,1456484,2
296,207,756,981537,981744,37
377,9,756,10792,10801,50
905,202,757,862562,862764,21
743,169,757,1092556,1092725,29
517,63,757,10849,10912,48
309,80,759,212437,212517,37
655,168,760,981627,981795,28
467,231,763,1456275,1456506,6
543,18,763,10940,10958,38
350,202,764,1273968,1274170,20
338,71,764,507078,507149,47
103,69,767,507098,507167,17
766,196,767,1192458,1192654,25
352,5,767,10995,11000,39
383,149,770,399386,399535,33
180,280,771,1092531,1092811,31
466,260,772,1439294,1439554,13
665,3,773,15274,15277,14
229,8,773,11069,11077,44
286,104,774,299968,300072,45
848,76,775,507144,507220,13
387,215,777,1456297,1456512,4
406,246,780,1468079,1468325,5
250,197,780,1274036,1274233,20
372,76,781,11165,11241,48
302,105,782,862822,862927,23
246,27,782,11242,11269,43
978,134,785,862817,862951,13
906,159,788,1192557,1192716,10
980,229,788,1192506,1192735,11
591,7,788,11278,11285,30
678,262,791,862754,863016,22
640,254,791,1337173,1337427,25
260,235,792,1274063,1274298,17
425,152,795,1337292,1337444,6
575,145,795,620584,620729,43
955,104,795,742028,742132,46
343,130,797,981862,981992,7
393,162,797,981874,982036,17
216,193,797,862937,863130,37
680,236,798,1092728,1092964,48
689,8,801,11440,11448,5
669,27,801,138117,138144,35
108,16,802,11453,11469,28
432,192,804,981902,982094,38
736,206,804,742056,742262,42
868,26,807,138146,138172,13
570,298,808,1192553,1192851,24
479,300,809,1476599,1476899,10
660,142,810,1274196,1274338,5
208,196,810,1192714,1192910,17
550,46,810,138173,138219,42
441,259,812,1383044,1383303,17
748,114,812,982089,982203,40
970,86,813,11524,11610,21
945,249,813,981994,982243,42
128,6,815,38389,38395,14
363,283,816,1274131,1274414,46
695,59,824,300309,300368,24
106,80,826,399823,399903,28
946,273,827,1274195,1274468,47
544,195,829,1274301,1274496,13
691,23,830,11642,11665,15
710,194,831,1274329,1274523,12
465,190,832,620844,621034,22
738,195,832,1192847,1193042,50
578,38,834,138259,138297,28
643,15,837,38397,38412,30
740,134,839,863262,863396,17
810,215,839,1274347,1274562,39
164,97,839,300364,300461,45
773,100,840,621000,621100,47
337,175,842,1416626,1416801,1
280,196,844,863258,863454,45
130,252,845,1383076,1383328,20
263,233,845,1093011,1093244,38
433,255,847,1383101,1383356,39
858,108,849,863403,863511,8
754,147,849,982270,982417,15
625,53,849,400021,400074,23
679,39,849,138352,138391,41
842,42,849,11924,11966,49
566,99,851,507683,507782,24
716,283,851,1383110,1383393,29
179,30,852,138384,138414,19
341,216,852,1274473,1274689,39
778,53,853,11986,12039,45
780,79,855,507743,507822,15
721,171,856,982310,982481,30
924,77,857,621164,621241,40
938,203,857,742461,742664,42
759,119,857,742577,742696,47
626,81,860,621216,621297,29
117,93,861,621223,621316,13
231,57,862,507866,507923,25
776,133,863,742574,742707,38
481,201,863,742554,742755,42
569,261,865,1383154,1383415,39
182,92,865,507895,507987,49
137,70,866,507927,507997,15
988,43,866,213071,213114,19
526,65,866,507952,508017,26
614,293,868,1337286,1337579,28
981,193,870,1193058,1193251,39
191,169,870,621263,621432,42
874,130,871,507963,508093,37
415,157,871,621304,621461,42
324,44,874,300754,300798,26
615,38,877,300767,300805,26
715,192,879,1274559,1274751,20
707,47,879,12244,12291,21
505,244,881,1383182,1383426,15
247,88,881,621410,621498,50
120,133,882,508029,508162,45
307,68,884,12365,12433,7
727,275,884,1274513,1274788,48
201,285,886,1193057,1193342,32
452,33,887,400388,400421,2
290,57,888,12472,12529,36
202,222,888,982423,982645,37
785,249,891,1383205,1383454,20
709,25,891,80530,80555,41
114,202,892,1383270,1383472,9
631,210,894,1093307,1093517,30
430,215,894,1274648,1274863,39
819,150,895,863652,863802,30
564,226,897,1274677,1274903,29
561,175,897,742824,742999,32
961,189,898,863666,863855,27
784,287,900,863631,863918,18
600,237,900,1274699,1274936,35
170,228,902,1456232,1456460,4
971,129,902,508264,508393,32
768,267,903,1337378,1337645,11
248,121,903,621676,621797,14
808,26,905,138740,138766,26
998,84,906,621733,621817,17
291,151,907,621703,621854,21
913,146,911,742972,743118,14
765,188,912,1193295,1193483,50
725,216,916,982600,982816,41
143,172,917,863856,864028,16
326,88,917,301052,301140,42
711,202,920,1439302,1439504,5
220,299,921,1467935,1468234,13
884,90,923,301090,301180,27
160,156,924,982708,982864,15
125,113,924,400652,400765,42
668,226,927,1456260,1456486,4
948,59,927,301164,301223,28
166,61,930,621922,621983,6
684,46,934,12742,12788,20
147,124,936,1193401,1193525,5
427,290,938,1416524,1416814,49
232,55,940,213498,213553,11
464,235,941,863911,864146,42
599,22,943,12828,12850,28
266,6,943,15370,15376,42
698,48,944,301220,301268,14
582,140,945,982774,982914,20
410,129,946,1274880,1275009,2
210,8,948,80731,80739,2
470,81,948,301220,301301,31
289,132,949,621929,622061,41
657,17,950,138909,138926,4
294,104,950,621990,622094,15
895,42,951,138902,138944,12
654,222,951,743103,743325,33
820,214,952,1274817,1275031,15
700,234,952,1093487,1093721,27
951,178,952,982838,983016,46
357,55,954,622130,622185,1
686,294,954,1481309,1481603,4
303,4,954,13033,13037,26
983,223,956,1456284,1456507,3
825,162,957,1093604,1093766,12
282,185,957,743295,743480,34
799,174,957,743354,743528,34
261,178,959,864106,864284,27
444,4,960,13162,13166,10
573,186,960,982905,983091,30
531,266,960,982883,983149,42
673,88,962,983078,983166,1
161,135,964,400884,401019,18
666,9,965,13180,13189,18
559,98,965,400934,401032,21
240,155,966,1093641,1093796,39
102,77,967,13239,13316,48
750,233,968,1093601,1093834,16
624,224,969,1456301,1456525,1
187,177,969,1193431,1193608,13
412,243,969,1274858,1275101,35
228,170,971,1274948,1275118,10
156,291,972,1193416,1193707,24
834,104,973,401038,401142,42
697,163,974,864336,864499,19
609,80,975,139083,139163,18
462,190,983,622290,622480,18
159,89,985,508895,508984,35
515,220,985,983096,983316,45
469,41,986,80893,80934,31
829,187,987,1093758,1093945,35
903,73,987,508958,509031,50
443,274,988,1193448,1193722,45
549,294,989,1274863,1275157,38
345,173,990,1383374,1383547,5
800,125,991,1275064,1275189,2
436,37,993,13493,13530,7
124,41,993,13530,13571,15
328,98,994,509008,509106,10
127,15,994,38809,38824,11
617,175,994,1093881,1094056,17
405,105,994,864527,864632,40
745,82,996,509059,509141,12
516,15,998,38826,38841,11
123,137,999,1093934,1094071,8
699,92,999,509083,509175,10
966,19,999,139255,139274,39
5374,182,8000,1409653,1409835,1
8254,42,8000,294731,294773,20
6485,161,8000,736735,736896,30
1334,186,8000,976310,976496,35
6359,287,8001,1474303,1474590,1
1428,198,8001,1376399,1376597,7
4178,51,8001,206990,207041,37
7034,197,8001,857546,857743,40
8887,133,8002,736858,736991,13
9247,276,8002,1186586,1186862,15
5675,1,8002,8457,8458,22
8643,2,8002,8458,8460,25
4482,235,8002,1330537,1330772,38
9982,48,8003,294839,294887,9
4605,134,8003,615646,615780,40
2990,14,8004,132367,132381,1
1598,43,8004,502291,502334,5
8866,222,8004,736848,737070,17
3073,186,8004,1186740,1186926,25
6527,143,8004,615723,615866,40
7531,95,8004,502330,502425,42
3834,109,8004,976501,976610,43
6656,142,8004,857729,857871,50
3882,48,8005,615854,615902,5
5851,54,8005,615863,615917,5
6750,288,8005,1268025,1268313,20
1163,200,8005,1268141,1268341,22
1839,207,8005,1186808,1187015,27
5567,58,8005,207171,207229,30
9570,240,8005,1087094,1087334,33
1052,141,8005,857856,857997,47
3470,157,8006,976591,976748,45
9480,238,8006,1186826,1187064,45
6959,148,8007,737178,737326,15
8305,172,8007,1186916,1187088,22
4228,123,8007,857975,858098,27
5410,254,8007,1268120,1268374,37
3748,151,8008,1186993,1187144,7
9191,157,8008,1187007,1187164,11
4917,20,8008,74193,74213,44
6639,195,8008,1087285,1087480,45
2688,160,8009,858054,858214,20
5539,157,8009,976758,976915,46
5821,15,8009,74220,74235,49
5603,286,8010,1460935,1461221,8
3049,218,8010,1087296,1087514,10
2826,193,8010,1087349,1087542,20
7648,12,8010,74253,74265,29
9836,27,8010,207356,207383,29
2348,43,8011,295177,295220,11
6143,203,8011,976804,977007,13
4602,237,8011,1087360,1087597,23
7359,94,8011,616246,616340,34
1709,174,8011,858195,858369,36
5571,19,8011,74293,74312,40
9202,141,8011,858258,858399,47
6151,213,8012,1087431,1087644,20
8269,207,8012,858265,858472,31
2878,215,8012,976896,977111,32
9349,84,8012,502819,502903,37
9064,88,8012,394891,394979,40
2152,155,8013,502777,502932,17
4319,179,8013,1187026,1187205,25
6228,248,8013,1186990,1187238,36
4174,164,8013,1187102,1187266,38
5903,111,8013,394960,395071,41
3779,204,8014,1087545,1087749,18
9105,30,8014,74392,74422,30
6884,259,8014,1268159,1268418,35
7454,4,8014,32151,32155,48
9434,250,8015,1087568,1087818,31
5141,236,8015,1087619,1087855,32
9895,170,8015,858509,858679,32
2636,221,8015,1087679,1087900,33
2003,152,8016,1330654,1330806,1
5487,173,8016,1409700,1409873,3
5115,57,8016,616599,616656,6
3707,163,8016,1268299,1268462,9
9735,81,8016,503067,503148,23
3447,165,8017,1376476,1376641,5
9849,201,8017,977208,977409,23
5182,174,8017,858653,858827,42
8229,208,8018,977250,977458,42
5324,48,8018,295587,295635,46
3260,213,8019,1376461,1376674,19
1122,259,8019,1330663,1330922,24
1648,36,8019,207708,207744,44
5688,18,8020,132887,132905,13
9826,36,8020,74490,74526,31
3408,71,8020,395260,395331,42
5780,32,8021,395308,395340,2
8071,83,8021,395288,395371,18
6147,173,8021,616632,616805,41
2397,109,8021,616722,616831,42
2340,245,8021,1187203,1187448,45
2273,65,8021,395382,395447,47
7910,200,8022,1432361,1432561,5
2987,91,8022,977462,977553,6
6452,2,8022,8629,8631,10
4477,257,8022,1330703,1330960,13
8714,108,8022,616812,616920,37
1413,6,8023,32259,32265,2
9868,82,8023,977514,977596,3
6977,16,8023,32262,32278,21
6597,128,8023,616824,616952,36
9454,248,8023,1187259,1187507,36
8746,112,8024,295744,295856,17
1210,141,8024,977517,977658,22
6336,261,8025,1187281,1187542,15
6862,27,8025,133032,133059,32
5844,158,8025,858927,859085,44
4538,257,8026,1376458,1376715,16
4448,181,8026,1187418,1187599,25
5527,251,8026,1187386,1187637,33
7486,293,8026,1268347,1268640,44
6301,13,8026,133087,133100,50
4209,46,8027,503447,503493,6
5562,59,8027,295899,295958,8
8119,2,8027,8672,8674,8
3203,218,8027,1268458,1268676,28
9814,254,8027,977621,977875,30
6635,120,8027,859133,859253,46
5053,299,8028,1376473,1376772,28
6174,84,8028,503494,503578,34
7855,169,8028,859128,859297,36
1487,67,8028,395649,395716,37
1670,297,8028,1330742,1331039,44
1294,238,8029,1409671,1409909,19
3965,292,8029,1268506,1268798,23
9788,176,8029,977827,978003,33
4901,181,8029,1088184,1088365,47
2719,80,8030,738393,738473,25
7747,12,8030,133214,133226,43
9725,136,8031,1268689,1268825,3
8112,165,8031,1268678,1268843,8
5645,58,8031,395776,395834,16
5478,250,8031,1187634,1187884,20
5093,8,8031,32413,32421,25
5813,112,8031,859383,859495,25
2511,143,8031,859389,859532,29
8395,170,8031,859390,859560,32
6999,176,8031,859417,859593,36
8732,269,8031,1432327,1432596,39
5938,198,8031,859461,859659,40
5868,128,8031,977985,978113,49
1798,283,8032,1474301,1474584,4
7272,186,8032,617311,617497,17
1307,172,8032,859557,859729,18
6374,296,8032,1330850,1331146,29
9172,174,8032,617411,617585,41
9897,238,8032,1409739,1409977,48
8084,191,8033,1376691,1376882,7
6869,8,8033,74873,74881,9
3727,233,8033,1268757,1268990,16
3584,76,8033,617570,617646,25
9659,28,8033,296325,296353,48
9212,59,8034,296310,296369,40
2383,15,8035,74891,74906,18
2570,3,8035,32516,32519,23
3070,186,8035,978058,978244,33
8277,208,8035,1187818,1188026,47
5078,193,8036,1409815,1410008,4
5186,288,8036,1376656,1376944,28
4446,243,8036,978109,978352,30
6491,276,8036,1376696,1376972,34
1666,293,8036,1187852,1188145,40
1115,117,8036,859875,859992,49
3861,259,8037,1469505,1469764,2
1006,290,8038,1474321,1474611,6
2436,108,8038,617739,617847,23
4493,58,8038,296446,296504,32
4182,219,8038,1268919,1269138,38
1755,195,8039,1432470,1432665,6
1002,290,8039,1409794,1410084,13
3714,151,8039,978374,978525,28
6926,257,8039,1268948,1269205,37
2334,59,8039,296512,296571,40
2257,102,8040,1088663,1088765,3
4530,42,8040,296547,296589,34
6933,288,8040,1376788,1377076,34
1802,272,8040,1268989,1269261,36
8417,144,8040,504102,504246,41
6270,22,8040,208537,208559,45
7082,169,8041,1088674,1088843,16
8532,299,8041,1331085,1331384,20
8078,219,8041,1269122,1269341,22
2422,242,8041,1188173,1188415,45
8364,142,8042,1188288,1188430,7
5401,77,8042,617992,618069,22
2813,215,8042,1088780,1088995,29
2421,250,8042,978555,978805,30
9321,285,8042,1188200,1188485,32
7004,235,8042,1188292,1188527,35
5052,89,8042,860305,860394,43
2277,46,8043,504368,504414,6
3547,57,8043,396416,396473,16
7029,150,8043,978750,978900,28
4340,241,8043,1188339,1188580,37
4168,41,8043,504414,504455,43
2534,284,8043,1376844,1377128,49
7972,144,8044,1331284,1331428,4
1230,19,8044,75124,75143,11
9029,102,8044,504405,504507,18
9517,9,8044,8835,8844,21
2755,205,8044,1269207,1269412,22
9469,149,8044,978859,979008,46
1020,178,8045,1331272,1331450,7
9319,241,8045,1432453,1432694,7
6614,37,8045,75157,75194,30
8648,53,8046,396540,396593,20
2026,236,8046,1088980,1089216,26
4741,52,8046,208749,208801,26
1767,34,8046,296880,296914,38
5108,86,8046,504502,504588,42
7746,191,8046,1089060,1089251,45
5954,255,8047,1188453,1188708,36
6644,21,8047,32733,32754,36
8276,107,8048,1089192,1089299,6
9660,100,8048,504569,504669,13
6904,251,8048,1432462,1432713,14
6193,265,8048,1409904,1410169,19
6713,3,8048,32763,32766,22
2228,285,8048,1089116,1089401,30
3346,280,8048,1188527,1188807,33
7760,177,8049,1410014,1410191,2
1882,35,8049,396702,396737,6
5509,291,8050,1469507,1469798,7
1189,170,8050,860592,860762,13
4414,4,8050,8909,8913,18
7157,218,8051,1188660,1188878,27
6805,125,8051,860674,860799,34
6587,198,8052,1432556,1432754,2
1378,184,8052,1331382,1331566,11
1585,116,8052,504716,504832,36
8102,79,8052,396761,396840,40
4105,290,8052,1331328,1331618,46
9356,111,8053,1188843,1188954,3
4349,265,8053,979121,979386,21
9419,83,8053,618520,618603,33
4655,237,8053,1089350,1089587,40
6848,197,8054,1432578,1432775,5
7984,35,8054,297160,297195,16
8524,51,8054,396880,396931,20
5158,156,8054,979302,979458,34
3523,248,8054,1269373,1269621,47
5653,147,8055,1188866,1189013,7
6822,69,8055,618630,618699,14
1926,81,8055,618640,618721,16
5420,215,8055,979310,979525,31
5967,168,8056,1377107,1377275,5
2892,262,8056,1410027,1410289,48
3881,46,8057,134029,134075,10
3039,116,8057,618671,618787,18
2675,101,8057,618721,618822,20
1040,174,8057,860901,861075,23
2596,80,8057,739814,739894,24
8596,299,8057,1089428,1089727,41
9669,246,8058,1269431,1269677,10
2168,116,8058,1089646,1089762,19
2968,187,8058,979451,979638,26
6240,210,8058,979472,979682,36
1785,155,8059,1089637,1089792,14
6931,97,8059,739935,740032,22
9829,75,8059,618941,619016,49
2593,105,8060,1089712,1089817,2
9230,221,8060,1089641,1089862,33
6294,261,8060,1269452,1269713,35
1942,179,8060,739944,740123,41
3478,177,8060,979651,979828,45
1779,293,8061,1331406,1331699,20
2653,103,8061,979769,979872,48
6992,64,8061,619109,619173,48
4004,13,8061,75529,75542,49
4104,202,8063,1432593,1432795,3
7093,42,8063,397264,397306,25
7913,115,8063,740112,740227,46
8340,274,8064,1469548,1469822,4
1014,212,8064,979744,979956,23
7149,104,8064,740181,740285,46
2063,98,8065,505326,505424,13
4858,138,8065,1189028,1189166,19
6260,208,8065,1269597,1269805,49
4363,172,8066,1377186,1377358,5
6484,25,8066,297589,297614,33
2744,8,8066,75580,75588,46
3312,206,8067,979835,980041,36
9678,273,8067,1331507,1331780,47
9597,193,8067,1331617,1331810,48
8575,165,8068,1377220,1377385,1
2286,92,8068,980026,980118,3
8426,50,8068,619300,619350,3
2777,147,8068,861382,861529,37
3841,5,8068,33026,33031,48
8817,146,8068,861437,861583,50
5654,158,8069,1377244,1377402,6
1750,296,8069,1461006,1461302,12
9809,111,8069,397426,397537,21
5926,286,8069,1269668,1269954,36
9278,286,8069,1331618,1331904,46
3868,135,8070,1269882,1270017,2
9256,201,8070,1331725,1331926,14
3632,69,8070,209470,209539,21
1290,49,8070,297731,297780,27
1053,88,8070,619401,619489,28
2738,267,8071,1331704,1331971,34
9129,37,8071,505615,505652,43
9381,223,8072,1377238,1377461,19
8578,228,8072,1269898,1270126,28
8762,39,8072,209573,209612,34
7840,1,8073,9055,9056,6
5471,190,8073,980116,980306,13
3609,46,8073,297810,297856,15
8767,96,8073,740522,740618,16
9042,143,8073,1090107,1090250,24
4338,96,8073,619515,619611,27
9153,177,8073,980189,980366,35
3938,64,8074,740610,740674,1
4364,30,8074,297884,297914,4
4037,217,8074,1410126,1410343,11
4786,78,8074,297871,297949,21
5037,41,8074,297923,297964,28
4554,232,8074,980194,980426,31
9877,2,8074,9088,9090,45
1121,6,8074,75780,75786,48
7487,204,8074,1269964,1270168,49
8884,5,8075,33134,33139,24
3257,54,8075,209696,209750,30
3956,58,8075,505761,505819,50
1241,18,8076,209744,209762,3
4367,87,8076,505761,505848,13
8106,257,8076,1331775,1332032,13
8024,156,8076,1090176,1090332,25
8148,137,8076,619631,619768,40
7614,69,8077,298009,298078,8
4147,226,8077,1269995,1270221,16
1643,199,8077,861760,861959,31
9635,30,8077,298090,298120,33
4841,105,8078,619726,619831,13
3245,159,8078,1090221,1090380,28
2917,285,8078,1269997,1270282,35
4410,154,8079,861894,862048,29
5614,189,8079,1090257,1090446,50
3917,28,8080,134648,134676,18
4603,115,8080,861994,862109,22
2008,32,8080,298161,298193,24
5802,283,8080,1270039,1270322,26
2086,156,8080,619804,619960,41
9656,148,8080,862019,862167,44
2863,211,8080,1270147,1270358,49
4747,27,8081,209937,209964,20
3226,75,8081,397938,398013,32
7467,55,8081,298239,298294,34
9746,18,8081,134745,134763,35
2000,159,8081,1090383,1090542,38
8509,159,8081,862087,862246,44
5706,54,8082,298275,298329,8
8076,6,8082,33249,33255,8
4274,236,8082,1410131,1410367,12
6187,148,8082,980550,980698,16
3118,244,8082,1189407,1189651,18
3804,264,8082,1410160,1410424,19
6199,241,8082,1331876,1332117,38
1994,18,8083,33263,33281,21
6076,265,8083,1377285,1377550,24
1744,164,8083,980641,980805,29
3483,292,8083,1331900,1332192,29
5569,251,8083,1189536,1189787,42
1991,145,8084,741068,741213,13
9429,6,8084,33293,33299,19
4220,72,8084,506215,506287,27
5211,300,8084,1331944,1332244,29
4576,15,8084,76012,76027,32
2021,284,8084,1410172,1410456,38
3318,235,8085,1461075,1461310,2
9079,5,8085,33311,33316,29
5863,242,8085,1270358,1270600,34
9641,81,8085,741217,741298,38
8133,106,8085,741227,741333,45
9617,147,8086,1332167,1332314,1
3701,95,8086,1090719,1090814,3
2786,9,8086,33326,33335,8
2404,265,8086,1377346,1377611,13
5966,241,8086,1090636,1090877,15
5286,63,8086,298499,298562,18
9563,29,8086,76054,76083,30
4682,17,8086,134919,134936,39
3420,273,8086,1270408,1270681,50
9928,83,8087,980985,981068,1
8961,73,8087,398259,398332,9
2930,228,8087,1332132,1332360,24
8824,12,8087,33364,33376,40
8996,142,8087,620288,620430,40
6868,94,8088,981016,981110,4
1302,88,8088,620374,620462,12
2772,68,8088,620410,620478,50
4988,274,8089,1469563,1469837,5
8117,243,8089,1189790,1190033,20
3464,62,8089,298616,298678,40
2758,295,8090,1090726,1091021,21
6801,253,8091,1332140,1332393,13
2319,47,8091,298683,298730,28
7490,106,8091,620477,620583,37
3595,132,8091,862645,862777,46
7595,201,8092,1377451,1377652,7
1589,31,8092,298751,298782,33
6438,241,8093,1461108,1461349,4
8586,45,8093,398462,398507,14
2862,38,8093,210352,210390,15
4213,93,8093,981154,981247,19
8537,42,8093,210374,210416,27
5299,100,8093,741525,741625,28
3225,105,8093,620557,620662,37
8986,58,8093,210400,210458,41
2235,76,8093,741571,741647,48
7694,171,8094,1377527,1377698,6
5034,77,8094,620622,620699,16
9066,250,8094,1189891,1190141,20
5161,66,8094,398537,398603,42
4167,91,8094,862778,862869,43
7696,235,8095,1270559,1270794,13
7836,153,8095,862776,862929,23
2545,13,8095,76256,76269,27
3876,32,8096,135150,135182,7
2514,192,8096,862771,862963,30
7299,30,8096,76270,76300,36
5991,85,8096,862893,862978,39
5510,23,8097,210522,210545,39
4689,266,8098,1189939,1190205,26
4008,134,8098,620732,620866,36
6783,81,8098,741755,741836,38
5009,85,8098,862932,863017,43
9022,227,8098,1190017,1190244,45
6709,248,8099,1377467,1377715,16
5155,300,8099,1377449,1377749,27
2548,235,8099,1377564,1377799,48
4478,174,8100,1410340,1410514,2
9560,152,8100,620839,620991,41
1339,56,8100,299006,299062,42
2068,240,8101,1461131,1461371,1
3424,138,8101,506827,506965,10
3460,123,8101,863028,863151,28
7664,268,8101,1091033,1091301,30
9392,268,8101,1190106,1190374,31
3327,24,8101,299108,299132,43
5081,125,8102,981406,981531,8
7027,4,8102,9332,9336,8
8980,70,8102,621015,621085,22
1394,43,8102,398857,398900,24
9407,175,8103,1091188,1091363,16
5750,42,8103,210722,210764,18
6549,241,8103,1332333,1332574,22
4797,215,8103,863101,863316,30
7935,165,8103,741955,742120,31
2709,81,8103,398905,398986,32
3179,292,8103,1410271,1410563,49
3575,248,8104,1461156,1461404,3
7744,136,8104,1270851,1270987,4
4756,230,8104,1190241,1190471,10
5453,39,8104,399008,399047,19
1118,141,8104,981527,981668,22
6548,66,8105,863330,863396,1
6286,278,8105,1377645,1377923,22
4828,120,8105,981590,981710,25
7068,11,8105,33656,33667,44
7590,281,8105,1432648,1432929,48
7902,57,8106,399053,399110,13
9399,175,8106,1091341,1091516,34
3790,270,8106,1377728,1377998,38
2730,139,8107,1270951,1271090,6
9313,113,8107,621249,621362,15
4667,187,8107,1091394,1091581,29
3536,97,8107,399108,399205,40
2905,185,8108,1410446,1410631,6
8035,127,8108,981708,981835,9
6819,181,8108,1190411,1190592,28
5740,139,8109,1270994,1271133,6
8362,208,8109,1432750,1432958,6
6381,82,8109,742289,742371,14
3321,72,8109,507291,507363,47
1893,143,8109,863491,863634,50
5317,121,8110,981777,981898,7
7652,79,8110,621409,621488,16
2816,45,8110,399277,399322,22
2120,48,8110,299475,299523,23
6406,216,8110,1091477,1091693,35
9819,18,8110,135598,135616,45
9443,199,8110,1091542,1091741,50
9565,3,8111,33727,33730,1
8390,129,8111,621433,621562,18
1692,250,8111,1332511,1332761,25
7147,229,8111,1332560,1332789,49
6772,231,8112,1461186,1461417,1
3903,186,8112,1091655,1091841,34
2601,144,8112,863647,863791,37
1706,187,8112,1332649,1332836,39
6024,218,8114,1410462,1410680,11
8864,81,8114,507471,507552,23
6495,88,8115,507494,507582,13
4394,91,8115,742494,742585,25
7391,93,8115,507518,507611,26
1035,101,8115,742502,742603,27
2520,84,8115,299623,299707,41
4202,190,8116,1410520,1410710,4
4830,111,8116,742529,742640,27
9791,245,8116,1190513,1190758,36
2607,172,8116,1271128,1271300,39
4017,7,8116,76718,76725,43
9974,70,8117,399510,399580,13
3537,131,8117,621640,621771,32
6529,212,8117,1271124,1271336,49
2928,225,8118,1449461,1449686,4
2369,10,8118,9446,9456,7
6627,243,8118,1271128,1271371,10
5793,82,8118,742641,742723,22
4812,4,8118,9459,9463,25
9120,60,8118,399615,399675,28
4842,51,8119,299796,299847,9
9214,95,8119,621780,621875,20
8625,295,8119,1332644,1332939,27
5722,202,8119,863758,863960,31
8925,18,8120,135836,135854,15
3877,255,8120,981963,982218,21
7831,240,8120,982027,982267,30
7710,289,8122,1432722,1433011,16
1139,290,8122,1332698,1332988,18
2352,275,8122,1091801,1092076,41
6205,196,8122,1271302,1271498,43
2260,259,8122,1271277,1271536,50
5496,290,8123,1410469,1410759,10
1708,121,8123,864067,864188,22
9931,231,8123,1091956,1092187,42
5890,251,8124,1461191,1461442,6
4624,183,8124,621985,622168,17
8696,32,8124,135953,135985,18
8711,160,8124,1092076,1092236,22
6967,52,8124,507993,508045,24
1092,17,8124,135988,136005,34
8776,227,8124,1271369,1271596,34
7059,29,8125,300063,300092,5
4765,114,8125,622125,622239,23
5375,194,8125,982333,982527,23
7410,234,8125,1190828,1191062,29
2103,39,8125,136019,136058,37
3069,290,8125,1332779,1333069,46
2358,132,8125,864230,864362,47
1512,264,8125,1410564,1410828,48
9750,157,8126,1271510,1271667,7
8309,257,8126,1190931,1191188,44
1686,35,8127,136075,136110,10
8724,71,8127,399995,400066,18
3835,111,8127,1092281,1092392,19
3939,117,8127,743076,743193,20
8808,155,8127,622267,622422,31
5423,76,8127,400054,400130,32
5228,255,8127,1271463,1271718,46
2926,93,8128,1092341,1092434,2
2677,221,8128,743037,743258,17
2517,157,8128,1271587,1271744,19
5073,294,8128,1092209,1092503,21
4322,8,8128,77033,77041,48
4207,254,8129,1271540,1271794,46
2018,113,8130,1191176,1191289,1
3952,169,8130,1191147,1191316,12
2624,68,8130,622505,622573,14
7464,101,8131,743257,743358,11
1083,241,8131,1332886,1333127,22
9883,190,8131,1092432,1092622,34
1213,15,8132,34040,34055,7
9576,169,8132,508261,508430,17
9820,126,8132,743292,743418,37
6109,67,8133,300380,300447,8
2083,206,8133,982630,982836,10
1426,238,8133,1432802,1433040,11
9575,2,8133,9578,9580,15
8982,76,8133,508439,508515,23
4059,283,8133,1191122,1191405,32
5988,97,8133,300445,300542,41
4659,116,8134,982776,982892,7
1489,220,8134,1271646,1271866,16
8469,52,8134,136333,136385,17
5646,166,8134,864557,864723,33
6361,237,8134,1377981,1378218,48
6468,200,8135,1432867,1433067,1
7418,83,8135,400385,400468,8
4188,25,8135,211891,211916,22
4942,65,8135,622733,622798,25
5996,59,8135,508555,508614,25
4277,283,8135,1377994,1378277,28
9892,151,8135,622715,622866,30
7262,128,8135,864663,864791,34
2978,117,8135,508573,508690,36
1061,244,8136,1333010,1333254,22
5197,86,8136,622832,622918,28
9074,163,8136,1191374,1191537,38
5576,202,8137,982852,983054,23
6547,298,8137,1332985,1333283,36
5993,277,8138,1378026,1378303,34
9863,290,8138,1432826,1433116,48
2887,153,8139,1378192,1378345,1
4261,163,8139,1271892,1272055,8
9288,130,8139,508702,508832,21
8855,227,8139,1092695,1092922,26
9719,83,8139,622965,623048,27
6341,183,8140,743587,743770,21
8487,111,8140,864875,864986,22
3957,21,8140,136581,136602,34
9187,223,8140,1191445,1191668,37
9909,177,8141,1410718,1410895,6
8422,167,8141,1092837,1093004,14
9844,21,8141,34233,34254,17
6010,178,8141,1191545,1191723,38
2810,98,8142,743765,743863,16
2858,198,8142,743715,743913,21
6778,77,8142,400746,400823,26
6793,159,8143,864928,865087,23
1130,159,8143,864952,865111,26
3314,146,8143,623112,623258,31
6919,254,8143,1092828,1093082,32
1783,300,8143,1333090,1333390,36
6317,208,8143,983119,983327,40
7414,142,8143,983207,983349,46
9769,225,8144,1410688,1410913,12
1420,69,8144,400915,400984,13
1675,279,8144,1092893,1093172,30
3083,105,8145,744013,744118,9
4348,209,8145,1333226,1333435,14
1816,7,8145,77437,77444,16
7412,31,8146,77426,77457,30
6561,173,8146,623279,623452,41
4719,209,8147,865101,865310,21
7900,298,8147,1378125,1378423,25
1679,125,8147,865236,865361,28
3627,226,8147,983245,983471,30
8472,10,8147,34364,34374,37
6840,143,8147,509151,509294,41
5439,267,8147,1378194,1378461,49
2972,31,8147,301162,301193,50
9830,179,8148,865280,865459,13
6064,225,8148,1333304,1333529,38
6504,182,8148,983370,983552,44
9600,19,8149,136861,136880,9
4597,78,8149,401127,401205,37
7154,180,8150,1410749,1410929,4
2727,127,8150,1272110,1272237,5
8097,11,8150,77550,77561,5
4479,291,8150,1378229,1378520,25
9061,222,8150,1272092,1272314,25
2666,219,8150,983433,983652,31
2585,120,8150,401176,401296,41
4313,181,8151,1410772,1410953,5
6921,270,8151,1449441,1449711,8
9759,162,8151,1191826,1191988,12
1252,265,8151,1191764,1192029,15
4910,221,8151,1093254,1093475,20
4945,78,8151,301302,301380,31
3762,17,8151,77621,77638,40
5465,44,8152,212540,212584,7
6991,221,8152,1272147,1272368,34
2370,259,8152,1432896,1433155,39
5803,221,8153,1378380,1378601,14
8512,253,8153,1378375,1378628,16
8319,89,8153,623752,623841,45
6150,250,8153,1272219,1272469,47
9194,281,8154,1461156,1461437,11
5269,84,8154,744508,744592,39
5157,51,8155,623849,623900,1
2320,113,8155,983759,983872,7
6073,256,8155,1378417,1378673,16
3990,257,8155,1272281,1272538,18
1473,169,8155,983779,983948,20
2337,53,8155,401464,401517,20
7146,56,8155,212661,212717,21
6117,130,8155,983850,983980,24
8075,102,8156,1093563,1093665,3
5703,233,8156,1333511,1333744,43
1264,197,8156,1093520,1093717,44
1158,287,8156,1272344,1272631,50
7417,193,8157,1432998,1433191,1
7360,54,8157,624002,624056,6
6462,15,8157,77743,77758,15
7383,296,8157,1192034,1192330,40
2923,234,8157,865815,866049,41
5236,57,8157,401582,401639,46
8555,290,8157,1333521,1333811,46
5519,235,8158,1461219,1461454,6
1742,160,8158,865945,866105,26
7686,204,8158,1192203,1192407,27
2802,87,8158,624102,624189,29
1078,25,8159,212839,212864,22
8093,215,8159,1272525,1272740,24
5953,24,8159,301668,301692,48
6422,250,8160,1461238,1461488,6
5362,61,8160,401677,401738,12
4729,272,8160,1272538,1272810,29
3614,18,8160,137242,137260,46
9038,231,8161,1449570,1449801,2
2880,124,8161,509781,509905,10
5940,46,8161,401748,401794,29
3660,72,8161,401742,401814,32
9720,251,8162,1461276,1461527,1
3227,242,8162,1461315,1461557,3
6434,238,8162,1461345,1461583,3
5138,281,8162,1474231,1474512,5
8055,229,8162,1449687,1449916,5
2014,35,8162,137298,137333,8
7429,71,8162,624230,624301,45
8759,77,8162,744931,745008,48
9058,295,8163,1449658,1449953,19
1622,166,8163,1093898,1094064,25
9474,30,8163,212971,213001,42
6259,37,8164,301795,301832,16
1432,117,8164,744946,745063,34
8497,257,8165,1469552,1469809,1
2424,142,8165,744963,745105,18
3973,74,8165,745053,745127,43
9577,170,8166,1093950,1094120,14
9505,19,8166,34655,34674,30
8727,76,8166,301818,301894,31
8905,28,8166,137395,137423,32
8314,95,8167,624329,624424,8
1703,138,8167,509967,510105,10
7756,117,8167,866198,866315,12
8621,147,8167,1192475,1192622,19
8304,161,8167,745057,745218,32
8960,286,8167,1192385,1192671,40
3846,224,8168,1411021,1411245,7
3428,93,8168,624433,624526,34
9502,179,8168,866236,866415,42
5854,231,8168,1192500,1192731,50
2619,25,8169,302008,302033,3
8180,283,8169,1474249,1474532,5
3230,142,8169,1094106,1094248,9
7372,20,8169,137515,137535,15
2787,166,8169,866335,866501,42
1649,257,8170,1272735,1272992,20
6645,72,8170,510235,510307,28
5457,300,8170,1333742,1334042,45
4646,203,8170,1192636,1192839,46
7293,19,8170,137561,137580,46
8267,267,8171,866362,866629,17
8750,56,8171,137570,137626,31
7280,285,8172,1449736,1450021,14
3122,10,8172,9934,9944,36
4073,101,8172,624628,624729,47
4165,178,8172,1272898,1273076,48
5333,213,8172,1272901,1273114,49
6744,254,8173,1272897,1273151,29
2833,90,8173,624705,624795,35
2035,74,8173,624744,624818,45
8821,287,8174,1192708,1192995,23
1577,280,8174,1272909,1273189,36
4336,170,8174,984564,984734,45
1168,213,8174,1273014,1273227,49
5296,254,8175,1461421,1461675,3
4879,149,8175,1192933,1193082,7
9096,34,8175,302236,302270,29
7988,215,8175,866669,866884,30
8170,295,8176,1333814,1334109,18
9726,88,8177,402312,402400,10
9701,130,8177,624856,624986,40
4219,280,8178,1378689,1378969,24
5795,83,8178,745623,745706,24
9535,3,8178,9984,9987,44
5689,61,8179,745659,745720,2
2703,1,8180,9987,9988,9
1124,127,8180,984704,984831,11
2359,230,8180,1273108,1273338,16
4999,217,8180,1273166,1273383,22
4833,39,8180,137771,137810,26
8631,222,8180,1094430,1094652,36
8205,268,8180,1273164,1273432,37
1889,154,8180,1094552,1094706,49
6616,234,8181,1461459,1461693,1
8863,62,8181,745787,745849,1
4475,136,8181,1273339,1273475,3
5732,177,8181,1411147,1411324,6
7919,80,8181,510677,510757,15
2999,32,8181,302435,302467,29
8393,97,8181,866991,867088,39
6562,222,8181,1094577,1094799,44
7300,233,8182,1094608,1094841,36
5251,183,8182,1193117,1193300,38
8990,292,8182,1449795,1450087,39
9138,158,8182,867037,867195,42
7914,71,8183,402597,402668,13
3709,257,8183,1433233,1433490,14
4021,62,8183,402635,402697,15
5173,232,8183,745808,746040,17
5408,259,8183,1273299,1273558,35
7475,127,8183,625225,625352,42
9677,196,8183,1094794,1094990,46
3788,202,8184,1433313,1433515,4
1630,176,8184,625256,625432,21
4835,75,8184,625380,625455,25
8779,130,8184,625362,625492,26
2733,92,8184,746024,746116,50
6603,62,8185,402797,402859,12
8294,107,8185,985068,985175,19
7776,12,8185,34994,35006,40
4091,115,8185,746036,746151,47
4339,125,8186,1273465,1273590,1
6161,279,8186,867076,867355,17
8922,40,8186,138036,138076,26
8019,12,8186,78399,78411,34
6492,19,8186,78401,78420,37
6222,177,8187,1273438,1273615,11
7582,190,8187,1334048,1334238,11
9802,148,8187,625481,625629,21
5643,210,8187,985034,985244,40
5905,42,8188,511098,511140,6
3412,131,8188,625572,625703,13
8323,123,8188,746157,746280,23
7351,182,8188,867273,867455,42
3027,178,8188,1273479,1273657,43
7012,90,8189,402982,403072,10
9622,271,8189,1334025,1334296,25
2298,61,8189,511175,511236,29
2131,117,8189,625681,625798,32
8938,4,8189,35092,35096,42
3498,154,8190,1193333,1193487,9
8418,129,8190,403032,403161,17
6837,92,8190,746277,746369,22
1896,86,8190,625758,625844,29
6141,83,8190,511241,511324,42
8331,297,8190,1334038,1334335,45
7742,45,8191,511307,511352,5
5513,44,8191,302970,303014,20
4160,137,8191,985220,985357,22
4744,82,8191,625814,625896,28
5045,107,8191,403162,403269,41
7938,142,8191,1193398,1193540,48
6885,215,8192,1449884,1450099,5
7103,246,8192,1461469,1461715,5
9414,133,8192,746354,746487,20
6795,19,8192,78564,78583,40
9190,277,8193,1474254,1474531,2
6037,85,8193,511366,511451,9
7450,214,8193,1095020,1095234,20
6217,115,8194,1193488,1193603,1
4025,25,8194,214041,214066,4
4876,2,8194,10125,10127,4
6739,109,8194,746446,746555,11
8542,200,8195,1433385,1433585,4
7198,11,8195,35172,35183,26
5555,122,8195,625908,626030,40
9203,224,8195,1095071,1095295,42
4809,266,8195,1273551,1273817,44
8200,178,8196,1411287,1411465,5
7556,55,8196,403386,403441,12
6387,112,8196,746535,746647,29
2036,296,8196,1334157,1334453,37
9133,31,8196,303203,303234,45
9691,227,8196,1378942,1379169,48
1941,207,8196,1273710,1273917,49
7973,26,8196,214155,214181,50
1144,68,8197,626085,626153,24
2147,257,8197,1378959,1379216,43
4788,168,8197,985487,985655,50
1451,205,8198,1379044,1379249,7
3870,27,8198,303268,303295,19
8399,58,8198,403484,403542,20
7347,209,8199,1379061,1379270,12
2213,260,8199,985486,985746,30
4960,216,8199,985571,985787,40
4637,22,8199,303331,303353,43
8184,282,8200,1474269,1474551,3
3753,282,8200,1461497,1461779,9
5191,186,8200,626150,626336,10
7275,190,8200,626215,626405,10
3216,291,8200,1273778,1274069,20
3765,142,8200,746773,746915,23
9020,258,8200,1095294,1095552,31
4509,163,8200,867848,868011,44
3594,248,8201,1273846,1274094,10
2440,156,8201,1095446,1095602,24
3487,284,8201,1095376,1095660,30
7631,67,8201,303457,303524,32
6949,108,8202,867982,868090,7
7676,71,8202,403728,403799,18
4476,101,8202,626506,626607,35
6198,286,8202,1193619,1193905,40
2527,203,8203,1433444,1433647,1
6044,58,8203,747012,747070,1
9685,165,8203,511863,512028,17
3390,7,8203,35365,35372,32
7060,171,8203,985836,986007,37
7064,298,8203,1411262,1411560,38
6533,164,8203,985900,986064,45
7848,8,8203,78866,78874,50
8917,69,8204,868137,868206,1
2044,71,8204,512022,512093,11
3347,10,8204,138672,138682,24
5178,136,8204,868106,868242,27
1733,61,8204,403898,403959,28
7896,71,8204,403906,403977,37
8370,281,8204,1433421,1433702,39
2985,137,8204,1095641,1095778,48
1365,141,8204,985990,986131,49
7388,242,8205,1411377,1411619,19
8386,209,8205,868126,868335,21
8589,77,8205,512127,512204,29
8739,283,8206,1461512,1461795,12
8181,236,8206,1095616,1095852,15
2697,279,8206,1273970,1274249,37
3698,174,8206,986080,986254,37
8401,78,8207,986187,986265,1
5237,78,8207,868371,868449,3
2660,116,8207,747262,747378,45
6543,77,8207,747324,747401,48
6648,4,8208,10266,10270,25
1017,239,8208,1274046,1274285,27
9277,52,8208,214630,214682,40
4572,186,8208,986151,986337,44
5270,166,8209,1379273,1379439,2
8014,94,8209,986277,986371,4
3280,152,8209,747350,747502,15
4801,234,8209,1274114,1274348,16
4772,156,8209,868412,868568,23
8197,146,8209,512301,512447,41
8221,43,8209,404212,404255,45
7252,78,8210,868508,868586,6
1665,189,8210,1334517,1334706,8
5150,174,8210,747431,747605,31
9121,43,8210,138877,138920,31
7800,290,8210,1334452,1334742,35
3986,238,8210,986224,986462,41
3249,241,8211,1274170,1274411,10
8088,203,8211,1274239,1274442,22
5514,282,8211,1274201,1274483,26
9979,47,8211,404359,404406,33
6454,198,8211,986361,986559,42
8476,54,8211,304029,304083,44
3843,279,8212,1334529,1334808,25
1830,228,8212,1194057,1194285,27
8667,251,8212,1194092,1194343,35
2170,29,8212,138995,139024,37
5867,72,8212,214870,214942,41
2953,163,8212,986512,986675,46
5682,152,8213,1334686,1334838,2
8953,273,8213,1274306,1274579,20
6997,76,8213,627243,627319,22
7370,114,8213,404427,404541,31
5473,159,8213,868738,868897,33
9782,19,8213,139075,139094,34
2205,242,8213,1095965,1096207,40
1988,135,8213,747785,747920,42
2951,87,8213,627327,627414,46
3646,48,8214,304194,304242,15
3159,299,8214,1411368,1411667,24
4736,268,8214,1379238,1379506,24
8935,3,8215,35616,35619,38
9188,98,8215,512718,512816,42
7851,57,8216,404607,404664,16
1614,142,8216,868846,868988,20
6078,144,8216,1096130,1096274,24
2456,297,8216,1379256,1379553,34
7307,118,8216,1096196,1096314,39
7585,235,8216,1194268,1194503,44
8687,141,8216,986759,986900,49
4197,81,8217,869023,869104,4
1762,263,8217,1449942,1450205,9
7572,150,8217,1096237,1096387,24
9426,223,8217,986762,986985,32
2037,116,8217,748023,748139,35
6390,73,8217,627545,627618,49
2343,195,8218,1433553,1433748,3
9977,263,8218,1469589,1469852,3
4099,84,8219,748093,748177,14
6927,278,8219,1274476,1274754,18
2800,74,8219,627619,627693,24
3146,293,8219,1274513,1274806,36
6520,235,8219,1096273,1096508,42
4243,73,8220,869192,869265,4
6169,272,8220,869051,869323,17
8007,251,8220,1274589,1274840,29
6953,4,8220,10395,10399,49
9651,286,8220,1379371,1379657,49
2655,209,8221,1379478,1379687,8
4177,63,8221,404936,404999,20
6571,10,8221,79356,79366,23
1515,231,8221,1194474,1194705,29
9878,289,8221,1334773,1335062,46
7317,148,8222,748252,748400,36
2946,172,8222,1096497,1096669,49
1780,102,8222,748351,748453,50
1992,40,8223,513192,513232,2
9347,166,8223,987071,987237,20
1154,239,8223,869289,869528,21
3291,103,8223,869448,869551,25
2795,219,8223,1096492,1096711,33
3591,195,8223,1096552,1096747,37
6420,52,8223,513272,513324,38
6581,126,8223,1096646,1096772,39
9696,16,8223,215408,215424,43
7814,229,8224,1379499,1379728,48
8563,103,8225,627954,628057,20
4832,54,8225,513320,513374,38
8438,34,8226,215425,215459,12
4940,182,8226,1274768,1274950,14
3621,149,8226,1194655,1194804,19
9978,7,8226,10441,10448,21
3494,236,8226,1334882,1335118,24
9821,94,8226,513333,513427,32
5727,163,8226,869571,869734,33
2105,195,8226,1274829,1275024,43
9562,125,8226,869659,869784,50
4883,118,8227,1194765,1194883,1
6944,149,8227,869674,869823,23
7602,95,8227,405219,405314,30
4331,33,8228,215518,215551,9
6760,36,8228,304799,304835,22
4468,285,8228,1274799,1275084,35
4884,93,8228,513437,513530,44
2047,184,8228,1274942,1275126,48
9528,96,8229,628143,628239,23
7628,38,8229,139524,139562,37
5621,288,8229,1411465,1411753,43
2070,38,8230,513535,513573,3
7599,282,8230,1461531,1461813,12
4155,188,8230,1194808,1194996,16
7007,10,8230,139578,139588,24
5106,48,8230,215589,215637,26
1300,32,8230,139581,139613,37
1204,149,8230,869821,869970,45
1190,177,8231,1275024,1275201,48
5310,218,8232,1275015,1275233,16
6780,88,8232,628275,628363,16
6047,99,8233,1096948,1097047,5
3440,153,8233,1096918,1097071,12
5865,288,8233,1379528,1379816,28
5425,2,8233,10490,10492,39
6691,173,8234,987465,987638,45
7934,58,8235,748913,748971,5
4359,239,8235,1433563,1433802,7
3222,79,8235,304937,305016,31
6770,278,8235,1275052,1275330,37
5535,118,8236,870012,870130,16
2739,138,8236,987572,987710,22
3767,76,8237,870090,870166,6
3485,58,8237,405505,405563,16
7438,59,8237,305027,305086,18
4431,218,8237,1194917,1195135,29
9176,276,8237,1096934,1097210,30
4725,220,8237,1275153,1275373,49
5103,17,8238,139747,139764,22
4865,4,8238,35931,35935,28
1897,207,8238,1097064,1097271,44
1700,85,8239,987748,987833,6
6952,234,8239,1433585,1433819,8
1367,193,8239,870130,870323,31
1902,149,8239,987720,987869,34
2553,84,8239,513815,513899,34
4762,256,8239,987662,987918,41
6690,17,8240,139828,139845,28
5607,235,8240,1335038,1335273,43
4116,225,8240,1195008,1195233,45
8841,120,8241,1195137,1195257,6
2615,42,8241,305206,305248,13
2679,235,8241,1275211,1275446,27
1612,23,8241,215919,215942,48
2476,84,8242,987931,988015,4
8061,73,8242,305214,305287,30
6280,217,8243,1450029,1450246,1
9280,144,8243,1335161,1335305,4
7727,292,8243,1461548,1461840,9
7331,25,8243,215966,215991,19
3197,238,8243,1097229,1097467,26
4754,5,8243,36008,36013,27
2513,126,8243,628661,628787,30
3319,231,8243,987892,988123,31
1766,122,8243,749290,749412,33
8349,26,8244,36031,36057,17
1062,4,8244,10591,10595,29
5927,6,8244,36055,36061,35
6861,227,8244,1195138,1195365,37
8158,232,8244,1335129,1335361,38
3148,84,8244,749386,749470,39
2760,185,8245,1335198,1335383,9
2540,58,8245,139948,140006,17
4813,196,8245,628731,628927,17
6776,215,8245,1195235,1195450,34
5447,145,8246,1097433,1097578,9
4123,198,8246,988061,988259,23
8478,126,8246,628880,629006,26
3577,146,8246,1097467,1097613,38
8670,100,8247,749459,749559,8
9631,71,8247,405947,406018,8
9742,189,8247,1195298,1195487,49
2445,46,8248,405994,406040,16
3397,266,8248,1411581,1411847,16
3305,57,8248,629015,629072,19
5636,17,8248,140107,140124,19
5741,71,8248,514221,514292,34
4854,187,8248,1335233,1335420,48
8021,200,8249,749459,749659,21
5635,9,8249,10630,10639,30
5914,98,8249,629039,629137,34
8045,98,8250,749578,749676,12
9612,153,8250,1097549,1097702,14
7719,115,8250,749617,749732,16
7001,250,8250,1335219,1335469,22
9664,212,8250,988229,988441,23
2595,264,8250,1335262,1335526,28
7476,219,8250,988293,988512,32
6446,290,8250,1275403,1275693,50
9984,177,8251,1275545,1275722,9
3437,142,8251,749736,749878,32
1735,78,8251,514436,514514,34
2212,299,8251,1450002,1450301,39
4484,289,8251,1195409,1195698,40
2547,144,8251,1195576,1195720,48
4409,143,8251,1195598,1195741,48
4570,135,8252,749857,749992,35
7387,240,8253,749809,750049,17
4916,156,8253,1097757,1097913,22
2575,235,8253,1275538,1275773,27
6285,295,8253,1335297,1335592,29
1496,214,8253,988524,988738,31
6595,294,8253,1195560,1195854,40
8434,102,8253,629428,629530,47
8494,82,8254,988701,988783,1
4378,209,8254,988623,988832,15
9614,187,8254,1195692,1195879,16
1342,153,8254,1275673,1275826,19
1775,31,8254,216487,216518,25
3416,190,8254,1195751,1195941,25
6231,90,8254,406435,406525,30
4097,3,8254,36254,36257,34
3549,8,8254,80108,80116,46
7726,198,8255,1433696,1433894,4
1486,226,8255,1411689,1411915,8
9663,71,8255,140377,140448,17
8760,9,8255,80138,80147,45
8835,174,8256,988774,988948,20
6136,283,8257,1474238,1474521,5
9273,42,8257,305952,305994,11
6091,131,8257,750202,750333,20
3866,263,8257,1195768,1196031,26
7611,234,8257,988801,989035,31
1199,121,8257,629611,629732,40
9786,116,8257,750283,750399,44
6040,79,8258,871182,871261,5
2288,275,8258,1469599,1469874,6
1164,293,8258,1335378,1335671,15
8654,268,8258,1275656,1275924,36
7264,293,8258,1335419,1335712,37
1696,216,8259,1450142,1450358,2
3715,118,8259,1098150,1098268,19
5071,243,8259,1275776,1276019,34
9433,98,8259,629787,629885,47
8271,250,8260,1433733,1433983,9
3325,128,8260,989088,989216,25
2066,62,8260,514989,515051,28
4722,271,8260,1335508,1335779,47
9731,286,8261,1474261,1474547,5
9103,7,8261,36369,36376,15
7868,45,8261,306186,306231,16
1402,176,8261,750438,750614,31
2656,237,8262,1433794,1434031,7
9242,293,8262,1411751,1412044,13
4578,30,8262,216786,216816,20
1281,204,8262,1196081,1196285,27
6937,11,8262,80307,80318,29
4244,221,8262,871321,871542,41
5832,61,8262,515125,515186,45
9890,83,8263,989246,989329,4
4565,241,8263,1196072,1196313,26
4206,176,8263,1098278,1098454,46
6810,32,8264,306320,306352,25
5766,290,8264,1335590,1335880,27
7231,122,8265,1276026,1276148,2
8957,75,8265,515191,515266,23
2209,283,8265,1275900,1276183,42
1731,111,8266,1196289,1196400,6
2283,252,8266,1098344,1098596,15
7829,42,8266,140723,140765,36
7749,113,8266,750764,750877,50
7536,114,8267,750780,750894,44
8906,126,8268,1276074,1276200,2
5500,86,8268,989422,989508,4
7570,196,8268,1379864,1380060,8
6002,80,8268,630156,630236,14
3975,251,8268,871508,871759,17
9363,185,8268,1098476,1098661,27
4679,215,8268,989363,989578,31
9700,203,8268,1276065,1276268,43
1519,20,8269,217023,217043,1
5842,171,8269,1379920,1380091,5
9317,282,8269,1474283,1474565,5
3370,121,8269,515373,515494,10
7643,228,8269,1196279,1196507,18
9033,54,8269,217041,217095,30
1714,6,8269,80495,80501,33
1079,27,8269,80491,80518,37
4819,244,8269,1196311,1196555,44
3111,215,8269,1196384,1196599,46
8610,195,8270,1335744,1335939,14
4984,100,8270,515475,515575,40
9949,105,8270,751030,751135,49
5143,96,8271,1098734,1098830,2
9067,162,8271,1276163,1276325,8
6472,243,8271,1433819,1434062,12
6821,272,8271,1276124,1276396,29
4039,265,8271,1196432,1196697,31
9456,131,8271,630386,630517,36
1734,269,8271,1335720,1335989,47
1453,98,8272,1098855,1098953,3
3665,112,8272,871964,872076,14
9266,171,8272,1098830,1099001,22
4541,266,8272,1196486,1196752,31
4730,220,8272,1335810,1336030,43
7625,28,8272,217241,217269,49
9268,229,8273,1450194,1450423,1
9013,31,8273,141026,141057,18
7897,36,8273,407383,407419,19
4851,214,8273,1098898,1099112,35
2673,200,8273,1098953,1099153,37
3839,233,8274,1461681,1461914,3
8659,18,8274,141074,141092,19
1234,270,8274,989768,990038,21
1844,240,8274,1098975,1099215,36
6137,143,8274,872140,872283,44
1542,210,8275,1433924,1434134,2
9860,22,8275,141124,141146,9
7165,231,8275,1335876,1336107,22
4365,274,8275,1196628,1196902,33
3844,25,8275,217345,217370,49
4358,119,8276,1196810,1196929,1
4864,152,8276,1196792,1196944,11
2754,51,8276,141148,141199,21
1054,177,8276,1276376,1276553,48
2650,181,8277,872251,872432,15
6552,192,8277,751417,751609,41
3628,247,8278,1379941,1380188,16
6183,103,8278,751544,751647,27
7245,202,8279,1433955,1434157,6
8839,141,8279,872362,872503,46
5919,183,8280,1335972,1336155,9
1286,159,8280,990079,990238,29
2479,126,8280,630849,630975,30
2225,284,8280,1099139,1099423,41
3768,32,8281,217485,217517,9
1494,75,8281,751677,751752,39
1993,113,8281,751661,751774,47
7013,82,8282,516050,516132,23
4357,140,8282,872451,872591,44
5816,74,8283,872530,872604,4
8172,55,8283,516119,516174,45
8251,39,8284,407749,407788,4
4575,283,8284,1474294,1474577,5
1501,229,8284,1433965,1434194,7
2326,150,8284,1099322,1099472,22
4114,102,8285,872554,872656,7
5778,151,8285,1099342,1099493,12
6404,260,8285,1380006,1380266,16
9472,32,8285,141371,141403,18
7809,103,8286,990257,990360,43
5060,51,8286,516207,516258,45
9118,248,8287,1461709,1461957,5
5544,259,8287,1196856,1197115,23
9213,30,8287,217626,217656,25
5977,63,8287,307133,307196,30
6909,217,8287,1276492,1276709,49
9173,68,8288,407843,407911,44
3802,281,8288,1335977,1336258,47
7019,243,8289,1099397,1099640,31
9015,23,8290,141465,141488,9
7608,87,8290,407880,407967,10
3909,258,8290,1336049,1336307,28
4057,266,8290,1196952,1197218,31
6310,72,8290,307247,307319,40
4579,77,8291,872797,872874,1
6497,126,8291,631185,631311,13
6243,34,8291,307319,307353,14
5364,13,8291,80959,80972,15
5565,9,8291,80968,80977,19
9654,164,8291,872762,872926,20
9360,161,8291,631212,631373,21
1794,91,8291,408005,408096,32
3443,86,8291,408044,408130,32
4894,32,8291,307396,307428,50
3803,93,8292,1099610,1099703,1
7225,251,8292,1461741,1461992,2
2977,24,8292,141588,141612,15
7465,282,8292,1433963,1434245,16
7856,206,8292,1099564,1099770,18
1488,159,8292,631308,631467,21
3766,53,8292,307444,307497,37
1254,192,8293,1380138,1380330,7
3284,26,8293,217891,217917,13
9692,18,8293,81057,81075,26
4748,19,8293,141660,141679,34
9144,232,8293,1276616,1276848,34
4590,178,8293,872889,873067,42
3186,15,8294,217930,217945,1
2781,218,8294,1450291,1450509,2
8781,108,8294,1099734,1099842,4
3581,264,8294,1450273,1450537,11
6144,92,8294,752142,752234,25
3678,185,8295,1336227,1336412,7
1677,234,8295,1099676,1099910,15
6333,281,8295,1099667,1099948,21
3562,155,8295,752183,752338,32
3041,95,8295,516591,516686,37
4136,290,8295,1411995,1412285,38
8786,132,8295,631557,631689,40
9158,27,8295,218033,218060,46
5512,187,8296,1412131,1412318,1
8745,262,8296,1469671,1469933,1
8963,180,8296,1412178,1412358,4
2088,186,8296,873072,873258,40
8042,21,8296,307690,307711,43
6009,86,8296,516697,516783,44
4324,129,8296,752316,752445,47
8424,75,8296,631698,631773,49
6011,162,8297,873143,873305,44
6693,217,8297,1099854,1100071,45
4474,280,8298,1474308,1474588,3
2519,250,8298,1197213,1197463,18
9182,207,8298,1380279,1380486,19
7799,127,8298,752447,752574,29
8357,73,8298,516851,516924,29
5451,172,8299,1197345,1197517,38
5521,180,8300,1412216,1412396,5
9628,171,8300,1197394,1197565,38
6184,191,8301,1276848,1277039,14
8244,78,8301,408504,408582,40
7870,246,8301,1197382,1197628,44
3661,133,8302,1276931,1277064,3
4569,93,8302,631873,631966,11
9087,151,8302,752549,752700,42
8579,202,8303,1434137,1434339,3
6814,180,8303,1412255,1412435,5
5030,192,8303,1336404,1336596,11
8360,67,8303,752683,752750,19
4521,178,8303,1197535,1197713,25
5626,167,8303,1197577,1197744,38
2631,127,8303,516977,517104,41
2285,179,8304,1412277,1412456,6
5736,218,8304,1380361,1380579,12
4707,47,8304,307961,308008,23
3214,65,8304,218287,218352,36
5409,86,8304,752744,752830,38
1425,186,8304,990926,991112,44
8634,242,8304,1197575,1197817,44
5729,237,8305,1461807,1462044,6
8680,215,8305,1380413,1380628,11
2661,284,8305,1412208,1412492,13
9674,258,8305,1336453,1336711,34
3599,211,8306,1434179,1434390,4
1705,35,8306,142063,142098,10
3007,98,8306,752866,752964,12
4871,289,8306,1336493,1336782,27
6589,22,8306,37154,37176,36
2742,69,8306,408800,408869,42
1259,44,8308,517229,517273,2
9997,176,8308,1412350,1412526,6
3832,258,8308,1434166,1434424,12
6033,86,8308,408835,408921,26
9374,94,8308,873679,873773,43
7050,294,8308,1434186,1434480,48
3324,215,8309,1450389,1450604,5
1400,35,8309,142147,142182,8
3404,259,8309,1197769,1198028,36
3193,128,8310,632228,632356,15
8539,32,8310,308189,308221,29
7780,149,8311,1336727,1336876,1
5594,297,8311,1469674,1469971,7
7955,181,8311,1100463,1100644,16
3696,151,8311,1100525,1100676,25
8211,255,8312,1469739,1469994,1
3848,16,8312,142228,142244,5
7535,169,8312,1380627,1380796,5
2366,132,8312,1100588,1100720,7
8428,250,8312,1197866,1198116,36
7528,292,8313,1474320,1474612,1
5517,183,8313,1412480,1412663,4
8167,220,8313,1450467,1450687,5
7205,293,8313,1336713,1337006,20
5819,66,8313,632459,632525,43
1166,132,8313,753126,753258,44
9837,78,8313,632491,632569,45
8105,55,8314,632528,632583,6
8819,111,8314,873895,874006,9
3741,67,8314,218618,218685,36
9918,161,8315,1277309,1277470,7
1080,226,8316,1412483,1412709,8
2599,234,8316,1412510,1412744,11
4956,219,8316,991386,991605,13
2500,126,8316,991504,991630,14
7613,148,8316,991512,991660,27
5501,166,8316,1198090,1198256,38
6191,124,8316,874027,874151,50
7684,165,8316,991557,991722,50
1720,167,8317,1100748,1100915,22
4236,257,8318,1450450,1450707,8
4687,135,8318,874111,874246,12
3415,209,8318,632604,632813,17
2117,138,8318,874141,874279,34
1764,144,8318,1100816,1100960,38
1939,87,8318,517674,517761,44
5416,282,8319,1450449,1450731,19
8569,148,8319,874213,874361,45
1573,220,8319,1198105,1198325,47
3025,122,8320,874283,874405,12
2762,17,8320,81674,81691,27
8721,143,8320,753472,753615,42
5797,184,8321,1412634,1412818,2
8879,55,8321,632896,632951,5
8847,142,8321,1198211,1198353,7
9921,150,8321,1198220,1198370,8
6539,251,8321,1434378,1434629,12
7789,117,8321,753575,753692,20
3985,155,8321,1100934,1101089,24
5948,227,8321,1198197,1198424,37
3206,28,8322,308674,308702,45
2452,169,8323,1380812,1380981,3
6502,294,8323,1336870,1337164,29
4757,251,8323,1277399,1277650,47
4350,244,8324,1461874,1462118,6
8543,195,8324,1380819,1381014,8
3275,200,8324,1337017,1337217,14
6022,101,8324,874508,874609,25
4126,148,8325,1198405,1198553,7
3164,29,8325,219011,219040,28
5631,18,8325,11288,11306,31
9075,248,8325,1198366,1198614,37
5346,217,8325,1101084,1101301,42
3479,156,8325,991954,992110,46
2717,227,8325,1198433,1198660,47
5397,40,8325,409597,409637,50
3330,260,8326,1336983,1337243,13
3363,273,8326,1412606,1412879,16
6218,154,8326,753839,753993,36
3685,116,8327,874656,874772,9
7223,245,8327,1434425,1434670,11
9139,126,8327,753932,754058,20
3212,201,8328,992035,992236,13
8942,215,8328,1101191,1101406,23
6732,72,8328,518155,518227,27
1609,2,8328,11330,11332,35
6344,284,8328,1198472,1198756,40
8936,181,8328,992159,992340,44
5587,87,8328,633344,633431,49
7291,285,8329,1450493,1450778,14
8236,153,8329,874780,874933,18
7945,96,8329,633401,633497,46
3935,165,8329,992230,992395,47
2072,244,8329,1337087,1337331,49
1877,227,8330,1101292,1101519,15
1422,269,8330,1380831,1381100,24
3253,241,8330,1337154,1337395,28
7567,84,8330,633519,633603,29
4615,227,8330,1198659,1198886,37
1311,13,8331,37524,37537,18
3979,249,8331,1412703,1412952,19
3329,119,8331,874975,875094,28
7451,241,8331,1337212,1337453,28
8806,215,8331,874956,875171,30
9910,132,8331,633586,633718,30
2121,253,8331,1101425,1101678,31
3243,203,8331,1277724,1277927,38
8208,59,8332,754370,754429,1
7120,272,8332,874997,875269,17
8566,177,8332,875127,875304,32
3564,261,8332,1277704,1277965,45
2160,231,8333,1277779,1278010,16
1382,86,8333,410049,410135,26
2889,196,8333,875194,875390,31
3530,203,8335,1434507,1434710,5
5315,196,8335,1101623,1101819,27
5314,106,8335,410095,410201,31
8015,44,8335,309280,309324,34
4481,278,8335,1434472,1434750,48
7078,171,8336,875302,875473,18
8460,206,8336,1380990,1381196,39
7537,51,8336,518651,518702,45
1807,45,8337,309329,309374,15
5638,248,8337,1380969,1381217,16
4190,180,8337,1101732,1101912,27
2597,147,8338,518639,518786,10
8405,239,8338,1277890,1278129,34
2559,113,8338,633898,634011,37
8306,159,8338,875430,875589,44
1695,289,8339,1469723,1470012,7
3970,66,8339,754652,754718,19
1323,7,8339,82135,82142,24
1895,5,8339,37681,37686,24
3619,32,8339,219600,219632,27
8907,23,8339,37681,37704,30
7580,125,8340,1278033,1278158,6
7953,298,8340,1337281,1337579,35
2588,73,8341,518817,518890,23
5322,248,8342,1337345,1337593,13
6463,283,8342,1434524,1434807,48
1347,197,8343,1434630,1434827,4
7810,211,8343,1381084,1381295,12
2792,91,8343,518885,518976,13
8991,178,8343,1199076,1199254,25
9523,94,8343,634087,634181,29
3270,113,8343,518932,519045,32
2034,288,8343,1412798,1413086,38
8967,111,8343,875650,875761,49
6629,155,8344,1381188,1381343,1
7190,91,8344,992878,992969,6
5895,154,8344,1199161,1199315,8
6461,209,8344,992821,993030,15
9010,60,8344,634215,634275,19
6430,291,8344,1412826,1413117,22
1642,159,8344,754809,754968,30
9090,103,8344,634244,634347,34
1066,86,8345,992982,993068,3
5199,75,8345,875795,875870,3
4583,37,8345,410590,410627,5
2927,5,8345,37776,37781,9
8927,170,8345,875739,875909,15
3304,132,8345,1199228,1199360,19
4441,23,8345,82262,82285,26
1450,251,8345,992892,993143,30
5154,258,8345,992952,993210,30
7642,115,8345,519153,519268,31
6318,284,8345,1412875,1413159,43
2911,226,8345,1278173,1278399,49
3232,15,8345,143299,143314,50
4211,102,8345,755059,755161,50
9297,239,8346,1461903,1462142,6
8599,101,8346,993182,993283,19
7241,207,8347,993116,993323,36
6226,69,8347,634478,634547,50
5355,238,8348,993131,993369,30
7126,184,8348,1102059,1102243,47
1278,222,8348,1199237,1199459,50
5470,72,8349,309806,309878,10
4720,275,8349,1450557,1450832,12
2045,265,8349,1199236,1199501,31
2932,210,8349,1199330,1199540,46
6425,300,8350,1337522,1337822,18
1272,235,8350,1199373,1199608,20
4432,148,8350,993420,993568,28
6855,85,8350,519419,519504,37
8240,253,8350,993361,993614,41
6849,124,8351,993512,993636,7
9983,63,8352,309960,310023,8
2264,184,8352,634623,634807,10
3032,178,8352,1337667,1337845,19
8947,188,8353,993500,993688,23
2407,44,8353,410959,411003,24
2263,186,8353,876217,876403,36
6159,8,8353,82483,82491,38
4268,168,8354,1381289,1381457,4
1481,86,8354,634801,634887,12
8755,62,8354,410995,411057,15
3127,151,8354,634772,634923,31
7690,239,8354,1102246,1102485,33
7653,61,8354,310097,310158,40
7874,9,8354,82522,82531,45
2208,148,8355,1199503,1199651,8
7505,279,8355,1102271,1102550,30
7701,132,8355,634890,635022,30
6456,136,8355,755469,755605,42
7560,115,8355,876401,876516,49
7398,3,8356,11615,11618,8
9812,223,8356,1102374,1102597,18
5678,119,8356,634984,635103,26
1535,57,8356,635058,635115,39
1067,94,8356,411146,411240,40
8874,7,8357,38022,38029,8
4384,102,8357,755556,755658,11
3795,254,8357,1337624,1337878,13
9603,291,8357,1199433,1199724,32
7523,26,8357,310301,310327,33
5114,93,8357,519779,519872,42
8492,129,8357,876496,876625,45
1621,285,8357,1337640,1337925,46
8605,225,8357,1278358,1278583,49
5279,259,8358,1278356,1278615,18
3746,80,8358,411314,411394,42
5145,282,8359,1278392,1278674,45
3089,257,8359,1278471,1278728,46
9167,62,8359,411376,411438,46
5220,201,8359,1278553,1278754,49
8663,93,8360,993928,994021,5
1918,258,8360,1450585,1450843,11
2623,8,8360,82662,82670,19
3600,251,8360,1199714,1199965,44
6883,47,8361,310444,310491,34
1165,52,8362,220433,220485,8
3810,239,8362,1337726,1337965,16
6127,131,8362,993979,994110,22
1514,119,8362,876737,876856,27
9703,84,8363,411461,411545,18
8416,229,8363,1102673,1102902,26
1082,38,8363,411532,411570,38
1303,45,8363,520028,520073,39
2437,17,8363,143835,143852,47
4352,213,8364,1450648,1450861,2
1123,37,8364,220539,220576,9
7152,142,8364,876774,876916,37
8564,135,8365,994032,994167,11
5624,133,8365,755897,756030,15
5294,300,8365,1102675,1102975,41
1377,46,8366,143880,143926,10
7425,247,8366,1381253,1381500,16
7209,200,8366,1102822,1103022,18
7455,67,8366,756043,756110,19
1595,91,8366,635468,635559,35
5897,138,8366,635455,635593,36
9670,161,8367,1199887,1200048,8
3738,132,8367,756032,756164,20
7737,136,8367,756077,756213,20
2840,134,8367,520169,520303,21
4870,59,8367,310707,310766,32
2119,80,8367,520247,520327,34
9715,236,8367,1199852,1200088,44
5944,208,8368,1434704,1434912,5
1667,291,8368,1412956,1413247,10
9864,102,8368,876969,877071,22
8590,49,8368,310796,310845,42
1872,34,8368,144051,144085,44
2246,232,8368,1381347,1381579,48
2784,153,8368,1102979,1103132,49
4633,151,8369,520331,520482,10
2748,170,8369,1103007,1103177,14
7794,298,8369,1337790,1338088,18
1871,272,8369,1278687,1278959,29
1025,296,8369,1337834,1338130,35
3098,39,8369,144119,144158,40
1627,185,8369,1200070,1200255,49
3830,197,8370,1103135,1103332,27
1269,62,8370,220831,220893,30
9874,61,8370,411929,411990,46
3631,172,8371,1103193,1103365,16
9559,280,8372,1474300,1474580,1
2473,172,8372,635758,635930,21
2640,175,8372,1103230,1103405,34
2255,285,8373,1200029,1200314,31
5618,64,8373,635923,635987,48
4742,261,8374,1278774,1279035,18
6441,42,8374,311011,311053,23
8179,65,8374,311009,311074,26
3473,131,8375,520579,520710,31
6798,179,8375,994449,994628,44
9219,173,8376,1381447,1381620,4
5523,121,8376,520646,520767,10
9521,82,8376,520713,520795,11
4986,279,8376,1450612,1450891,19
7857,188,8376,994505,994693,23
5233,113,8376,877307,877420,28
9713,113,8376,520763,520876,32
8332,227,8376,1103296,1103523,42
4502,251,8376,1200183,1200434,45
5142,75,8377,520855,520930,27
3393,162,8377,877368,877530,33
4241,297,8377,1278819,1279116,33
7421,133,8377,1103488,1103621,43
1979,173,8379,636067,636240,10
7185,218,8379,1103438,1103656,23
2670,47,8379,412293,412340,29
7712,282,8380,1461873,1462155,11
1194,199,8380,1278978,1279177,43
6122,71,8381,520980,521051,11
2200,276,8382,1381440,1381716,38
9115,296,8383,1474314,1474610,3
1803,264,8383,994681,994945,21
1100,202,8383,1279042,1279244,49
8060,260,8384,1337996,1338256,10
9441,214,8384,1103600,1103814,29
1913,210,8385,877567,877777,21
6583,161,8385,1103694,1103855,25
7350,84,8385,756848,756932,38
3014,146,8386,756822,756968,18
9990,262,8386,994814,995076,21
8183,261,8386,1279053,1279314,46
6860,174,8387,1413158,1413332,3
5507,200,8387,756875,757075,21
6435,146,8388,1338148,1338294,1
5524,214,8388,1381566,1381780,19
9403,11,8389,83223,83234,9
1387,180,8389,756947,757127,21
6498,294,8389,1279100,1279394,31
5671,59,8389,521310,521369,45
4946,286,8390,1381525,1381811,10
6061,213,8390,1103788,1104001,18
5417,87,8390,757118,757205,38
7623,78,8391,877876,877954,5
9198,227,8391,1103810,1104037,36
9748,77,8391,311526,311603,36
6676,194,8391,1279244,1279438,38
2417,132,8392,1279329,1279461,5
3082,48,8392,636713,636761,5
7647,14,8392,144635,144649,6
1238,51,8392,221412,221463,40
9365,41,8393,521451,521492,3
2546,297,8393,1338073,1338370,20
3469,86,8393,311579,311665,31
4259,291,8393,1103863,1104154,41
9911,204,8393,995145,995349,42
7083,167,8393,1200641,1200808,43
5029,61,8394,521520,521581,24
6572,185,8394,877959,878144,32
1147,152,8394,1104064,1104216,38
4874,171,8394,1279357,1279528,39
5065,202,8395,1434790,1434992,1
3158,281,8395,1200614,1200895,15
1211,253,8396,1461945,1462198,4
3288,119,8396,878143,878262,14
1566,95,8396,636875,636970,47
1439,279,8397,1104063,1104342,30
7924,232,8397,995312,995544,40
6196,87,8397,636953,637040,46
3699,24,8398,311822,311846,1
4982,57,8398,311818,311875,15
7991,237,8398,1338187,1338424,16
9372,8,8398,38613,38621,25
9438,98,8398,878262,878360,25
2350,38,8398,221646,221684,42
7227,38,8399,221657,221695,18
2698,5,8399,38632,38637,22
5637,259,8399,995373,995632,30
6190,109,8400,1200836,1200945,2
4671,258,8401,1469760,1470018,5
7323,10,8401,83466,83476,13
4311,257,8401,995445,995702,21
9055,64,8401,412972,413036,46
3980,59,8401,637097,637156,48
1431,196,8402,1434852,1435048,1
3822,219,8402,1450755,1450974,1
7545,208,8402,995576,995784,23
7456,47,8402,144858,144905,31
2222,118,8403,1200889,1201007,6
4726,153,8403,1104295,1104448,12
9049,232,8403,878347,878579,21
5320,124,8403,637154,637278,26
6139,276,8404,1469781,1470057,5
2549,285,8404,1338249,1338534,27
9410,41,8405,312018,312059,9
4041,293,8405,1381658,1381951,28
7409,28,8405,83551,83579,41
1690,286,8406,1200842,1201128,32
4170,198,8406,1104377,1104575,35
5864,269,8406,1434857,1435126,39
1726,60,8406,521953,522013,49
4267,82,8407,521953,522035,15
3728,244,8407,1338378,1338622,28
1534,118,8407,757757,757875,37
7519,293,8408,995704,995997,17
9833,79,8408,637364,637443,28
3906,248,8408,1279516,1279764,29
4695,180,8408,757795,757975,31
9952,228,8408,1279569,1279797,34
9518,35,8408,413311,413346,39
6568,138,8408,522053,522191,41
7286,64,8409,757947,758011,1
2904,12,8409,145093,145105,3
5858,31,8409,145092,145123,27
2963,58,8410,757964,758022,2
4877,90,8410,995974,996064,6
2109,54,8410,413351,413405,12
5254,235,8410,1201034,1201269,37
2576,74,8410,413375,413449,42
1441,209,8410,1338441,1338650,43
7333,60,8410,637519,637579,43
9117,56,8411,413425,413481,12
2071,131,8411,1201182,1201313,19
6646,73,8411,758023,758096,19
3066,257,8411,1201101,1201358,26
3117,300,8411,1338402,1338702,29
4014,49,8411,312342,312391,34
7407,74,8412,413483,413557,9
6596,226,8412,1413242,1413468,11
2482,299,8412,1413203,1413502,13
8735,66,8412,312390,312456,18
6185,97,8412,758120,758217,22
2007,190,8412,878787,878977,40
3778,160,8412,878847,879007,42
1218,128,8413,637646,637774,18
9933,46,8413,145248,145294,21
1975,211,8413,1201243,1201454,34
3941,123,8413,878927,879050,46
5232,96,8413,758237,758333,50
8617,92,8414,222168,222260,17
6437,30,8414,83809,83839,30
8611,207,8414,996060,996267,40
2050,99,8414,312507,312606,41
4808,32,8415,413685,413717,3
3959,166,8415,878946,879112,18
4763,30,8415,83852,83882,21
8614,269,8415,1338509,1338778,34
1788,147,8416,1201350,1201497,7
1049,235,8416,1201289,1201524,10
4907,277,8416,1381777,1382054,38
4024,4,8416,38941,38945,48
1878,176,8416,1201401,1201577,49
6293,169,8416,996229,996398,50
8445,246,8417,1462009,1462255,1
4435,188,8417,1413358,1413546,6
7666,9,8417,38953,38962,32
2335,256,8417,1201408,1201664,44
6351,280,8418,1461998,1462278,11
1317,77,8418,312667,312744,31
3912,229,8419,1104800,1105029,15
2149,93,8419,222372,222465,17
2102,233,8419,1338652,1338885,22
9283,195,8419,1201554,1201749,22
8421,280,8419,1279760,1280040,26
4266,266,8419,1279821,1280087,37
9062,15,8419,145519,145534,38
9470,158,8419,1201688,1201846,48
5767,134,8420,1105031,1105165,8
2638,205,8420,1381923,1382128,9
3667,156,8420,522605,522761,17
5246,86,8420,758593,758679,38
3506,293,8420,1338643,1338936,45
6353,114,8421,1201797,1201911,6
9350,214,8421,879283,879497,21
3132,153,8421,879391,879544,29
8334,7,8421,39053,39060,42
7866,279,8421,1279913,1280192,45
1868,211,8422,1413371,1413582,7
5419,112,8422,638164,638276,13
4344,278,8422,1381915,1382193,22
8113,231,8422,996546,996777,31
4520,212,8422,996611,996823,36
4723,288,8423,1474316,1474604,2
7202,33,8423,312977,313010,33
1344,177,8423,1338839,1339016,39
1244,185,8423,996725,996910,45
9179,275,8424,1381955,1382230,10
1409,15,8424,84116,84131,29
9946,240,8424,1413387,1413627,48
6123,234,8425,1462079,1462313,5
2015,6,8425,84134,84140,22
8192,57,8425,522968,523025,22
4287,277,8425,1338857,1339134,25
7301,57,8425,222686,222743,41
1384,83,8425,638389,638472,45
2157,62,8425,523005,523067,49
8860,45,8426,84151,84196,17
6459,19,8426,145731,145750,25
3905,17,8426,84192,84209,40
8657,272,8426,1201853,1202125,40
7986,35,8426,313076,313111,49
4827,232,8427,1450854,1451086,4
3629,65,8427,414204,414269,11
9634,155,8427,758865,759020,40
8149,76,8427,414239,414315,44
9959,110,8427,638446,638556,44
2073,237,8428,1462100,1462337,1
5163,123,8428,1105352,1105475,19
8514,68,8428,414301,414369,34
4652,157,8428,1105364,1105521,38
6356,157,8428,758934,759091,40
7504,46,8428,313193,313239,47
2592,96,8429,1105438,1105534,6
7553,94,8429,638559,638653,16
1295,75,8429,414363,414438,18
3207,160,8430,1202012,1202172,11
3663,152,8431,1202034,1202186,11
4149,270,8431,1338926,1339196,47
7592,144,8432,1339075,1339219,1
5264,12,8432,145893,145905,24
5456,247,8432,1280218,1280465,34
4245,80,8433,638661,638741,12
4501,138,8433,997046,997184,24
4278,20,8433,145915,145935,29
2991,1,8433,12227,12228,34
5550,88,8434,414458,414546,26
8830,27,8434,222965,222992,29
1343,66,8434,313304,313370,30
5725,129,8434,638656,638785,30
7294,294,8434,1280222,1280516,36
6464,143,8434,879842,879985,37
1823,296,8434,1338956,1339252,44
8799,142,8434,879899,880041,47
1837,109,8435,1202213,1202322,1
8443,40,8435,313421,313461,22
1449,181,8435,997107,997288,44
6099,281,8436,1474337,1474618,2
9338,96,8436,523339,523435,9
2024,20,8436,84409,84429,11
6866,44,8436,414639,414683,14
8726,158,8436,759179,759337,30
2974,47,8437,313487,313534,28
4223,167,8437,879976,880143,33
2144,131,8437,1105590,1105721,43
2896,105,8437,759313,759418,45
8336,193,8438,1435053,1435246,5
6698,82,8438,523436,523518,9
2918,2,8438,12283,12285,10
1553,205,8438,997167,997372,13
4380,54,8438,523504,523558,14
7477,191,8438,997212,997403,15
8584,228,8438,1382149,1382377,19
9776,147,8438,759381,759528,26
4292,283,8438,1382137,1382420,28
4510,268,8438,1202174,1202442,42
5911,107,8438,880198,880305,49
2061,87,8439,523592,523679,15
7698,77,8439,523626,523703,23
7207,68,8439,523648,523716,27
6734,139,8439,1105701,1105840,43
3559,255,8439,1202245,1202500,44
4592,138,8440,1280514,1280652,6
1022,234,8440,1105700,1105934,23
1888,40,8440,414922,414962,33
3836,160,8441,997430,997590,34
2950,89,8442,523722,523811,13
2506,257,8442,1339137,1339394,24
1748,110,8442,639125,639235,44
7778,274,8442,1435004,1435278,48
7909,112,8442,997542,997654,48
4900,170,8443,1105825,1105995,34
5605,43,8443,415019,415062,50
5102,70,8444,415007,415077,8
2351,279,8444,1382212,1382491,22
3364,187,8445,880343,880530,40
8503,108,8446,1202486,1202594,5
9205,22,8446,146268,146290,11
7844,287,8446,880326,880613,17
6836,25,8446,146300,146325,35
5746,119,8446,523851,523970,36
7509,256,8447,1469824,1470080,5
9025,197,8447,1339303,1339500,19
2290,44,8447,313908,313952,42
8365,137,8447,1105956,1106093,48
9855,195,8448,1202464,1202659,16
7041,19,8448,223473,223492,24
2993,222,8448,1339308,1339530,38
9084,37,8448,223485,223522,42
3964,148,8448,880593,880741,45
8809,50,8449,639381,639431,6
7336,195,8450,1202537,1202732,25
9961,145,8450,1202614,1202759,39
4702,94,8450,313946,314040,41
5597,69,8451,524006,524075,11
7420,283,8451,1339273,1339556,18
1200,37,8451,314043,314080,22
5180,57,8451,314054,314111,42
7008,60,8451,524058,524118,45
5272,60,8451,639430,639490,48
3508,120,8452,524032,524152,31
6773,160,8452,759827,759987,36
9688,201,8452,1280648,1280849,38
2416,4,8452,39520,39524,42
4492,181,8453,1413579,1413760,2
2776,242,8453,1435069,1435311,11
4443,259,8453,1202623,1202882,36
8437,246,8454,1382306,1382552,16
9554,52,8454,314167,314219,18
3553,157,8454,880760,880917,20
5415,118,8454,639509,639627,26
6481,218,8454,997747,997965,31
7841,103,8454,997880,997983,43
6072,280,8454,1435072,1435352,48
2114,167,8455,1382437,1382604,6
2357,260,8455,1469837,1470097,6
7136,57,8455,223726,223783,10
8482,296,8455,1462105,1462401,14
1569,280,8455,1106145,1106425,30
5592,205,8455,760062,760267,41
1531,52,8455,314302,314354,47
3116,280,8456,1462144,1462424,11
4878,230,8456,1413645,1413875,14
2025,99,8456,639725,639824,35
4077,144,8457,1202866,1203010,7
6112,165,8457,639706,639871,41
3971,1,8458,12427,12428,9
5668,179,8458,1339537,1339716,9
3849,173,8458,880988,881161,33
7959,73,8458,415530,415603,37
1492,149,8459,639787,639936,21
7586,122,8459,881060,881182,27
6442,297,8459,1280744,1281041,31
8513,273,8459,1202837,1203110,33
3797,137,8459,881126,881263,35
6825,187,8459,998039,998226,42
2306,102,8460,1106469,1106571,2
6034,128,8460,1280931,1281059,6
6636,22,8460,84942,84964,18
3233,203,8460,1280887,1281090,22
3855,10,8460,84964,84974,28
3574,52,8460,314522,314574,32
5735,112,8460,760417,760529,34
6887,102,8460,760447,760549,46
5303,198,8460,1202998,1203196,49
2874,288,8461,1474339,1474627,2
3140,86,8461,998234,998320,3
2439,123,8461,1280996,1281119,5
4198,258,8461,1202999,1203257,15
5726,71,8461,760568,760639,19
9798,29,8461,39698,39727,31
2854,166,8462,524572,524738,17
5878,97,8462,640112,640209,27
5268,44,8462,314656,314700,28
9707,260,8463,1413679,1413939,19
7939,163,8463,881292,881455,42
9773,140,8464,1203147,1203287,7
6440,7,8464,85053,85060,9
6665,181,8464,881334,881515,15
8964,62,8464,524767,524829,24
6360,6,8464,12494,12500,26
9550,194,8464,881356,881550,31
1657,160,8464,881441,881601,33
5598,28,8464,85073,85101,37
6138,116,8464,760667,760783,37
6685,22,8464,146902,146924,49
3234,259,8465,1280919,1281178,37
9178,116,8465,415881,415997,41
6394,296,8465,1280930,1281226,42
1636,217,8465,1382523,1382740,48
7481,122,8465,1106689,1106811,48
2198,66,8466,314817,314883,10
3781,95,8466,415970,416065,10
8548,22,8466,146974,146996,11
3637,80,8466,640337,640417,16
5358,88,8467,998406,998494,5
5341,73,8467,524886,524959,7
1698,74,8467,416051,416125,13
5338,72,8467,416081,416153,42
3724,169,8467,1203242,1203411,43
4549,289,8468,1462181,1462470,8
7097,63,8468,416138,416201,12
7679,153,8468,760782,760935,13
2251,113,8468,640394,640507,15
7048,248,8468,998314,998562,21
9743,270,8468,1382526,1382796,24
2274,218,8468,998407,998625,40
4893,230,8468,1203256,1203486,44
7254,46,8468,525057,525103,48
6405,111,8468,760958,761069,50
8811,227,8469,1451013,1451240,2
3094,217,8469,998504,998721,13
9954,24,8469,224431,224455,24
4316,82,8469,761040,761122,25
5195,158,8469,760998,761156,30
6371,59,8469,224431,224490,31
7035,10,8469,147151,147161,33
7382,265,8470,1469868,1470133,4
5871,291,8470,1462221,1462512,14
7527,51,8470,525155,525206,14
2793,157,8470,525081,525238,17
4734,162,8470,1281201,1281363,19
5164,195,8470,1203398,1203593,25
2206,112,8470,761133,761245,33
6653,232,8470,1339671,1339903,38
8317,258,8471,1469901,1470159,1
9639,185,8471,1413864,1414049,6
9629,121,8471,881852,881973,11
8247,82,8471,640750,640832,33
6030,79,8472,416441,416520,8
9544,265,8472,1451065,1451330,8
4183,64,8472,315227,315291,40
2089,248,8473,1435310,1435558,8
4911,83,8473,761249,761332,14
4849,3,8473,12611,12614,15
3569,51,8473,416524,416575,20
6046,279,8473,1203436,1203715,40
8919,171,8474,1339808,1339979,7
7375,80,8474,640849,640929,14
2474,275,8474,1339758,1340033,34
4850,125,8474,1107027,1107152,43
2185,208,8475,1435383,1435591,3
4283,116,8475,315311,315427,17
7371,200,8475,640815,641015,17
2020,177,8475,1107017,1107194,34
7471,26,8475,224736,224762,38
4654,87,8476,525405,525492,23
6675,177,8476,998835,999012,29
5340,29,8476,315465,315494,50
4926,93,8477,224730,224823,17
6236,38,8477,315467,315505,20
3021,183,8477,881987,882170,26
4257,193,8477,1107045,1107238,34
3056,245,8477,1281297,1281542,46
7283,22,8478,315528,315550,2
4016,138,8478,998937,999075,12
9754,222,8478,1281369,1281591,22
4092,237,8478,1107106,1107343,26
3896,100,8478,761488,761588,28
8188,45,8478,315571,315616,35
9457,5,8479,40087,40092,39
1898,94,8480,416734,416828,30
2864,264,8480,998912,999176,41
9011,34,8481,416828,416862,2
8412,63,8481,761564,761627,5
3402,34,8481,416843,416877,19
5153,292,8481,1382673,1382965,25
4902,154,8481,761526,761680,32
7415,144,8481,882202,882346,44
1508,149,8482,1203714,1203863,8
8465,75,8482,525645,525720,20
4995,15,8482,147586,147601,23
8766,123,8482,999109,999232,24
9657,118,8482,525645,525763,36
3711,280,8482,1382744,1383024,38
7327,60,8482,525728,525788,49
3395,143,8483,641164,641307,31
7707,93,8483,416954,417047,40
1077,188,8483,1107248,1107436,47
2815,251,8484,1462307,1462558,3
1167,203,8484,1382857,1383060,11
4440,84,8484,882367,882451,19
7195,78,8484,641308,641386,24
5353,114,8484,999211,999325,39
9822,108,8485,882368,882476,8
3490,16,8485,85677,85693,27
3309,139,8485,882370,882509,29
9386,159,8486,1382918,1383077,6
7723,161,8486,1203791,1203952,11
7379,239,8486,1281472,1281711,13
7428,280,8486,1281485,1281765,18
6879,259,8486,1382849,1383108,22
2305,29,8486,315915,315944,24
4137,65,8487,315904,315969,8
9089,80,8487,417146,417226,18
4100,207,8487,1203847,1204054,34
7498,238,8487,1281596,1281834,34
9869,15,8487,147777,147792,48
4680,6,8488,40231,40237,19
6251,234,8488,1203885,1204119,20
5068,18,8488,40234,40252,21
7226,267,8488,1281610,1281877,35
8728,295,8488,1413854,1414149,38
7255,236,8488,1413950,1414186,39
8326,12,8488,85767,85779,46
9866,181,8489,1340063,1340244,9
7773,299,8489,1435335,1435634,16
7014,175,8489,882615,882790,26
7714,126,8489,999491,999617,38
6762,88,8489,882739,882827,43
4731,120,8490,882725,882845,11
9440,294,8490,1382928,1383222,25
5466,222,8490,1383037,1383259,48
2532,146,8490,999548,999694,49
7739,91,8491,999622,999713,4
5847,69,8491,316096,316165,40
2715,122,8491,417326,417448,41
5642,96,8491,762121,762217,45
6624,94,8492,1107689,1107783,2
7094,141,8492,1340193,1340334,2
4234,272,8492,1462305,1462577,7
2644,250,8492,1340151,1340401,22
2651,95,8492,882883,882978,38
1635,181,8492,762123,762304,41
9098,161,8493,1383132,1383293,4
8666,139,8493,999663,999802,12
4852,270,8493,1383073,1383343,38
2219,42,8493,147954,147996,41
6269,245,8494,1462363,1462608,3
6413,144,8494,1340337,1340481,5
5367,298,8494,1469863,1470161,9
3662,82,8494,641834,641916,46
6683,180,8494,999734,999914,50
2515,192,8495,641807,641999,10
1658,39,8495,316319,316358,16
7548,60,8495,641956,642016,19
8965,276,8495,1204197,1204473,23
1859,107,8495,641959,642066,44
3381,168,8495,999820,999988,45
6591,222,8496,1451194,1451416,3
3353,40,8496,526422,526462,5
8036,37,8496,316388,316425,22
1921,280,8496,1383163,1383443,24
4015,254,8496,1281992,1282246,47
9650,277,8497,1474338,1474615,1
2163,102,8497,762424,762526,12
9310,245,8497,1204360,1204605,35
2287,211,8497,1340379,1340590,43
3084,275,8498,1462401,1462676,7
2433,245,8498,1204428,1204673,36
8462,219,8498,1282127,1282346,49
3752,211,8499,1107956,1108167,20
8500,169,8499,1000043,1000212,20
3706,59,8499,526569,526628,33
6981,271,8499,1435500,1435771,48
7689,212,8500,1435596,1435808,5
1196,108,8500,526570,526678,26
8182,229,8500,1204537,1204766,35
9543,209,8500,1000102,1000311,36
6609,144,8500,1000204,1000348,49
1214,300,8501,1476663,1476963,1
1150,96,8501,642273,642369,8
4704,134,8501,526652,526786,10
2459,80,8501,526733,526813,23
1289,255,8501,1282193,1282448,27
1133,253,8501,1000194,1000447,30
5818,155,8501,642296,642451,31
9619,289,8501,1340402,1340691,35
6013,29,8501,225804,225833,46
6192,144,8501,1204716,1204860,48
4923,230,8501,1204676,1204906,50
6290,299,8502,1474380,1474679,1
7636,99,8502,1108277,1108376,4
5984,274,8502,1282252,1282526,26
8587,104,8502,1000485,1000589,39
6305,143,8502,883535,883678,50
6620,12,8503,86155,86167,6
8731,286,8503,1204723,1205009,15
6692,18,8503,148328,148346,20
8943,21,8503,225881,225902,24
6563,157,8503,1108304,1108461,28
2743,182,8503,1000508,1000690,29
6908,282,8504,1204795,1205077,33
7292,35,8504,148348,148383,37
2505,7,8505,86197,86204,2
3223,145,8505,1000621,1000766,14
4442,103,8505,526949,527052,30
6718,252,8505,1340482,1340734,34
4796,196,8505,1108352,1108548,44
5687,140,8506,1108429,1108569,24
6846,85,8506,642641,642726,28
8738,237,8507,1462498,1462735,2
4969,253,8507,883659,883912,17
1126,205,8507,1282394,1282599,24
6674,168,8507,1282463,1282631,39
7612,280,8507,1204922,1205202,40
3607,87,8507,883905,883992,43
3011,138,8508,1340625,1340763,3
4370,156,8508,1205082,1205238,8
7302,118,8508,883913,884031,27
7700,240,8508,1108501,1108741,33
9333,213,8508,1108565,1108778,33
1366,263,8508,1340542,1340805,34
8488,175,8509,1414234,1414409,5
7843,113,8509,642850,642963,18
9522,77,8509,418333,418410,32
7492,44,8509,226097,226141,44
6114,1,8509,12924,12925,47
8979,134,8510,1108699,1108833,7
1774,188,8510,1000895,1001083,18
1587,15,8510,86333,86348,32
9254,126,8510,642898,643024,32
5159,94,8510,642976,643070,33
5406,144,8510,763260,763404,36
9228,272,8510,1282465,1282737,37
4176,184,8510,1108719,1108903,46
9793,175,8511,642999,643174,10
7511,132,8511,884091,884223,29
3871,219,8511,1205136,1205355,34
4593,38,8511,86386,86424,36
6918,170,8512,1383436,1383606,1
7311,234,8512,1462517,1462751,5
5856,212,8512,1001015,1001227,13
5759,297,8512,1462483,1462780,14
7946,79,8512,643223,643302,14
8123,156,8512,1001134,1001290,16
4265,87,8512,317162,317249,31
4653,75,8512,418576,418651,42
8290,219,8512,1383455,1383674,48
8138,288,8513,1108750,1109038,21
1950,42,8513,317264,317306,34
9078,144,8514,1340764,1340908,2
8692,241,8514,1282636,1282877,25
3224,215,8514,1108888,1109103,36
4825,83,8515,1001330,1001413,1
7096,191,8515,1435717,1435908,1
3773,77,8515,226331,226408,17
3777,124,8515,763576,763700,23
8155,91,8515,643371,643462,46
4990,226,8516,1451342,1451568,6
9423,259,8516,1451336,1451595,9
9766,211,8516,1001288,1001499,15
6364,245,8516,1205315,1205560,50
8143,243,8516,1205376,1205619,50
4913,207,8517,1109040,1109247,20
4426,281,8517,1205382,1205663,31
6110,143,8517,884498,884641,33
2618,211,8517,1282756,1282967,38
3535,167,8518,763771,763938,40
6542,300,8518,1414249,1414549,43
3145,31,8519,317466,317497,22
3060,236,8519,1109120,1109356,32
4273,183,8519,884558,884741,32
5006,294,8519,1205483,1205777,32
6335,38,8519,418927,418965,33
9290,128,8519,643613,643741,36
1842,209,8519,1109231,1109440,45
6786,279,8520,1474406,1474685,3
9236,207,8520,1383588,1383795,8
4627,23,8520,148919,148942,11
6436,195,8520,1001599,1001794,15
8136,19,8520,40851,40870,21
7999,296,8520,1414315,1414611,38
8297,169,8521,1109366,1109535,22
6358,140,8521,884778,884918,29
5058,209,8521,884739,884948,41
3306,170,8522,1383687,1383857,1
3995,141,8522,1340935,1341076,2
6092,297,8522,1474428,1474725,3
4673,155,8522,884868,885023,20
7786,163,8522,884914,885077,33
1550,292,8522,1340858,1341150,47
2429,242,8522,1414416,1414658,48
4423,13,8523,149010,149023,1
9724,173,8523,1414502,1414675,3
5791,214,8523,1001760,1001974,15
3106,46,8523,226687,226733,40
1059,45,8523,317710,317755,42
2354,239,8524,1282937,1283176,13
9346,47,8524,528084,528131,14
1459,28,8524,149047,149075,18
6332,25,8524,40919,40944,31
7976,26,8524,226742,226768,35
2059,287,8524,1282935,1283222,36
7106,13,8525,149086,149099,5
8904,90,8525,764303,764393,7
1523,271,8525,1451390,1451661,11
7180,158,8525,764305,764463,13
6312,267,8525,1414484,1414751,19
2694,135,8525,885120,885255,29
6389,153,8525,1205883,1206036,39
5266,284,8525,1283038,1283322,50
3925,288,8526,1414509,1414797,43
5720,184,8527,1414643,1414827,1
5171,272,8527,1470006,1470278,2
3262,168,8527,1205984,1206152,24
9199,12,8527,40989,41001,26
6349,113,8528,1109720,1109833,19
4545,123,8529,1206054,1206177,4
3705,205,8529,1383835,1384040,12
6017,158,8529,644116,644274,21
5693,23,8529,149175,149198,25
6088,202,8529,885236,885438,31
2750,114,8530,1206099,1206213,1
3204,129,8530,1283285,1283414,1
8698,47,8530,226887,226934,7
4326,291,8530,1206003,1206294,15
3046,257,8530,1206081,1206338,33
3029,261,8530,1283191,1283452,35
4401,161,8530,644261,644422,41
7507,240,8530,1283245,1283485,47
4948,276,8530,1435769,1436045,48
9545,12,8531,86878,86890,20
7250,99,8531,885511,885610,39
2587,7,8531,41066,41073,47
3421,255,8532,1470042,1470297,1
3747,259,8532,1414678,1414937,19
9526,148,8532,644360,644508,21
3894,128,8532,885533,885661,27
2962,274,8532,1206208,1206482,40
5486,121,8533,318022,318143,17
6086,107,8533,764787,764894,28
1536,260,8533,1109877,1110137,31
6227,156,8533,885599,885755,35
2603,219,8534,1109946,1110165,36
4674,213,8534,1206299,1206512,47
3003,36,8535,419611,419647,4
1796,94,8535,644590,644684,33
5975,256,8535,1283320,1283576,37
9985,182,8535,885685,885867,42
6045,98,8536,644653,644751,11
3235,131,8536,885768,885899,12
2753,202,8536,644614,644816,17
3568,54,8536,227169,227223,26
1826,129,8536,764939,765068,37
7182,96,8537,764990,765086,16
5312,95,8537,644778,644873,23
6545,139,8537,764974,765113,26
4382,122,8537,885798,885920,27
1625,154,8537,644792,644946,31
9477,175,8537,1206391,1206566,49
7215,146,8538,1206454,1206600,19
2683,26,8538,227286,227312,20
5747,120,8538,1110153,1110273,39
6038,293,8539,1462585,1462878,8
7819,209,8539,1283419,1283628,24
2141,186,8539,1110163,1110349,27
2281,1,8539,13226,13227,33
3023,94,8539,644945,645039,34
1048,39,8539,87100,87139,36
8742,84,8539,644980,645064,49
1583,26,8540,318438,318464,4
4012,140,8540,1002509,1002649,14
2233,25,8540,227367,227392,50
3655,175,8541,644959,645134,21
5396,147,8541,1002530,1002677,27
3331,176,8541,1002538,1002714,44
6418,269,8541,1341134,1341403,47
3588,231,8541,1341202,1341433,49
1861,192,8542,645077,645269,10
9611,62,8542,528998,529060,24
3776,164,8542,1002621,1002785,35
3124,66,8543,420014,420080,23
2227,242,8544,1462660,1462902,5
9484,117,8544,528995,529112,36
3719,118,8544,1002710,1002828,43
6328,254,8544,1206505,1206759,44
6746,259,8544,1383902,1384161,49
3433,71,8545,529103,529174,16
2332,20,8545,41300,41320,21
8865,150,8545,1002751,1002901,34
7346,7,8545,41320,41327,49
2845,243,8546,1462685,1462928,4
8196,4,8546,41329,41333,23
4548,122,8546,765328,765450,33
7107,145,8546,1110355,1110500,38
5792,210,8546,1002755,1002965,40
4332,78,8546,529184,529262,47
4125,20,8547,227578,227598,48
6715,3,8548,41345,41348,16
7822,146,8548,645333,645479,30
1479,187,8549,1414816,1415003,4
4060,43,8549,149740,149783,10
4935,10,8549,41367,41377,18
1552,41,8549,318699,318740,20
7879,237,8549,1110329,1110566,23
1915,65,8550,420214,420279,9
2700,92,8550,529245,529337,13
5983,291,8550,1341246,1341537,35
2757,228,8551,1451543,1451771,3
3110,278,8551,1462678,1462956,7
6807,213,8551,1414842,1415055,9
2039,235,8551,1206669,1206904,10
8050,190,8551,1283653,1283843,14
8299,227,8551,765421,765648,17
6906,140,8551,765555,765695,23
3190,156,8552,1206775,1206931,12
2125,126,8552,886320,886446,16
5660,27,8552,227739,227766,16
3436,286,8552,1341350,1341636,27
1597,29,8553,149898,149927,8
2104,226,8553,1341457,1341683,43
5839,37,8554,420438,420475,5
6188,158,8554,1384096,1384254,6
6075,66,8554,227747,227813,31
1239,215,8554,1283740,1283955,49
8118,56,8554,529505,529561,50
2387,17,8555,87424,87441,11
9740,3,8555,41467,41470,28
6100,138,8555,765710,765848,33
2079,129,8555,1110663,1110792,39
1674,59,8555,529536,529595,49
9243,213,8555,1283779,1283992,49
5935,224,8556,1206852,1207076,20
3006,67,8556,529579,529646,29
7278,213,8557,1110645,1110858,10
6806,31,8557,87461,87492,17
2116,245,8557,1414842,1415087,19
7090,281,8557,1206879,1207160,23
3988,134,8557,886512,886646,34
5350,220,8558,1110714,1110934,10
2702,297,8558,1462681,1462978,14
6005,160,8558,1110831,1110991,49
6703,190,8559,1341572,1341762,8
6525,261,8559,1283825,1284086,29
7071,13,8560,150058,150071,6
3758,187,8560,1341595,1341782,11
4162,32,8560,87536,87568,41
7748,180,8561,645902,646082,10
7411,96,8561,529789,529885,15
9944,4,8561,41559,41563,16
6264,24,8561,87575,87599,26
5200,168,8561,1110910,1111078,28
3899,207,8561,886578,886785,41
6295,178,8561,1110936,1111114,46
5923,96,8562,1111030,1111126,4
2371,46,8562,319167,319213,9
5745,91,8562,529884,529975,9
7493,216,8562,1283930,1284146,24
3035,54,8562,646122,646176,43
9592,230,8562,1207083,1207313,46
8640,61,8563,766114,766175,2
9929,138,8563,1003395,1003533,28
6261,232,8563,1207125,1207357,29
5075,160,8563,766093,766253,36
5902,17,8563,87656,87673,40
1858,17,8564,150187,150204,28
7172,120,8564,529968,530088,31
4388,213,8564,1111039,1111252,35
7206,35,8565,150202,150237,7
5351,37,8565,319295,319332,12
2538,212,8565,1384095,1384307,14
4658,278,8565,1283932,1284210,18
4231,235,8565,1207203,1207438,35
9425,104,8565,766254,766358,46
7629,184,8565,1111173,1111357,47
4218,77,8566,530116,530193,7
2347,250,8566,1341595,1341845,24
7772,151,8566,646264,646415,31
7405,5,8566,41673,41678,35
6429,231,8567,766209,766440,17
8885,73,8567,150299,150372,17
4678,279,8567,1111151,1111430,30
8396,87,8567,421018,421105,30
3545,292,8567,1283996,1284288,36
8375,100,8567,530209,530309,40
6534,191,8567,1111299,1111490,47
3653,104,8568,1111411,1111515,1
7658,270,8568,1207265,1207535,15
7056,19,8568,228314,228333,19
9163,192,8568,886981,887173,31
9571,214,8568,1003656,1003870,32
6510,28,8568,319560,319588,33
9574,161,8568,1003745,1003906,34
8325,177,8568,887090,887267,42
5289,109,8568,646550,646659,47
1073,198,8569,1207387,1207585,25
3356,94,8569,421201,421295,36
1854,20,8569,150499,150519,47
3247,66,8570,646618,646684,50
8483,240,8571,1462754,1462994,2
2325,207,8571,1384140,1384347,9
7579,39,8571,228422,228461,11
8722,62,8571,421292,421354,12
6957,91,8571,646640,646731,29
7823,237,8571,1207424,1207661,29
4067,77,8571,766636,766713,38
8480,189,8571,1111471,1111660,45
9780,240,8572,1462779,1463019,6
4096,104,8572,887288,887392,14
7571,89,8572,228456,228545,17
5117,200,8573,1384184,1384384,8
7865,228,8573,1414930,1415158,9
1177,93,8573,530541,530634,13
9227,107,8573,530556,530663,40
4355,162,8574,1384260,1384422,6
9840,163,8574,1207572,1207735,12
5385,37,8574,319786,319823,28
2067,5,8574,41853,41858,35
2484,124,8574,1003970,1004094,38
4663,65,8574,421466,421531,42
9255,244,8574,1384213,1384457,43
1911,96,8574,646812,646908,46
1228,247,8575,1284176,1284423,10
5194,219,8575,1284238,1284457,16
1440,113,8575,530685,530798,30
2629,36,8575,228660,228696,32
5293,52,8575,319878,319930,47
1270,143,8575,1004038,1004181,49
5014,113,8576,766803,766916,12
1920,277,8576,887309,887586,17
4157,212,8576,1284284,1284496,22
1952,63,8576,421627,421690,23
5542,191,8576,1004042,1004233,26
8859,266,8576,1341729,1341995,27
4193,84,8576,530832,530916,44
6650,12,8576,150804,150816,48
1776,185,8577,1207688,1207873,16
6447,258,8577,1341797,1342055,24
5112,27,8577,228799,228826,29
6847,67,8577,530896,530963,29
6951,256,8577,1207705,1207961,44
7620,179,8577,1111761,1111940,46
1745,8,8577,88125,88133,50
3061,99,8578,1111856,1111955,4
2979,103,8578,1111874,1111977,5
7821,96,8578,530949,531045,9
7740,125,8578,766992,767117,37
9894,180,8579,1414997,1415177,3
8320,137,8579,1111876,1112013,7
7274,98,8579,767072,767170,14
8373,138,8579,1004298,1004436,25
5572,195,8579,1004277,1004472,26
1567,185,8579,887656,887841,31
7318,106,8579,647206,647312,33
8701,135,8579,767154,767289,33
6969,24,8579,88190,88214,41
8000,61,8579,320176,320237,44
5559,83,8579,531104,531187,47
7219,199,8579,1111862,1112061,50
1554,151,8580,1341947,1342098,2
7105,18,8580,228980,228998,14
8790,108,8580,767248,767356,16
1201,202,8580,767208,767410,21
4131,294,8580,1384222,1384516,25
2499,195,8580,1111957,1112152,27
4677,35,8581,421991,422026,2
4112,290,8581,1414905,1415195,10
2084,18,8581,151014,151032,22
4260,257,8581,1341949,1342206,22
5135,7,8581,88280,88287,33
8453,278,8582,1341972,1342250,27
3299,264,8583,1470011,1470275,6
6354,293,8583,1474407,1474700,6
2311,186,8583,887853,888039,15
8639,284,8583,1207880,1208164,32
1870,199,8583,1004528,1004727,33
9871,9,8583,88313,88322,42
7941,27,8583,320390,320417,43
5579,111,8583,1004642,1004753,48
2292,83,8584,647542,647625,12
1329,90,8584,531359,531449,13
7603,242,8584,1284499,1284741,13
8558,294,8584,1284490,1284784,23
2078,255,8584,1208017,1208272,44
6784,39,8584,320461,320500,49
2031,27,8585,229164,229191,13
7159,70,8585,767618,767688,19
2136,295,8585,1384316,1384611,25
9151,51,8585,229166,229217,30
9941,193,8585,888066,888259,40
3125,168,8586,647613,647781,10
4920,2,8586,13659,13661,27
8709,28,8586,229227,229255,28
3636,169,8587,1208160,1208329,24
8449,232,8587,1112203,1112435,36
3774,227,8587,888119,888346,41
2438,256,8587,1208141,1208397,45
1373,83,8588,1004864,1004947,6
2368,232,8588,1435983,1436215,8
1429,210,8588,1284653,1284863,49
7151,33,8589,422347,422380,1
9721,161,8589,1004847,1005008,29
2986,149,8589,888327,888476,35
4814,135,8589,531602,531737,41
7129,63,8589,422386,422449,42
7931,167,8590,1384484,1384651,5
2056,93,8590,531669,531762,26
4518,189,8590,1112353,1112542,29
7095,111,8590,1004953,1005064,38
2654,260,8591,1470058,1470318,1
9081,148,8591,767840,767988,26
1931,124,8591,888447,888571,28
8988,147,8591,1112451,1112598,43
3816,111,8591,767955,768066,50
4302,12,8592,151335,151347,2
6325,115,8592,1208366,1208481,3
8883,287,8592,1474436,1474723,3
2539,70,8592,320743,320813,26
7683,172,8593,647935,648107,10
2418,188,8593,767936,768124,21
6876,3,8593,13714,13717,29
5837,157,8593,1112511,1112668,38
3958,277,8594,1470104,1470381,3
6177,154,8594,1208374,1208528,9
5193,72,8594,422582,422654,37
9002,263,8595,1451675,1451938,9
1031,53,8595,648130,648183,19
9043,117,8595,648090,648207,26
6152,215,8595,888499,888714,30
3317,114,8595,768109,768223,35
5589,285,8595,1112467,1112752,41
4356,150,8596,531973,532123,10
9383,170,8596,1284779,1284949,11
1756,199,8596,1284777,1284976,22
4936,185,8596,1284826,1285011,43
3812,1,8597,13745,13746,16
4106,193,8597,1208442,1208635,16
4959,32,8597,229636,229668,49
8700,130,8598,768227,768357,20
8058,21,8598,88648,88669,26
7128,19,8598,151514,151533,29
1397,102,8598,648314,648416,33
5762,84,8599,229628,229712,17
5373,20,8599,42317,42337,30
3372,237,8599,1112621,1112858,31
8585,143,8599,888721,888864,33
9623,286,8600,1474462,1474748,1
8616,262,8600,1470161,1470423,4
1790,166,8600,888765,888931,23
9391,95,8600,532186,532281,26
7322,63,8600,532232,532295,28
8257,228,8600,1112707,1112935,33
9047,112,8600,1005257,1005369,38
7337,226,8601,1451778,1452004,6
5718,42,8601,321112,321154,16
9009,25,8601,229789,229814,19
6930,277,8601,1208458,1208735,23
1860,191,8601,888863,889054,30
9161,105,8601,422906,423011,31
3505,85,8602,1005345,1005430,1
9257,3,8602,13806,13809,4
3622,103,8602,1112899,1113002,5
1908,180,8602,768443,768623,21
3671,37,8602,321202,321239,28
8803,55,8602,321203,321258,32
8520,187,8602,1112843,1113030,37
4117,250,8602,1112825,1113075,40
3659,136,8603,768560,768696,13
3399,205,8603,1112915,1113120,29
1919,48,8604,321281,321329,9
8827,58,8604,648686,648744,39
4532,215,8605,1384568,1384783,12
1995,249,8605,1208552,1208801,35
9832,13,8606,42438,42451,10
4932,175,8606,889054,889229,13
1909,41,8606,321346,321387,16
9601,35,8606,423133,423168,19
7257,96,8606,423094,423190,21
9099,58,8606,423153,423211,35
8868,213,8606,1005394,1005607,36
9777,43,8606,321415,321458,49
9442,125,8607,1005505,1005630,14
1833,299,8607,1112915,1113214,21
6496,28,8607,230044,230072,23
6890,278,8607,1208586,1208864,33
7593,257,8607,1284838,1285095,45
1581,50,8607,423243,423293,49
3004,300,8608,1342194,1342494,20
7569,134,8608,768839,768973,23
9449,290,8608,1284877,1285167,23
9760,275,8608,1284926,1285201,36
3566,34,8609,423333,423367,1
9293,5,8609,13878,13883,7
7801,179,8609,1285049,1285228,11
2345,253,8609,1208803,1209056,18
2914,189,8609,1208900,1209089,28
1588,69,8609,230123,230192,36
2774,46,8609,321576,321622,47
8470,163,8609,1113301,1113464,49
9032,193,8610,1436155,1436348,1
8559,248,8610,1415157,1415405,19
4574,250,8610,1285049,1285299,29
6350,247,8610,1113346,1113593,33
7948,227,8610,1342355,1342582,43
8609,17,8611,89000,89017,11
8407,174,8611,1113482,1113656,28
5665,198,8611,1113500,1113698,47
2942,191,8611,1342418,1342609,48
6299,132,8611,1113614,1113746,48
2773,89,8612,423444,423533,10
7681,8,8612,42582,42590,18
8234,125,8612,769160,769285,20
2648,141,8612,649116,649257,36
4775,210,8613,1436172,1436382,3
9858,148,8613,1005971,1006119,28
4758,229,8614,1384659,1384888,19
7968,187,8614,1005996,1006183,35
1781,33,8614,230317,230350,46
2243,182,8615,1006030,1006212,18
5040,111,8615,532861,532972,32
3456,127,8615,769268,769395,44
6001,8,8615,89096,89104,46
6215,164,8616,1209085,1209249,11
9448,9,8616,42638,42647,18
8740,135,8616,1209138,1209273,19
1310,119,8616,769327,769446,44
5628,176,8616,1006106,1006282,47
5148,283,8616,1285159,1285442,50
7733,249,8616,1209126,1209375,50
3028,119,8617,889770,889889,9
4594,129,8617,423642,423771,17
3396,230,8617,1113678,1113908,36
4379,292,8617,1209137,1209429,40
5796,194,8618,1384713,1384907,7
5383,64,8618,649444,649508,14
1813,228,8618,1342460,1342688,22
2419,244,8618,1285304,1285548,25
1516,117,8618,889896,890013,28
4937,199,8618,1006279,1006478,32
3769,288,8618,1451731,1452019,39
4906,155,8618,1006374,1006529,46
9373,266,8619,1451777,1452043,12
1243,256,8619,1436197,1436453,14
4205,270,8620,1462873,1463143,7
7951,196,8620,1006422,1006618,18
8647,190,8620,769600,769790,41
5826,48,8620,423929,423977,49
3290,1,8621,13977,13978,1
3815,186,8621,1285446,1285632,14
1852,54,8621,230598,230652,21
1537,286,8621,1384750,1385036,22
5306,188,8621,1209447,1209635,22
9529,61,8621,533287,533348,22
1434,103,8621,890123,890226,24
7488,4,8621,13990,13994,25
3435,31,8621,230668,230699,34
1990,21,8621,322142,322163,43
6856,295,8621,1415251,1415546,43
3477,49,8621,322133,322182,44
3152,203,8622,1209498,1209701,16
4715,245,8622,1342622,1342867,38
3608,284,8622,1342629,1342913,46
6245,238,8622,1285546,1285784,46
5754,70,8623,424041,424111,9
4617,36,8623,152374,152410,10
4927,52,8623,230733,230785,10
2749,232,8623,1114084,1114316,26
9005,270,8623,1285580,1285850,46
3510,173,8624,890234,890407,18
1360,85,8624,322223,322308,21
8429,281,8624,1285608,1285889,26
1962,133,8624,890331,890464,27
9368,259,8624,1436242,1436501,39
7911,36,8624,230851,230887,42
8374,204,8624,1114233,1114437,45
2182,195,8625,1114277,1114472,29
9972,300,8625,1342677,1342977,35
3772,185,8625,890415,890600,36
4528,25,8626,42856,42881,17
6975,197,8626,1342823,1343020,19
6320,174,8626,1006829,1007003,20
7102,223,8626,1114337,1114560,23
8261,273,8626,1285741,1286014,37
8683,16,8626,152547,152563,47
3926,148,8627,1342899,1343047,1
7030,48,8627,230923,230971,10
4294,63,8627,322388,322451,40
6843,210,8627,1342869,1343079,43
2678,70,8628,650037,650107,14
8250,84,8628,533598,533682,15
5495,263,8628,1415322,1415585,16
7232,257,8628,1209796,1210053,33
8447,298,8628,1342840,1343138,35
7894,70,8628,424318,424388,37
5849,71,8628,533671,533742,46
9157,227,8629,1451858,1452085,4
3202,135,8629,770216,770351,18
6905,164,8629,1114590,1114754,28
6574,60,8629,650173,650233,39
7820,253,8630,1451859,1452112,7
8580,54,8630,424409,424463,11
2573,173,8630,1114642,1114815,14
8120,70,8630,770341,770411,19
6179,46,8630,322578,322624,27
1227,229,8631,1451920,1452149,2
3297,210,8631,1007107,1007317,33
3425,32,8631,322622,322654,33
4199,274,8631,1209885,1210159,40
3991,27,8631,231135,231162,47
1981,235,8631,1384964,1385199,48
5388,142,8631,1210057,1210199,48
5422,275,8631,1436313,1436588,48
1618,236,8632,1436374,1436610,9
8115,36,8632,231169,231205,11
1624,14,8632,152756,152770,45
3391,197,8633,1436435,1436632,5
7711,153,8633,1343133,1343286,6
2373,92,8633,650318,650410,11
9831,2,8633,14100,14102,14
8433,53,8633,424552,424605,16
3915,52,8633,424568,424620,35
8176,21,8634,89610,89631,8
4164,85,8634,424567,424652,32
7376,123,8634,770473,770596,33
5580,139,8634,650334,650473,36
3898,255,8634,1286018,1286273,37
7660,99,8634,533899,533998,40
5483,209,8635,1385077,1385286,9
8708,275,8635,1114754,1115029,41
2016,288,8635,1436392,1436680,48
9114,87,8636,770599,770686,14
3806,267,8636,1007310,1007577,21
1318,287,8636,1436454,1436741,39
4886,95,8636,770658,770753,45
7061,292,8636,1286104,1286396,45
1835,209,8636,1210203,1210412,46
8385,214,8637,1451952,1452166,2
7363,23,8637,322908,322931,3
8818,141,8637,1343234,1343375,5
7164,162,8637,891054,891216,15
9046,172,8637,1115012,1115184,16
9542,28,8637,231400,231428,16
3910,287,8637,1451909,1452196,19
2901,202,8637,891092,891294,30
2486,127,8637,770814,770941,35
2254,173,8637,1210322,1210495,38
3528,116,8637,770890,771006,50
1647,55,8638,424890,424945,47
3157,4,8639,14158,14162,20
8583,65,8639,650738,650803,38
3130,227,8640,1452000,1452227,5
9393,73,8640,650764,650837,14
4895,32,8640,152987,153019,26
6911,3,8641,14167,14170,2
4194,169,8641,1210363,1210532,12
8201,144,8641,1007626,1007770,27
8901,285,8641,1385152,1385437,28
9520,220,8641,1343267,1343487,43
3220,68,8641,424963,425031,44
8199,99,8642,1115216,1115315,1
1824,278,8642,1451968,1452246,19
1225,100,8642,650843,650943,23
5208,34,8642,231541,231575,28
4070,267,8642,1115107,1115374,30
5943,300,8643,1385224,1385524,28
8880,277,8643,1385276,1385553,34
6623,248,8644,1343337,1343585,13
7353,189,8644,1007782,1007971,26
7577,61,8644,231589,231650,36
1096,204,8645,1007787,1007991,10
6079,266,8645,1210437,1210703,15
4214,117,8645,891494,891611,22
2435,260,8646,1470145,1470405,2
3968,38,8646,323200,323238,35
9112,123,8646,771179,771302,44
7261,119,8647,1210623,1210742,2
5840,118,8647,1210648,1210766,5
1917,251,8647,1210551,1210802,23
4860,65,8647,651132,651197,25
3501,44,8647,425216,425260,38
6775,200,8648,1436653,1436853,1
3960,271,8648,1385373,1385644,43
5035,240,8648,1343443,1343683,49
8976,210,8649,1452069,1452279,1
2159,172,8649,891606,891778,23
5661,11,8649,153226,153237,48
7915,231,8649,1210694,1210925,50
4253,296,8650,1436609,1436905,16
3606,70,8650,425277,425347,18
1506,135,8650,771383,771518,20
1460,202,8650,1008031,1008233,32
6719,245,8650,1115453,1115698,40
8346,207,8650,1008105,1008312,42
4861,42,8651,89975,90017,17
5841,292,8652,1474442,1474734,2
7368,219,8652,1452105,1452324,2
8359,213,8652,1008165,1008378,32
6867,94,8652,651354,651448,35
8697,257,8652,1385488,1385745,38
5366,165,8653,651339,651504,10
5773,167,8653,1210858,1211025,12
1761,21,8653,231882,231903,22
4321,11,8653,43289,43300,41
9200,116,8654,1210932,1211048,2
1998,287,8654,1343518,1343805,37
9320,155,8655,1115674,1115829,14
8538,82,8655,771646,771728,22
6722,24,8655,43305,43329,36
6710,197,8655,1115670,1115867,37
5130,91,8656,771664,771755,7
1437,125,8656,1008393,1008518,24
8893,24,8656,43336,43360,30
5440,237,8656,1115690,1115927,33
5915,177,8656,1343648,1343825,39
1221,65,8657,771762,771827,19
7557,140,8657,892006,892146,35
1090,219,8657,891967,892186,41
5828,293,8658,1474475,1474768,1
3944,191,8658,1436782,1436973,2
1086,93,8658,425595,425688,10
2135,37,8658,153430,153467,41
3831,114,8658,771814,771928,46
1097,140,8659,892100,892240,29
5027,192,8659,892083,892275,30
8878,93,8659,651738,651831,33
2989,253,8660,1462951,1463204,4
6671,163,8660,1385647,1385810,4
8253,19,8660,232060,232079,6
5347,165,8660,892164,892329,13
6599,204,8660,1343707,1343911,14
3166,38,8660,153492,153530,30
6103,81,8660,535058,535139,34
5280,52,8660,153510,153562,36
7546,187,8660,1286743,1286930,43
7876,169,8660,1115911,1116080,49
1181,32,8661,425788,425820,3
3432,61,8661,772031,772092,6
1462,276,8661,1462951,1463227,8
3400,290,8661,1415730,1416020,10
9193,214,8661,1385649,1385863,14
5859,62,8661,535177,535239,29
7033,169,8661,892280,892449,36
4657,125,8662,1008611,1008736,9
2395,201,8662,1343804,1344005,19
9249,125,8662,1116054,1116179,19
8782,43,8662,232179,232222,37
9602,98,8662,651960,652058,37
9106,238,8663,1436800,1437038,7
2134,26,8663,323856,323882,14
5327,161,8663,1116073,1116234,24
8307,106,8663,892433,892539,25
1108,62,8663,425936,425998,34
5558,298,8664,1343765,1344063,35
7804,172,8665,1343907,1344079,7
1275,256,8665,892358,892614,17
6084,264,8665,1385648,1385912,24
7981,296,8665,1415774,1416070,24
4746,81,8665,535356,535437,27
6626,3,8665,14368,14371,45
5893,110,8666,892559,892669,7
3499,64,8666,535402,535466,22
9082,110,8666,892587,892697,22
3387,140,8666,1116199,1116339,24
1362,286,8666,1116113,1116399,30
3540,39,8666,232370,232409,32
7348,294,8667,1470162,1470456,7
2173,285,8667,1462981,1463266,12
7065,96,8667,535472,535568,13
1438,210,8667,1116259,1116469,20
5098,131,8667,772352,772483,20
8452,13,8667,14400,14413,31
8213,108,8667,652235,652343,35
6824,20,8667,153835,153855,38
9958,201,8667,1286977,1287178,38
3282,175,8668,1415950,1416125,1
1399,47,8668,535603,535650,5
7201,98,8668,1116425,1116523,5
1111,205,8668,1116358,1116563,20
9222,154,8669,1116438,1116592,14
2252,298,8669,1415864,1416162,24
3063,262,8669,1211235,1211497,36
4329,241,8669,1211282,1211523,36
6532,220,8669,1211336,1211556,37
3450,257,8669,1385814,1386071,43
5241,172,8670,1211440,1211612,24
5772,277,8670,1344035,1344312,25
8156,81,8670,652455,652536,28
2204,274,8670,1287057,1287331,35
7674,283,8671,1287107,1287390,20
6550,257,8671,1211485,1211742,42
8409,264,8671,1287168,1287432,45
1385,279,8671,1436830,1437109,48
3657,188,8672,652477,652665,17
2388,295,8672,1287201,1287496,23
8278,243,8672,1211616,1211859,36
5245,75,8672,652657,652732,38
5104,43,8672,232640,232683,44
1478,35,8672,232667,232702,47
2240,47,8673,324324,324371,11
1862,141,8673,772719,772860,26
7193,6,8673,90594,90600,33
8861,60,8673,232687,232747,41
8163,59,8674,772814,772873,1
9135,158,8674,1385954,1386112,3
2217,57,8674,652727,652784,6
8710,167,8675,535852,536019,17
6130,44,8675,232759,232803,32
9872,151,8675,1211745,1211896,43
7160,210,8675,1116839,1117049,50
9018,4,8676,43757,43761,19
9561,95,8676,652749,652844,29
3652,23,8676,43756,43779,30
8413,118,8676,772826,772944,37
7439,32,8676,232818,232850,42
1795,113,8677,893149,893262,9
3362,214,8677,1287321,1287535,16
6779,52,8677,536061,536113,25
8489,58,8677,536072,536130,25
9835,143,8677,1116959,1117102,38
4398,141,8677,893200,893341,46
1996,257,8678,1344105,1344362,10
4897,38,8678,154175,154213,10
9620,249,8678,1415973,1416222,19
6633,93,8678,772959,773052,24
4553,178,8678,772928,773106,30
7373,167,8679,536101,536268,17
9751,121,8679,893263,893384,27
4237,18,8679,154252,154270,49
8100,87,8680,773056,773143,25
2190,89,8680,893313,893402,39
3380,12,8680,90760,90772,42
5939,111,8680,773086,773197,45
2118,197,8681,1009358,1009555,36
2394,38,8682,426773,426811,6
5838,247,8682,1385907,1386154,16
1973,192,8682,1009418,1009610,42
4222,67,8683,536313,536380,12
1637,267,8683,1211745,1212012,15
5213,45,8683,426845,426890,33
2377,268,8683,1287370,1287638,45
1292,14,8684,43889,43903,26
3691,165,8684,1009545,1009710,34
6984,17,8684,90809,90826,40
6465,275,8684,1287416,1287691,50
2561,31,8685,233060,233091,28
2589,162,8685,1117114,1117276,28
5669,59,8686,426893,426952,47
5393,70,8687,426897,426967,8
6508,160,8688,1386011,1386171,2
9492,194,8688,1436918,1437112,5
4026,205,8688,893455,893660,31
9646,73,8688,773352,773425,39
7115,205,8688,1009606,1009811,40
9900,113,8689,653192,653305,15
2265,82,8689,426989,427071,18
5577,176,8689,893557,893733,42
3949,244,8689,1287509,1287753,47
3734,238,8690,1287535,1287773,13
3341,144,8690,893689,893833,50
5715,60,8691,233187,233247,21
6794,241,8691,1344223,1344464,22
9960,8,8691,43971,43979,32
8729,118,8691,773472,773590,35
8956,190,8692,1416068,1416258,4
6831,67,8692,427121,427188,15
6662,216,8692,1117205,1117421,20
5937,109,8692,893812,893921,38
9908,230,8692,1212010,1212240,46
3987,202,8693,1436931,1437133,4
1957,44,8693,324949,324993,13
1179,195,8693,1009795,1009990,26
1539,209,8693,1009815,1010024,40
3731,275,8694,1385968,1386243,13
4524,182,8694,1117336,1117518,16
3018,195,8694,1212119,1212314,22
5028,22,8694,90978,91000,41
6334,113,8694,773682,773795,47
5710,44,8695,536756,536800,4
1389,281,8695,1287617,1287898,20
4733,126,8695,1010024,1010150,24
2130,237,8695,1117360,1117597,31
5221,244,8695,1212150,1212394,35
3326,138,8695,1117523,1117661,43
3598,64,8696,325082,325146,10
7321,168,8696,894047,894215,15
1867,232,8696,1212194,1212426,18
4395,137,8696,773856,773993,20
5235,165,8696,894117,894282,23
9827,256,8696,1212230,1212486,44
3867,73,8696,773984,774057,48
4076,160,8697,894175,894335,15
3256,149,8697,653714,653863,31
9185,255,8697,1212297,1212552,45
6854,48,8698,653845,653893,2
5392,139,8698,773997,774136,18
9828,105,8698,536983,537088,18
1887,207,8698,1010151,1010358,23
9101,118,8698,537011,537129,31
2107,109,8698,774086,774195,33
4035,232,8698,1212364,1212596,37
2051,102,8698,894335,894437,38
7178,159,8698,1010252,1010411,47
9733,81,8699,537129,537210,11
3333,43,8699,325345,325388,15
4770,60,8699,325352,325412,44
3340,272,8699,1386009,1386281,49
5861,50,8700,653988,654038,1
8479,31,8700,427652,427683,2
7520,17,8700,154798,154815,5
1969,258,8700,1344299,1344557,13
4330,195,8700,1212486,1212681,25
2775,238,8700,1287733,1287971,27
1694,160,8700,1117728,1117888,28
5477,100,8700,774270,774370,50
8896,50,8702,325455,325505,15
1578,227,8703,1436917,1437144,7
1551,257,8703,894351,894608,17
8618,69,8703,233711,233780,21
1901,171,8703,1010405,1010576,29
1418,290,8703,1212484,1212774,40
6474,37,8704,325540,325577,35
3378,238,8704,1212586,1212824,37
5113,58,8704,233781,233839,41
8815,37,8704,233822,233859,46
8245,65,8704,537339,537404,49
9109,20,8705,154952,154972,12
5036,17,8705,91296,91313,35
5825,236,8705,1212630,1212866,35
4669,207,8706,1386104,1386311,12
2308,221,8706,1287810,1288031,16
1557,14,8706,91319,91333,32
6696,250,8706,1287828,1288078,46
2221,106,8707,325568,325674,17
6512,47,8707,233897,233944,18
1541,182,8707,774402,774584,21
3770,114,8707,894678,894792,22
8272,51,8707,427882,427933,29
3654,99,8707,427857,427956,31
1173,88,8707,774537,774625,38
2423,56,8707,654290,654346,39
2178,170,8708,1212791,1212961,12
5109,226,8708,1117879,1118105,23
2879,285,8708,1386081,1386366,24
3315,81,8708,325719,325800,31
4252,157,8708,1010654,1010811,46
8029,228,8708,1212808,1213036,47
1984,297,8708,1452101,1452398,48
8219,257,8709,1470179,1470436,6
5504,163,8709,894794,894957,15
3796,75,8709,774719,774794,19
7184,76,8709,774741,774817,19
5432,89,8709,325812,325901,21
7390,261,8709,1386180,1386441,22
8723,119,8709,1010787,1010906,25
8003,231,8709,1118023,1118254,26
9815,112,8709,774783,774895,34
8930,185,8709,894889,895074,42
4399,49,8709,428128,428177,50
5508,232,8710,1436972,1437204,9
3105,7,8710,44362,44369,13
3703,115,8710,325913,326028,17
7011,105,8710,428118,428223,31
8018,65,8710,428181,428246,34
9604,216,8710,1118076,1118292,36
8966,4,8710,44405,44409,50
1070,202,8711,1118116,1118318,18
1498,299,8712,1462974,1463273,14
3924,126,8712,895054,895180,28
5800,204,8712,1010868,1011072,33
3928,273,8712,1212882,1213155,40
6186,298,8714,1470165,1470463,7
2128,111,8714,774984,775095,11
1407,163,8714,1010980,1011143,29
2129,197,8714,1118226,1118423,37
8463,86,8714,537818,537904,42
6368,122,8714,1118320,1118442,48
4038,276,8715,1463046,1463322,7
6423,67,8715,428371,428438,23
7197,125,8715,654690,654815,26
4867,297,8715,1287957,1288254,31
4187,168,8715,1288118,1288286,39
5201,111,8715,775133,775244,50
2906,127,8716,1288177,1288304,5
3085,224,8716,1288119,1288343,16
2563,115,8716,895309,895424,24
6249,237,8716,1118357,1118594,33
5330,43,8716,537997,538040,43
5632,195,8717,1437080,1437275,5
7936,120,8717,654857,654977,13
3133,299,8717,1386278,1386577,28
1482,32,8717,155436,155468,32
3853,126,8717,654887,655013,36
7950,149,8718,1344662,1344811,1
8613,82,8718,775288,775370,24
6322,256,8719,1288177,1288433,37
5441,117,8720,775301,775418,11
7243,286,8720,1386328,1386614,25
3681,228,8720,1288284,1288512,28
7038,35,8720,234513,234548,28
5744,144,8720,538067,538211,41
6214,123,8721,1011317,1011440,24
6823,109,8721,538147,538256,26
5817,297,8721,1118493,1118790,30
6399,197,8721,1288361,1288558,43
6444,242,8722,1288335,1288577,10
4151,204,8722,1344664,1344868,14
9901,40,8722,155567,155607,41
3666,255,8722,1386403,1386658,43
5485,63,8722,428716,428779,44
5617,195,8722,1011406,1011601,44
2401,227,8723,1452268,1452495,4
7167,210,8723,1386496,1386706,19
5394,31,8723,155621,155652,26
8392,64,8724,326495,326559,10
6553,124,8725,1288549,1288673,2
9181,26,8725,326544,326570,4
1881,47,8725,538342,538389,6
9580,174,8725,1386564,1386738,6
2309,196,8725,1386560,1386756,8
1284,247,8725,1288486,1288733,13
2249,21,8725,234709,234730,22
7462,3,8725,14909,14912,49
6211,53,8726,538393,538446,48
4862,43,8727,538414,538457,5
2722,132,8727,538361,538493,21
4335,19,8727,155716,155735,29
3405,227,8727,1416213,1416440,39
4083,289,8727,1416182,1416471,49
1411,298,8728,1474445,1474743,1
2966,158,8728,655214,655372,21
8997,152,8728,895698,895850,35
2162,211,8729,1118832,1119043,44
1611,67,8730,428929,428996,9
1697,5,8730,44660,44665,12
3601,143,8730,775621,775764,15
9155,17,8730,155785,155802,16
4056,238,8730,1213415,1213653,18
6736,199,8730,1386644,1386843,39
1559,71,8731,895854,895925,1
4069,182,8731,655351,655533,10
1892,94,8731,234812,234906,17
1291,98,8731,538593,538691,26
4305,30,8732,429060,429090,3
5480,54,8732,429053,429107,12
8339,193,8732,1344895,1345088,19
3639,159,8732,895825,895984,20
8801,257,8732,1344889,1345146,22
6544,10,8732,91980,91990,45
7047,165,8732,1118995,1119160,49
7958,193,8732,1119009,1119202,50
8484,1,8733,14962,14963,3
7646,138,8733,1119081,1119219,8
2959,67,8733,538709,538776,12
6647,294,8733,1416233,1416527,38
3626,65,8733,655587,655652,43
1890,16,8733,155926,155942,49
4191,199,8734,1437121,1437320,6
4270,16,8734,44745,44761,17
7276,15,8734,92018,92033,18
2895,154,8734,1119138,1119292,24
2933,113,8734,896026,896139,25
6101,202,8734,1011788,1011990,26
1840,44,8734,155939,155983,36
4607,64,8735,326891,326955,18
5918,66,8735,538793,538859,20
3823,66,8735,429223,429289,23
5074,185,8735,1011830,1012015,26
2327,212,8735,1213579,1213791,27
5829,300,8735,1386619,1386919,27
3638,157,8735,1011946,1012103,50
7453,294,8736,1474481,1474775,2
1605,29,8736,235096,235125,9
1880,294,8736,1416295,1416589,13
9848,9,8736,44818,44827,20
1509,150,8736,896183,896333,29
3002,14,8736,156056,156070,39
8810,31,8736,235125,235156,46
5552,109,8737,896252,896361,24
8685,223,8737,1119181,1119404,36
3466,224,8737,1213659,1213883,37
8473,13,8737,44852,44865,41
5124,283,8738,1474518,1474801,3
7204,233,8738,1213688,1213921,10
8006,177,8738,1288818,1288995,11
8651,242,8738,1437137,1437379,11
1026,142,8738,776126,776268,18
1355,293,8738,1119257,1119550,30
9988,43,8738,156128,156171,31
4810,139,8738,655891,656030,36
7177,224,8739,1416427,1416651,9
9962,189,8739,896358,896547,15
9473,168,8739,896417,896585,18
4826,58,8739,429534,429592,20
5734,300,8739,1288773,1289073,33
7887,10,8739,92240,92250,34
7458,285,8739,1119361,1119646,41
8288,4,8739,15068,15072,45
4868,162,8740,1288925,1289087,9
8749,43,8740,156221,156264,10
1443,67,8740,539189,539256,12
3875,295,8740,1437116,1437411,16
9382,246,8740,1119482,1119728,32
4577,224,8740,1345134,1345358,43
4724,207,8740,1119599,1119806,50
2201,299,8741,1474543,1474842,3
1390,205,8741,1386861,1387066,7
5959,184,8741,896638,896822,13
1729,263,8741,1288950,1289213,37
3735,53,8741,429712,429765,46
6841,143,8742,1119734,1119877,11
5123,171,8742,1119754,1119925,22
2411,137,8742,1012445,1012582,24
6955,27,8743,327393,327420,1
1874,218,8743,1416488,1416706,8
7514,139,8743,539320,539459,10
5756,220,8743,1386894,1387114,12
1471,231,8743,1213954,1214185,20
3434,44,8743,327446,327490,20
5702,282,8743,1345186,1345468,27
6414,207,8744,1345289,1345496,14
5061,254,8744,1345299,1345553,24
6577,11,8744,92380,92391,25
9599,54,8744,235505,235559,26
5229,113,8744,776643,776756,29
4505,189,8744,1119905,1120094,34
2303,212,8744,1214084,1214296,46
2680,249,8744,1416494,1416743,48
8191,213,8745,1289151,1289364,16
8152,288,8745,896859,897147,17
3136,175,8745,897012,897187,26
7122,175,8745,897044,897219,36
3933,221,8745,1214168,1214389,46
4269,210,8745,1120042,1120252,50
8455,76,8746,429987,430063,44
2232,74,8747,897210,897284,3
5276,281,8747,1452310,1452591,12
9934,19,8747,235683,235702,33
1747,41,8747,235678,235719,44
6004,216,8748,897145,897361,30
6963,159,8748,1012711,1012870,37
4955,291,8748,1416499,1416790,49
5869,76,8749,897339,897415,3
2075,38,8749,156576,156614,8
2218,220,8749,1289223,1289443,25
4146,243,8749,1386971,1387214,43
3847,156,8749,1012804,1012960,45
2330,163,8750,1289323,1289486,8
8950,107,8750,539725,539832,18
3344,291,8750,1289245,1289536,26
3236,96,8750,777054,777150,28
2598,230,8750,1214329,1214559,35
7067,146,8750,897424,897570,44
9765,192,8750,1120251,1120443,50
6740,94,8751,1120364,1120458,1
1480,94,8751,656737,656831,8
7401,146,8751,777122,777268,13
9568,12,8752,92587,92599,34
3811,230,8752,1214370,1214600,37
6654,78,8752,539903,539981,47
1222,6,8753,92609,92615,24
4071,23,8753,156718,156741,25
5384,27,8753,92603,92630,30
8591,20,8753,235884,235904,33
4771,192,8754,1416628,1416820,5
2391,36,8754,156735,156771,8
6558,30,8754,156753,156783,26
5808,83,8754,430264,430347,30
4007,30,8754,327875,327905,39
2362,23,8754,92657,92680,41
3851,216,8754,1345478,1345694,43
7046,161,8755,1387084,1387245,4
7010,155,8755,897542,897697,23
4144,71,8755,327885,327956,26
4490,231,8755,1289394,1289625,34
1174,161,8755,1013030,1013191,46
2002,129,8755,897646,897775,50
2207,140,8756,1289514,1289654,4
1268,197,8756,1214518,1214715,34
3467,137,8756,1120477,1120614,38
5855,205,8756,1120463,1120668,50
4129,272,8757,1452345,1452617,11
1071,168,8757,1120552,1120720,49
7408,30,8758,430453,430483,3
5262,17,8758,156879,156896,28
9341,102,8758,897802,897904,38
4963,267,8759,1387010,1387277,13
7983,121,8759,657006,657127,13
7543,259,8759,1289480,1289739,27
1372,136,8759,1120648,1120784,38
9690,168,8759,1013237,1013405,44
3251,146,8760,1120663,1120809,9
2627,120,8760,540148,540268,21
2344,116,8760,897921,898037,24
4517,5,8760,15246,15251,26
1903,10,8760,15251,15261,30
3076,33,8760,92781,92814,31
5978,92,8760,777545,777637,49
6070,129,8761,430524,430653,17
8291,47,8761,328168,328215,23
7020,299,8761,1289473,1289772,31
8051,118,8761,540217,540335,31
8934,14,8761,157013,157027,38
7627,248,8761,1214578,1214826,42
2385,162,8761,1214701,1214863,43
2791,45,8761,430688,430733,50
7203,1,8762,15295,15296,23
3694,53,8762,328249,328302,27
3323,160,8762,777583,777743,32
7058,114,8762,1013402,1013516,39
6230,37,8763,328305,328342,24
7757,40,8763,328317,328357,49
6649,37,8764,157052,157089,7
7558,65,8764,328313,328378,7
7002,217,8764,1013331,1013548,31
9745,244,8764,1289566,1289810,46
5570,82,8764,777741,777823,48
3592,229,8765,1214683,1214912,10
8526,169,8765,1289679,1289848,19
9513,223,8765,898008,898231,21
6082,218,8765,1387086,1387304,48
7965,297,8766,1470226,1470523,8
3656,58,8766,540483,540541,14
4028,57,8766,540499,540556,22
2984,100,8766,898177,898277,25
3645,82,8766,657405,657487,33
1752,71,8766,430873,430944,42
8626,169,8767,1387180,1387349,5
9143,176,8767,1214828,1215004,14
5307,152,8767,898176,898328,18
7615,36,8767,92989,93025,21
7927,78,8767,657480,657558,24
7782,164,8767,777844,778008,32
3196,267,8767,1387129,1387396,38
4696,94,8767,540597,540691,42
2797,260,8768,1470290,1470550,1
7349,199,8768,1289789,1289988,43
1997,36,8769,157237,157273,8
5214,17,8769,93048,93065,11
1195,26,8769,93050,93076,21
3900,95,8769,777970,778065,28
5020,16,8769,157271,157287,29
1619,289,8769,1345572,1345861,35
5760,69,8769,236445,236514,36
8653,248,8769,1013525,1013773,41
1739,169,8770,898280,898449,32
6948,106,8770,1013687,1013793,39
9225,223,8771,1452453,1452676,1
2964,284,8771,1452428,1452712,14
1143,195,8771,778033,778228,21
1395,177,8771,778080,778257,21
8189,78,8771,657740,657818,24
4709,300,8771,1387195,1387495,34
1349,106,8771,540795,540901,36
6062,113,8771,1013764,1013877,48
7447,250,8771,1345717,1345967,49
2579,10,8771,93177,93187,50
7533,88,8772,778238,778326,22
5421,116,8772,898466,898582,24
1246,148,8772,778225,778373,32
5575,125,8772,657814,657939,32
8144,21,8772,45572,45593,36
2244,272,8773,1470312,1470584,3
3057,276,8773,1437292,1437568,19
9302,7,8773,15424,15431,21
2382,213,8774,1416744,1416957,8
1682,122,8774,898523,898645,28
2920,110,8774,898556,898666,49
1640,299,8774,1345762,1346061,50
9128,175,8775,1215105,1215280,14
3946,140,8775,657907,658047,31
9582,211,8775,1013828,1014039,42
9586,120,8776,1215183,1215303,4
6573,279,8776,1387333,1387612,38
6990,206,8777,1013907,1014113,13
3745,141,8777,1014011,1014152,22
4767,274,8777,1387383,1387657,24
3680,293,8777,1345885,1346178,27
4156,250,8777,1290071,1290321,27
1028,142,8777,541087,541229,41
8282,216,8778,1416758,1416974,9
6704,94,8778,778550,778644,28
5260,26,8778,236844,236870,29
4327,112,8778,778562,778674,46
8649,279,8778,1437325,1437604,48
6027,147,8779,778567,778714,40
6275,50,8779,329053,329103,44
2621,201,8779,1290180,1290381,49
1563,30,8780,431576,431606,2
9354,143,8780,1215360,1215503,19
1507,129,8780,1014189,1014318,25
4619,12,8780,15473,15485,30
1484,227,8780,1014149,1014376,32
9367,6,8781,45682,45688,15
1628,206,8781,1215341,1215547,16
6689,101,8781,658257,658358,29
3687,260,8781,1121273,1121533,31
7790,284,8781,1215311,1215595,31
2848,95,8782,1014370,1014465,19
5352,133,8782,1215483,1215616,19
5070,90,8782,778804,778894,25
2029,12,8782,45720,45732,32
8761,172,8782,898931,899103,42
9326,248,8783,1463190,1463438,2
7137,90,8783,778861,778951,22
5136,139,8783,658360,658499,31
6292,240,8784,1416809,1417049,12
5848,226,8784,1215439,1215665,13
4366,22,8784,157729,157751,29
9936,271,8784,1290183,1290454,35
7638,262,8784,1121438,1121700,40
7867,221,8784,1121513,1121734,42
9771,39,8784,329315,329354,46
3873,51,8785,541566,541617,14
8432,295,8785,1452481,1452776,19
8217,94,8785,658550,658644,20
7377,183,8785,1290326,1290509,43
5960,201,8786,1437459,1437660,6
5403,11,8786,93464,93475,15
8012,109,8786,329316,329425,17
4027,198,8786,778957,779155,21
7626,19,8786,157837,157856,22
3238,166,8786,899143,899309,26
2824,253,8786,1014470,1014723,30
3725,90,8786,779149,779239,38
8632,266,8787,1437430,1437696,14
9186,26,8787,329470,329496,14
1296,153,8787,899231,899384,18
3520,3,8787,15570,15573,37
3908,200,8788,1014584,1014784,13
7619,195,8789,1215606,1215801,28
3414,19,8789,45832,45851,36
9716,116,8789,779227,779343,47
3178,291,8789,1416853,1417144,49
4526,53,8790,658819,658872,4
4821,125,8790,1014723,1014848,14
7732,169,8791,1387675,1387844,2
6941,186,8791,1416987,1417173,3
8146,84,8791,329523,329607,36
6367,77,8791,237270,237347,41
7181,204,8791,1121721,1121925,45
4540,79,8792,432027,432106,30
4023,257,8792,1215638,1215895,33
8954,207,8792,1215725,1215932,34
9937,115,8792,541808,541923,36
5259,53,8793,658933,658986,1
4620,137,8793,1346228,1346365,2
7260,79,8793,541881,541960,13
4930,144,8793,779384,779528,23
2410,258,8793,1387630,1387888,49
7496,224,8793,1290453,1290677,49
3298,198,8794,1014849,1015047,15
3890,119,8794,899560,899679,22
1610,130,8795,779507,779637,23
2997,272,8795,1215756,1216028,40
4368,159,8796,899575,899734,18
8227,71,8796,542041,542112,20
8450,203,8796,1014926,1015129,23
1341,285,8796,1215814,1216099,33
1081,80,8796,432283,432363,37
7279,270,8796,1215862,1216132,40
8844,246,8796,1215944,1216190,45
3129,130,8796,779701,779831,47
2396,159,8797,542068,542227,17
1160,104,8797,659185,659289,23
5064,134,8797,899738,899872,37
9170,54,8798,659268,659322,1
3259,230,8798,1121977,1122207,15
9694,170,8798,1122069,1122239,16
1396,36,8798,93744,93780,21
3989,40,8798,329922,329962,46
3907,29,8799,329944,329973,3
4013,249,8799,1463209,1463458,5
2324,95,8799,237582,237677,17
9790,185,8799,659219,659404,17
4412,182,8799,1122104,1122286,34
9637,171,8799,1216065,1216236,38
5761,212,8800,1122145,1122357,20
8303,136,8801,1290575,1290711,6
8547,51,8801,542348,542399,14
6699,106,8801,1015278,1015384,48
9131,271,8802,1452538,1452809,12
9086,275,8802,1290484,1290759,26
9732,33,8802,158289,158322,26
7406,297,8802,1122183,1122480,30
7604,25,8802,158325,158350,34
6175,57,8802,330052,330109,37
7977,171,8802,899964,900135,42
8552,136,8802,1122377,1122513,43
6516,17,8803,158361,158378,28
7343,70,8803,542434,542504,35
3156,267,8804,1346177,1346444,10
6557,3,8804,46100,46103,14
2729,41,8804,432671,432712,19
5069,24,8804,237814,237838,29
1510,208,8804,1122357,1122565,44
6401,226,8805,1452614,1452840,3
1613,199,8805,1387749,1387948,8
9995,168,8805,659522,659690,10
4485,48,8805,158417,158465,30
4904,98,8805,780069,780167,45
2804,6,8805,93964,93970,48
8107,40,8806,542585,542625,5
9298,79,8806,542562,542641,7
6329,237,8806,1122413,1122650,33
9223,178,8806,1216178,1216356,49
6785,36,8807,432790,432826,6
5370,73,8807,542602,542675,7
8355,276,8807,1290573,1290849,18
9271,208,8807,1122520,1122728,18
4939,281,8807,1122485,1122766,21
2828,199,8807,1122622,1122821,27
6682,116,8807,780214,780330,34
3413,137,8807,900237,900374,35
6518,169,8807,900244,900413,42
7672,151,8808,1346347,1346498,4
5424,166,8808,1290723,1290889,7
6039,209,8808,1387763,1387972,11
9171,147,8808,1216312,1216459,19
4881,231,8808,1290726,1290957,25
4058,251,8808,1290741,1290992,29
9281,276,8808,1122707,1122983,30
7854,6,8808,15766,15772,37
1912,161,8808,900422,900583,44
6730,37,8808,238069,238106,47
8160,197,8809,1216357,1216554,16
3368,35,8809,158631,158666,18
4839,138,8809,659927,660065,36
6253,179,8809,900459,900638,36
8022,37,8810,433053,433090,5
8372,121,8810,1015745,1015866,7
1972,3,8810,46277,46280,9
4184,78,8810,542900,542978,11
2958,189,8810,1290827,1291016,14
5610,185,8810,1216420,1216605,22
2528,208,8810,1216458,1216666,25
4153,241,8810,1216454,1216695,26
1582,107,8810,433079,433186,31
1928,36,8810,433161,433197,33
9435,195,8810,1216525,1216720,34
1436,46,8810,330577,330623,42
5655,227,8810,1290841,1291068,49
7483,119,8811,1216652,1216771,2
3100,218,8811,1417008,1417226,11
5363,256,8811,900574,900830,17
6197,68,8811,330629,330697,26
9424,230,8811,1122980,1123210,32
9652,198,8811,1123051,1123249,37
9244,104,8811,1015993,1016097,43
8780,35,8812,433282,433317,6
2857,47,8812,543115,543162,14
9432,199,8812,1015947,1016146,23
5771,291,8812,1387757,1388048,24
3718,286,8812,1216582,1216868,32
9303,93,8813,433315,433408,40
9325,291,8813,1216630,1216921,40
5921,75,8813,238362,238437,41
4516,263,8814,1452595,1452858,11
2969,109,8814,780814,780923,12
6400,247,8814,1346380,1346627,38
1379,46,8815,660376,660422,2
8978,243,8815,1216748,1216991,26
7767,133,8815,900942,901075,27
3000,31,8815,158950,158981,32
4172,130,8815,780886,781016,35
3338,229,8815,1346435,1346664,38
6680,28,8816,330877,330905,5
4227,241,8816,1123229,1123470,15
1212,69,8816,781003,781072,19
5593,138,8816,1016228,1016366,24
8969,98,8816,660466,660564,34
8464,135,8817,1016267,1016402,24
8753,146,8817,1216898,1217044,39
1819,249,8818,1417030,1417279,19
6993,217,8818,1123338,1123555,20
9916,129,8818,660520,660649,30
8161,242,8818,1123379,1123621,33
8999,183,8818,1016360,1016543,37
6688,125,8818,1123518,1123643,48
1256,115,8819,660625,660740,13
6965,294,8819,1452597,1452891,39
8067,127,8819,660668,660795,42
1593,183,8820,1417148,1417331,3
8937,95,8820,660725,660820,8
1330,84,8820,543498,543582,15
1940,222,8820,1291062,1291284,24
6178,41,8820,433715,433756,25
8082,292,8820,1291062,1291354,45
1652,290,8821,1437508,1437798,16
8882,165,8821,901236,901401,18
5807,63,8821,543596,543659,29
8641,25,8821,159134,159159,32
8993,180,8821,1016522,1016702,35
7670,101,8821,901356,901457,48
9557,183,8822,901321,901504,26
1011,161,8822,1291241,1291402,39
2132,41,8822,433826,433867,45
3384,98,8822,781318,781416,45
9998,25,8822,159189,159214,46
6015,256,8822,1291195,1291451,47
6604,81,8823,433836,433917,8
2239,260,8823,1437571,1437831,39
2115,34,8823,331222,331256,45
1732,12,8823,94526,94538,49
5782,75,8824,543689,543764,7
4499,39,8824,238775,238814,18
5974,252,8824,1123604,1123856,32
7601,35,8824,94543,94578,36
1007,292,8824,1216999,1217291,40
1885,271,8824,1291247,1291518,50
4700,250,8824,1217144,1217394,50
7621,252,8825,1463221,1463473,2
4529,8,8825,46576,46584,3
7512,22,8825,159287,159309,13
8046,183,8825,1016737,1016920,23
3940,208,8825,1016778,1016986,33
5556,185,8825,1346614,1346799,39
8903,245,8826,1463260,1463505,3
2825,129,8826,543796,543925,10
4408,75,8826,238843,238918,17
3449,40,8826,159343,159383,26
3891,139,8826,661057,661196,32
2203,16,8826,238920,238936,33
6833,208,8826,901584,901792,41
8715,143,8827,781562,781705,18
1688,76,8827,661179,661255,28
4449,182,8827,1016873,1017055,44
5488,220,8828,1016894,1017114,15
4539,269,8829,1463257,1463526,7
9417,38,8829,159434,159472,10
9537,229,8829,1346630,1346859,24
6878,159,8829,901763,901922,33
2581,96,8829,434122,434218,36
7967,281,8830,1463269,1463550,11
8280,169,8830,1123920,1124089,25
2610,102,8830,544017,544119,26
6555,294,8830,1217260,1217554,32
9145,13,8830,94752,94765,39
8262,294,8831,1474495,1474789,6
7882,276,8831,1417211,1417487,16
6853,249,8831,1217398,1217647,20
5546,22,8831,239088,239110,22
2434,6,8831,46712,46718,25
5356,154,8831,1124072,1124226,38
4684,215,8831,1217476,1217691,46
5564,245,8832,1417279,1417524,19
6721,295,8832,1346677,1346972,37
7644,56,8832,661452,661508,39
7554,176,8832,901954,902130,40
2608,106,8833,781912,782018,8
2771,277,8833,1417280,1417557,16
2299,281,8834,1474532,1474813,2
3700,134,8834,1124221,1124355,7
1326,240,8834,1124171,1124411,26
7473,141,8834,902088,902229,29
2921,246,8834,1346811,1347057,38
4582,199,8834,902099,902298,40
4290,5,8834,16034,16039,41
1137,260,8834,1417363,1417623,48
9630,26,8835,159656,159682,8
5707,252,8835,1346867,1347119,25
7892,92,8835,782097,782189,28
3534,19,8835,94872,94891,37
9538,242,8835,1217666,1217908,45
2241,104,8836,434445,434549,10
6303,50,8836,331759,331809,13
4458,280,8836,1291609,1291889,20
5176,189,8836,1124390,1124579,50
4537,238,8837,1437725,1437963,7
6357,243,8837,1417431,1417674,19
6717,32,8837,331828,331860,39
4229,147,8837,1017465,1017612,46
7132,192,8838,1217807,1217999,16
3199,187,8838,661637,661824,17
7070,112,8838,902398,902510,25
9668,293,8838,1388139,1388432,25
1944,178,8838,1017522,1017700,29
3311,95,8838,434605,434700,30
3215,32,8838,239385,239417,34
8928,111,8838,1017607,1017718,38
6157,100,8838,544472,544572,40
4031,236,8838,1347014,1347250,43
4887,121,8838,902499,902620,49
9647,82,8839,1017668,1017750,2
9956,23,8839,159843,159866,20
1475,106,8839,782343,782449,34
6421,296,8839,1217817,1218113,40
7998,24,8839,159873,159897,44
5190,141,8840,782381,782522,23
5777,225,8841,1452794,1453019,4
7921,234,8841,902490,902724,21
5390,179,8841,1017651,1017830,44
2471,245,8842,1437760,1438005,11
7296,126,8842,782517,782643,33
6180,137,8842,1124632,1124769,48
3261,92,8843,1124690,1124782,1
8837,32,8843,95063,95095,10
7277,128,8843,902687,902815,12
3723,211,8843,1388267,1388478,14
7495,2,8844,16114,16116,8
6634,216,8844,1291853,1292069,22
3160,232,8844,1124646,1124878,26
5531,55,8844,434886,434941,27
7092,278,8844,1124640,1124918,41
9119,163,8844,662060,662223,41
6276,168,8845,1388339,1388507,2
7072,106,8845,1124849,1124955,5
7361,275,8845,1463332,1463607,7
2077,231,8845,1388346,1388577,19
6769,137,8845,902835,902972,37
4912,182,8845,1017880,1018062,44
1777,166,8845,1017937,1018103,45
5090,289,8846,1347093,1347382,35
7378,243,8846,1218035,1218278,36
8204,220,8846,1218097,1218317,47
5018,298,8847,1463344,1463642,12
1237,171,8847,1124938,1125109,16
7826,136,8847,782872,783008,23
9679,120,8847,903040,903160,28
8296,263,8847,1124883,1125146,30
2907,246,8847,1124937,1125183,31
6621,293,8847,1291901,1292194,31
8920,80,8848,545031,545111,11
4113,12,8848,160160,160172,14
7069,212,8848,1292021,1292233,22
1105,56,8848,332377,332433,32
8047,9,8848,95270,95279,38
4947,202,8848,1018159,1018361,42
9945,100,8849,783058,783158,27
8757,34,8849,95273,95307,30
8053,192,8849,1018194,1018386,36
5616,233,8850,1463428,1463661,2
4784,145,8850,1125124,1125269,9
9856,40,8850,435270,435310,14
8125,235,8850,783015,783250,17
7358,11,8851,47093,47104,10
4783,217,8851,1417551,1417768,11
8002,288,8851,1125043,1125331,41
5536,200,8852,1125165,1125365,20
4139,59,8852,332525,332584,26
1217,78,8852,545223,545301,27
3161,28,8852,332579,332607,33
3972,222,8852,1218219,1218441,37
3525,157,8853,1388484,1388641,1
8496,46,8853,435380,435426,49
4043,11,8854,95394,95405,13
7196,300,8854,1347191,1347491,29
5369,275,8854,1347270,1347545,34
9768,297,8854,1347293,1347590,37
6309,206,8854,1018430,1018636,42
1600,15,8854,95421,95436,44
2900,296,8854,1437812,1438108,48
2010,27,8855,332675,332702,5
9808,53,8855,240008,240061,10
2310,164,8855,1125377,1125541,14
1623,50,8855,435465,435515,28
9955,120,8855,783372,783492,34
2916,47,8856,332710,332757,23
5794,76,8856,783435,783511,39
2472,102,8857,1125460,1125562,2
2779,286,8857,1125319,1125605,21
6288,53,8857,545429,545482,39
9292,66,8857,435532,435598,47
4118,168,8857,1292238,1292406,48
6278,218,8857,1388478,1388696,48
2489,243,8858,1463443,1463686,1
2957,31,8858,160430,160461,7
8246,234,8858,1218410,1218644,18
5094,112,8858,783522,783634,20
2844,64,8858,332809,332873,26
1091,41,8858,332850,332891,29
6735,232,8859,1452886,1453118,4
3792,285,8859,1452870,1453155,14
6754,188,8859,1218510,1218698,16
8794,77,8859,545522,545599,23
7460,132,8859,1018735,1018867,28
5446,81,8859,662938,663019,49
6567,163,8860,1388605,1388768,5
8233,299,8860,1417599,1417898,43
1617,50,8861,663001,663051,6
5277,278,8861,1292288,1292566,20
3051,29,8861,160539,160568,27
8094,86,8861,545601,545687,44
8185,260,8862,1470308,1470568,1
6263,54,8862,663043,663097,2
1532,167,8862,1018808,1018975,34
7975,266,8863,1470332,1470598,6
9369,58,8863,332975,333033,7
3642,11,8863,95613,95624,13
3668,203,8863,1125665,1125868,37
7555,150,8863,1018892,1019042,46
7076,13,8864,160619,160632,2
2289,239,8864,1437980,1438219,8
4739,270,8864,1452942,1453212,14
9315,79,8864,240300,240379,17
8439,203,8864,903724,903927,30
7200,53,8864,240362,240415,40
7969,100,8865,1125824,1125924,3
6189,291,8865,1018836,1019127,17
9461,186,8865,1218670,1218856,22
7073,78,8865,783875,783953,39
7591,18,8865,160719,160737,49
8576,109,8866,333064,333173,17
2194,71,8866,545793,545864,35
1809,10,8867,95727,95737,3
5046,177,8867,1347625,1347802,7
3173,166,8867,545746,545912,17
2302,245,8867,1218669,1218914,18
4325,100,8867,783906,784006,28
1263,23,8867,240523,240546,29
2690,211,8868,1438060,1438271,5
1351,7,8868,95778,95785,14
6962,78,8868,545901,545979,20
2293,196,8868,1019043,1019239,23
3976,55,8868,545956,546011,25
5003,288,8869,1474525,1474813,1
8110,219,8869,903897,904116,21
2789,256,8869,1347621,1347877,25
7485,179,8869,1292554,1292733,48
6415,46,8870,240573,240619,7
9146,49,8870,333295,333344,13
4307,193,8870,1019128,1019321,15
5016,52,8870,240601,240653,30
4020,90,8870,663352,663442,35
3551,47,8871,333343,333390,12
6982,153,8871,1125923,1126076,12
8751,258,8871,1292505,1292763,18
5050,54,8871,663434,663488,19
1152,42,8871,240672,240714,32
4466,97,8871,904148,904245,39
9402,105,8872,1126016,1126121,4
7538,37,8873,333409,333446,25
5608,204,8873,904097,904301,30
7179,268,8874,1470375,1470643,5
5434,243,8874,1292553,1292796,10
1336,199,8874,1019222,1019421,36
3064,190,8874,904198,904388,40
1333,11,8874,161010,161021,43
6370,122,8875,1218946,1219068,5
6257,81,8876,1019365,1019446,1
2085,41,8876,333495,333536,12
8873,91,8876,240752,240843,17
4072,29,8876,240826,240855,34
7108,160,8876,1126045,1126205,38
9796,144,8876,904311,904455,44
3472,2,8877,16416,16418,2
5843,107,8877,436205,436312,41
1691,10,8877,95987,95997,46
4216,112,8877,784278,784390,50
3526,288,8878,1474548,1474836,5
7632,32,8878,240886,240918,15
5548,125,8878,1126123,1126248,19
2458,4,8878,16426,16430,26
3901,32,8878,95995,96027,31
7189,246,8878,1292612,1292858,34
2214,273,8878,1438093,1438366,39
9717,274,8878,1126050,1126324,41
9942,200,8879,1438194,1438394,1
8394,153,8879,1347813,1347966,5
2151,34,8879,333629,333663,16
4546,4,8879,47597,47601,34
9482,220,8879,1388772,1388992,48
3509,96,8879,784431,784527,49
8787,191,8880,1347821,1348012,11
8145,234,8880,1292756,1292990,16
9240,147,8880,1019516,1019663,16
5530,283,8880,1292767,1293050,35
1634,202,8881,1438220,1438422,2
4263,23,8881,161196,161219,12
5866,148,8881,436373,436521,17
1192,288,8881,1347773,1348061,18
9100,182,8881,1219129,1219311,25
5463,132,8881,546404,546536,31
7118,95,8881,333734,333829,41
7883,252,8881,1417872,1418124,48
9130,224,8882,1126323,1126547,15
2796,14,8882,161291,161305,24
2133,37,8882,241108,241145,46
2508,126,8882,784599,784725,47
2831,125,8883,1293003,1293128,5
1369,189,8883,1347919,1348108,8
3113,81,8883,546539,546620,15
9781,265,8883,1417915,1418180,19
9882,247,8883,1019622,1019869,21
3885,207,8883,1126431,1126638,29
8952,243,8883,1219192,1219435,50
5719,43,8884,333915,333958,9
2533,87,8884,663983,664070,20
5615,244,8884,1126465,1126709,40
2948,256,8884,1219217,1219473,42
8550,97,8884,904853,904950,43
2317,283,8885,1347877,1348160,18
5122,28,8885,241260,241288,20
2682,276,8885,1388818,1389094,28
3732,87,8886,1019960,1020047,1
3514,214,8886,1126610,1126824,18
6679,28,8886,334037,334065,33
4760,46,8886,546775,546821,43
2466,53,8887,436782,436835,22
4000,38,8887,334061,334099,24
5231,177,8887,1126691,1126868,28
7440,19,8887,47734,47753,31
2495,30,8887,241334,241364,34
1983,273,8887,1438191,1438464,39
6480,31,8887,241356,241387,42
7610,175,8887,1219415,1219590,43
5845,4,8887,47762,47766,46
1925,166,8888,1388978,1389144,1
4996,102,8888,664172,664274,20
6799,220,8888,1126754,1126974,20
4009,79,8888,546835,546914,34
5402,271,8888,1438238,1438509,39
2224,33,8888,334150,334183,45
2048,41,8889,546890,546931,4
7312,103,8889,784984,785087,16
9037,154,8889,1126871,1127025,25
6475,187,8890,1126865,1127052,29
5973,245,8891,1293048,1293293,13
7761,246,8891,1348048,1348294,24
5047,189,8891,905063,905252,40
8461,95,8891,785128,785223,50
5273,273,8892,1219423,1219696,31
4397,136,8892,664345,664481,36
3518,2,8892,16564,16566,38
4640,182,8893,1293164,1293346,12
5177,207,8893,1020149,1020356,15
1960,91,8893,547043,547134,42
2839,244,8894,1348092,1348336,22
6316,60,8894,547103,547163,22
6980,261,8894,1388933,1389194,22
9755,200,8894,1020248,1020448,23
7806,140,8895,1348243,1348383,2
3921,209,8895,1438326,1438535,4
1754,21,8895,161652,161673,23
1907,126,8895,785266,785392,37
8551,297,8896,1474561,1474858,6
1392,287,8896,1438292,1438579,16
3967,274,8896,1348219,1348493,25
5139,4,8896,47863,47867,48
4636,285,8896,1389014,1389299,49
4555,286,8896,1293305,1293591,50
7997,18,8896,161703,161721,50
4387,165,8897,664545,664710,21
6875,161,8897,785354,785515,36
9142,243,8897,1293383,1293626,47
2112,252,8898,1463561,1463813,2
9642,161,8898,1389177,1389338,2
9006,59,8898,241657,241716,30
3246,241,8898,1389129,1389370,43
9156,155,8899,1348456,1348611,4
5876,129,8899,1020543,1020672,9
1075,88,8899,664729,664817,11
9136,300,8899,1463551,1463851,12
8682,28,8899,241741,241769,16
9845,79,8899,664779,664858,22
1327,286,8899,1389158,1389444,24
9514,43,8899,437336,437379,33
8026,187,8899,1219911,1220098,38
3647,87,8899,905569,905656,39
2154,129,8900,1127355,1127484,39
2301,104,8900,664833,664937,47
2450,283,8901,1474597,1474880,5
8356,281,8901,1127258,1127539,41
5528,131,8901,1127436,1127567,43
3919,103,8901,1020712,1020815,48
2955,208,8901,1127416,1127624,50
8594,30,8902,241846,241876,13
1712,108,8902,1020766,1020874,19
7240,6,8902,47961,47967,20
5042,47,8902,161864,161911,21
3716,186,8902,1219969,1220155,24
8369,20,8902,161904,161924,25
7842,292,8902,1389218,1389510,28
5005,87,8902,437452,437539,32
1350,259,8902,1293572,1293831,47
4804,16,8903,161938,161954,13
1591,125,8903,437455,437580,17
6802,25,8903,161964,161989,20
2790,22,8903,241932,241954,22
8028,124,8904,1293721,1293845,5
9180,259,8904,1438406,1438665,12
9747,297,8904,1418077,1418374,24
5360,96,8904,905818,905914,43
9501,257,8905,1470443,1470700,6
6971,213,8905,1418196,1418409,8
2247,283,8905,1463626,1463909,12
6766,14,8905,96646,96660,13
6881,42,8905,241982,242024,18
1452,37,8905,242007,242044,34
6686,18,8905,162051,162069,39
6811,88,8906,1020946,1021034,5
2122,126,8906,1020932,1021058,22
7141,123,8906,665077,665200,32
3624,265,8906,1293709,1293974,35
3488,242,8906,1220115,1220357,36
9853,173,8906,1220232,1220405,43
9233,254,8906,1220209,1220463,44
9413,231,8906,1348594,1348825,49
3493,186,8906,1127753,1127939,50
5738,209,8907,1389418,1389627,12
7578,253,8907,1348643,1348896,24
9971,48,8907,547780,547828,39
9052,1,8908,16694,16695,1
1927,122,8908,547740,547862,10
2562,228,8908,1418225,1418453,11
3458,127,8908,786012,786139,23
3287,39,8908,242159,242198,34
3198,138,8908,906071,906209,45
6701,156,8908,1021128,1021284,46
4670,219,8909,1418257,1418476,9
2716,79,8909,665355,665434,22
4552,291,8909,1418235,1418526,43
1346,169,8909,1293957,1294126,48
6585,201,8910,1438525,1438726,2
2390,213,8910,1293955,1294168,16
1251,184,8910,665333,665517,17
6384,18,8910,162246,162264,23
3273,72,8910,665465,665537,24
8741,179,8910,1021232,1021411,29
3793,91,8910,665489,665580,35
3829,212,8910,1127917,1128129,45
8660,113,8911,1220545,1220658,1
8546,222,8911,1389512,1389734,14
9964,5,8911,48149,48154,15
7491,124,8911,1128063,1128187,48
5387,244,8912,1438502,1438746,12
1704,183,8912,906263,906446,31
4390,232,8913,1128007,1128239,15
9994,180,8913,1021398,1021578,35
5265,202,8913,1021412,1021614,36
2053,31,8914,242357,242388,11
9495,117,8914,1128145,1128262,19
4203,285,8914,1293971,1294256,20
4527,65,8915,786436,786501,3
1525,165,8915,1389607,1389772,6
6074,39,8915,335186,335225,13
4086,18,8915,48202,48220,17
4034,216,8915,1128118,1128334,26
8154,126,8915,548149,548275,41
4275,30,8915,438157,438187,43
4718,220,8915,1294095,1294315,49
1938,97,8916,1128273,1128370,6
8758,143,8916,1128250,1128393,9
9515,215,8916,1389577,1389792,14
6272,52,8916,162402,162454,17
5775,108,8916,906571,906679,25
6842,155,8916,786481,786636,40
3902,127,8916,665803,665930,42
8775,218,8916,1348852,1349070,43
9380,109,8916,786570,786679,46
8114,83,8916,786625,786708,48
9970,249,8916,1220605,1220854,50
1948,203,8917,1128297,1128500,18
8383,296,8917,1418295,1418591,22
4487,92,8917,665949,666041,27
3139,87,8917,665993,666080,33
3984,246,8917,1294188,1294434,34
3764,205,8917,1128391,1128596,45
4807,195,8918,1438569,1438764,1
5210,14,8918,97005,97019,11
1540,156,8918,666004,666160,21
6119,1,8918,16795,16796,23
1493,82,8918,548470,548552,37
3838,39,8919,162544,162583,21
8260,27,8919,48316,48343,31
3664,108,8919,1021827,1021935,43
6113,163,8919,1294305,1294468,48
7624,248,8920,1463680,1463928,6
8382,34,8920,438431,438465,6
1260,239,8920,1294304,1294543,25
9556,284,8920,1389607,1389891,25
9412,252,8920,1021815,1022067,30
5295,45,8920,242654,242699,40
5906,21,8920,97081,97102,40
1936,55,8921,666205,666260,6
3044,44,8921,335512,335556,15
3693,217,8921,1128528,1128745,20
4975,64,8921,335531,335595,32
2676,101,8921,335538,335639,41
1555,93,8921,906894,906987,48
4498,242,8921,1418412,1418654,48
8689,195,8922,1349029,1349224,19
3422,44,8922,438518,438562,33
7970,284,8923,1474602,1474886,5
5970,192,8923,1349086,1349278,19
2568,47,8923,438544,438591,25
8945,257,8923,1220862,1221119,42
3278,113,8923,906977,907090,49
4074,79,8924,907031,907110,5
3521,51,8924,242781,242832,30
6163,85,8924,335664,335749,41
9938,194,8925,1438621,1438815,5
8459,264,8925,1470467,1470731,6
9648,128,8925,666312,666440,13
5930,167,8925,1128742,1128909,22
8691,162,8925,1128790,1128952,25
5910,257,8925,1349101,1349358,28
1633,184,8925,787000,787184,30
7230,239,8925,1418505,1418744,39
9992,23,8925,162800,162823,46
9593,221,8925,1221007,1221228,47
4766,220,8926,1453195,1453415,4
2577,111,8926,438656,438767,41
7779,31,8926,242936,242967,42
4204,44,8927,162832,162876,10
6080,89,8927,907165,907254,43
3945,34,8928,162857,162891,10
7168,15,8928,48501,48516,21
6209,62,8928,666509,666571,38
9427,55,8929,666529,666584,4
1353,254,8929,1349154,1349408,10
2381,279,8929,1294531,1294810,20
4623,8,8929,97303,97311,22
6632,198,8929,907142,907340,40
8940,84,8929,438784,438868,40
9541,77,8930,907282,907359,3
5054,269,8930,1470492,1470761,5
1999,57,8930,666643,666700,48
3138,288,8931,1474622,1474910,5
7314,193,8931,1221158,1221351,49
6342,298,8932,1474653,1474951,5
4242,221,8932,1418614,1418835,9
4438,228,8932,1128948,1129176,15
7576,218,8932,1022289,1022507,15
6102,253,8932,1221185,1221438,20
2049,9,8932,97365,97374,22
9334,233,8932,1418636,1418869,39
5379,88,8932,666768,666856,45
9846,79,8933,549034,549113,7
8582,253,8933,1022340,1022593,21
2805,181,8933,1022444,1022625,23
2004,228,8933,1022434,1022662,30
7770,150,8934,1221321,1221471,9
2258,139,8934,1022571,1022710,22
9251,216,8934,1129068,1129284,35
1047,258,8935,1349255,1349513,13
5216,135,8935,1022664,1022799,22
7497,8,8935,97432,97440,34
1206,158,8936,1221350,1221508,9
2812,2,8936,16953,16955,14
9134,277,8936,1294674,1294951,35
8840,235,8936,1129150,1129385,42
1965,266,8936,1349278,1349544,47
7995,164,8936,1022758,1022922,47
5886,112,8937,907719,907831,9
1202,222,8937,1389888,1390110,14
1504,25,8937,97461,97486,40
4840,173,8937,1022812,1022985,47
5057,172,8937,1022864,1023036,50
3248,114,8938,907817,907931,22
4506,76,8938,549356,549432,23
6051,130,8938,1022937,1023067,24
7183,36,8940,439269,439305,14
4079,208,8940,907790,907998,30
8752,89,8940,907928,908017,39
4795,279,8940,1294762,1295041,44
6428,175,8941,1294889,1295064,11
6611,139,8941,1022987,1023126,12
1900,283,8941,1349308,1349591,29
9736,29,8941,163188,163217,37
4054,214,8941,1389921,1390135,48
9014,196,8942,1438721,1438917,2
3095,149,8942,1129407,1129556,11
9210,32,8942,243378,243410,42
2915,104,8942,787914,788018,46
7766,284,8942,1389922,1390206,49
8086,15,8943,97568,97583,4
4337,243,8943,1438699,1438942,11
2646,274,8943,1418653,1418927,43
6107,52,8943,336397,336449,44
2140,127,8943,908084,908211,45
3024,222,8943,1221555,1221777,45
6515,132,8943,908142,908274,46
7598,247,8943,1294995,1295242,46
8814,196,8943,1349539,1349735,48
5271,250,8944,1438728,1438978,8
1151,297,8944,1295013,1295310,31
7808,283,8944,1295087,1295370,35
9783,168,8944,1221764,1221932,38
4400,17,8944,48748,48765,41
1596,130,8944,788127,788257,42
5666,240,8944,1418733,1418973,48
7878,280,8944,1295170,1295450,50
5625,54,8945,439560,439614,12
5758,198,8945,1349593,1349791,14
1404,200,8945,1129696,1129896,20
5249,222,8945,1295286,1295508,25
8842,121,8946,1295402,1295523,1
5258,259,8946,1349553,1349812,10
6427,133,8946,1023437,1023570,14
6171,247,8946,1221873,1222120,37
6514,3,8946,17042,17045,45
6742,198,8947,1349645,1349843,11
3150,295,8947,1295304,1295599,42
4372,48,8948,667706,667754,5
2572,137,8948,1129898,1130035,8
6142,263,8948,1349635,1349898,28
7162,294,8949,1463752,1464046,8
6872,59,8949,439738,439797,9
7055,17,8949,163461,163478,25
8134,89,8949,336684,336773,31
4977,231,8949,1129895,1130126,33
6513,246,8949,1222013,1222259,45
8387,249,8950,1463835,1464084,1
2512,242,8950,1463869,1464111,4
1215,40,8950,243706,243746,8
4962,96,8950,667785,667881,20
7985,249,8950,1023560,1023809,41
4979,163,8950,1130055,1130218,49
3676,287,8951,1463858,1464145,9
5582,66,8951,163524,163590,17
6135,143,8951,439796,439939,17
4360,293,8951,1130004,1130297,30
1646,263,8951,1295478,1295741,46
3966,99,8952,1130247,1130346,1
8348,33,8952,336889,336922,22
4782,285,8952,1130108,1130393,41
9304,109,8953,1222235,1222344,5
1500,240,8953,1418832,1419072,12
7722,72,8953,550094,550166,28
3557,63,8953,336921,336984,30
6935,164,8953,908781,908945,33
4240,223,8953,1222165,1222388,35
7971,118,8953,1130346,1130464,39
5549,102,8953,668020,668122,47
6106,46,8954,668084,668130,2
2269,214,8954,1390189,1390403,11
9761,230,8954,1295583,1295813,16
6882,238,8954,1130290,1130528,31
6181,14,8954,163734,163748,42
1782,32,8954,337048,337080,45
2146,249,8954,1222237,1222486,45
5365,121,8955,1295707,1295828,1
4391,140,8955,1130452,1130592,9
2865,89,8955,668156,668245,20
3495,51,8955,440141,440192,22
7394,29,8955,244005,244034,22
4095,51,8955,337095,337146,27
6314,256,8955,1130393,1130649,32
3712,24,8955,337147,337171,43
1956,32,8956,97957,97989,10
3737,72,8956,440159,440231,18
5785,50,8957,668230,668280,1
8004,157,8957,1390261,1390418,5
3430,172,8957,1130522,1130694,16
7053,191,8957,908988,909179,30
6375,242,8957,1222318,1222560,35
7354,116,8958,788923,789039,12
6133,254,8958,1438811,1439065,14
4737,208,8958,1130588,1130796,37
3115,149,8958,1024136,1024285,46
2665,41,8958,440307,440348,50
1187,205,8959,1438892,1439097,2
2662,131,8959,1295761,1295892,5
1039,112,8959,668355,668467,37
8624,296,8959,1418852,1419148,38
6832,113,8959,789059,789172,50
1015,185,8960,1024192,1024377,37
3749,46,8960,244172,244218,44
8033,85,8961,1024305,1024390,4
9752,91,8961,440351,440442,30
3561,134,8961,909233,909367,50
9124,90,8962,668477,668567,45
2961,255,8963,1453293,1453548,7
1811,253,8963,1438890,1439143,12
3794,21,8963,244253,244274,19
4675,251,8963,1349891,1350142,24
5021,19,8963,98116,98135,26
8968,256,8963,1024241,1024497,30
1074,100,8963,550555,550655,42
1388,158,8964,1222541,1222699,11
5711,240,8964,1418968,1419208,14
2062,160,8964,1130808,1130968,25
3036,174,8964,1130821,1130995,34
7057,1,8964,17212,17213,46
3357,229,8964,1349956,1350185,49
3929,151,8965,1350064,1350215,1
8406,47,8965,550693,550740,6
5511,48,8965,337466,337514,12
4972,231,8965,1130848,1131079,23
8298,135,8965,909465,909600,29
2602,55,8965,550739,550794,33
5255,32,8965,244372,244404,46
2821,92,8966,1024569,1024661,3
4373,78,8966,909553,909631,3
4971,70,8966,440604,440674,15
2150,274,8966,1024452,1024726,21
1371,204,8966,1222594,1222798,28
7239,223,8966,1222627,1222850,46
1490,166,8967,1024647,1024813,50
2467,34,8968,440707,440741,3
7827,15,8968,164125,164140,16
4614,179,8968,1024679,1024858,37
6792,66,8969,337591,337657,10
2913,161,8969,1222710,1222871,11
1282,156,8969,909628,909784,18
9168,30,8970,98259,98289,7
4751,47,8970,440749,440796,16
5395,28,8970,244508,244536,22
3895,2,8970,17251,17253,39
5234,3,8970,49213,49216,43
4140,144,8970,909672,909816,47
1857,218,8971,1419013,1419231,7
9806,154,8971,550815,550969,17
3596,174,8971,1222736,1222910,22
5917,76,8971,440803,440879,32
1305,218,8971,1295875,1296093,38
6057,192,8971,1131059,1131251,46
4456,223,8971,1222756,1222979,47
1530,160,8972,909773,909933,15
4604,243,8972,1024754,1024997,21
6453,203,8972,1222808,1223011,34
4318,250,8972,1222796,1223046,36
7344,18,8972,164301,164319,47
2005,39,8973,244651,244690,8
3016,288,8973,1463871,1464159,8
9023,65,8973,440956,441021,11
4776,34,8973,244696,244730,13
2626,65,8973,440977,441042,42
1855,152,8973,1024933,1025085,50
4453,295,8974,1474654,1474949,3
2093,174,8974,1419108,1419282,5
1821,80,8974,551080,551160,23
7506,295,8974,1419022,1419317,24
9165,280,8974,1295942,1296222,45
6242,150,8975,441004,441154,17
8203,244,8975,1024949,1025193,21
7564,48,8975,441147,441195,24
4050,128,8975,910055,910183,28
2013,11,8975,17308,17319,31
6176,214,8975,1025010,1025224,31
4417,210,8975,1222976,1223186,46
5574,231,8975,1350099,1350330,49
5667,149,8975,910154,910303,50
1572,39,8976,338047,338086,24
4036,157,8976,789885,790042,30
2849,235,8976,1025091,1025326,40
8327,171,8976,1131321,1131492,46
2521,113,8976,1025263,1025376,48
6900,157,8977,1390476,1390633,2
6035,68,8977,338101,338169,8
5091,283,8977,1390380,1390663,10
3689,277,8977,1223022,1223299,23
3825,292,8977,1296053,1296345,45
6036,55,8978,669368,669423,6
7045,289,8978,1296122,1296411,45
7508,288,8979,1463913,1464201,12
2943,125,8979,1025405,1025530,25
6765,119,8979,790144,790263,29
9471,166,8979,790142,790308,40
3239,123,8980,1223283,1223406,6
1934,121,8980,669424,669545,40
3787,61,8980,551481,551542,49
5196,85,8980,669486,669571,49
2139,232,8981,1453396,1453628,6
3376,165,8981,1131526,1131691,14
4427,247,8981,1223220,1223467,18
2981,93,8981,669545,669638,23
8606,283,8981,1223254,1223537,33
6768,203,8981,1296263,1296466,49
3930,90,8982,551577,551667,13
4486,183,8982,1025500,1025683,18
8845,161,8982,910525,910686,23
7025,282,8982,1419104,1419386,43
9076,96,8983,669668,669764,11
9253,132,8983,1025598,1025730,22
8005,197,8983,1131635,1131832,37
1391,125,8983,910645,910770,45
2734,155,8984,1223447,1223602,11
3677,277,8984,1419141,1419418,16
5013,177,8984,1025637,1025814,18
2248,211,8984,1296338,1296549,25
9056,27,8984,98672,98699,30
1386,151,8984,1223539,1223690,39
3789,299,8985,1463934,1464233,12
2518,1,8985,17408,17409,28
8876,269,8986,1350209,1350478,10
8633,234,8986,1350300,1350534,43
8069,70,8987,164735,164805,17
2380,37,8987,98716,98753,36
5673,170,8987,1223615,1223785,43
3101,131,8988,1296498,1296629,1
3077,116,8988,1223706,1223822,2
6897,180,8988,1419276,1419456,5
2231,20,8988,98757,98777,11
8471,285,8988,1419191,1419476,13
2856,299,8988,1350317,1350616,29
8944,80,8988,790702,790782,43
4138,7,8988,49561,49568,46
2480,205,8988,1350453,1350658,48
6659,276,8989,1463977,1464253,9
1338,245,8989,1419282,1419527,14
6443,95,8989,551948,552043,15
5386,220,8989,1131958,1132178,45
6140,54,8990,552021,552075,14
6540,79,8990,670057,670136,16
7125,127,8990,551993,552120,31
8249,293,8990,1296491,1296784,42
3109,165,8991,1390678,1390843,5
9665,137,8991,1132095,1132232,11
3617,88,8991,790831,790919,22
2609,79,8992,338645,338724,31
5697,281,8992,1296556,1296837,36
7944,181,8993,1350539,1350720,8
7860,108,8993,670150,670258,23
4728,151,8993,911044,911195,35
6584,298,8993,1350461,1350759,50
4460,75,8995,911164,911239,5
6724,63,8995,338742,338805,10
2361,29,8995,338787,338816,14
2322,158,8995,790882,791040,36
1689,134,8996,1026083,1026217,11
9332,278,8996,1296645,1296923,36
5119,181,8996,1296773,1296954,43
3807,263,8996,1350522,1350785,47
3913,36,8997,245499,245535,28
9019,47,8997,442086,442133,29
7051,99,8997,442057,442156,31
4347,278,8997,1296757,1297035,35
1945,232,8997,1350606,1350838,43
4915,57,8997,442138,442195,47
8540,22,8998,165066,165088,15
4310,16,8998,165080,165096,19
2992,149,8998,911235,911384,44
3529,127,8998,911285,911412,46
4132,46,8999,338927,338973,12
3195,68,8999,552323,552391,20
6628,283,8999,1390607,1390890,22
5786,202,8999,911274,911476,30
3144,244,8999,1132266,1132510,33
7326,225,9000,1453457,1453682,3
9704,159,9000,1390766,1390925,6
3582,27,9000,245641,245668,16
1883,236,9000,1296916,1297152,27
7247,106,9000,791216,791322,27
4740,84,9000,670509,670593,29
4224,144,9001,1026327,1026471,14
5493,230,9001,1419322,1419552,14
8425,207,9001,1224092,1224299,27
9805,182,9002,1419396,1419578,3
7903,162,9002,1390816,1390978,4
3218,127,9002,1026435,1026562,8
3184,40,9002,245716,245756,11
1604,233,9002,1419367,1419600,14
2485,234,9002,1350759,1350993,22
3798,125,9002,670599,670724,40
3650,111,9002,911585,911696,49
3423,126,9003,1026504,1026630,14
8128,235,9003,1350801,1351036,38
6976,247,9004,1439022,1439269,8
3313,129,9004,791405,791534,20
2174,300,9004,1132482,1132782,21
7717,30,9004,339195,339225,39
3482,73,9005,552621,552694,12
5087,151,9005,791458,791609,15
1299,134,9005,442429,442563,17
2672,160,9005,1026574,1026734,27
2617,145,9005,911685,911830,34
2881,290,9005,1419365,1419655,38
7964,164,9005,1224305,1224469,43
8693,183,9005,1297163,1297346,48
5010,187,9006,1297195,1297382,43
5202,83,9007,1026738,1026821,1
8655,140,9007,791608,791748,13
7759,126,9007,1026720,1026846,14
6416,66,9007,339312,339378,18
4271,277,9008,1470513,1470790,4
5801,247,9008,1439071,1439318,9
7834,235,9008,1132693,1132928,32
1134,293,9008,1297169,1297462,36
5002,192,9008,1132794,1132986,37
4611,268,9008,1439093,1439361,39
1564,290,9009,1132759,1133049,21
3147,29,9009,339448,339477,24
4122,227,9009,1297285,1297512,34
1314,236,9009,1132885,1133121,42
6069,159,9010,791796,791955,31
5987,43,9010,165470,165513,36
2379,73,9011,912050,912123,2
7881,195,9011,1439185,1439380,3
2400,97,9011,1133051,1133148,5
8673,121,9011,552923,553044,10
2541,60,9011,442815,442875,28
5690,72,9011,671130,671202,38
5133,118,9012,671122,671240,13
6403,119,9012,1133046,1133165,39
9362,278,9013,1470550,1470828,6
1933,160,9013,912037,912197,13
6687,112,9013,791956,792068,16
4822,96,9013,671237,671333,20
6839,129,9013,553048,553177,21
9680,20,9013,165587,165607,25
7526,81,9013,671272,671353,29
8225,281,9013,1419495,1419776,38
2126,142,9013,912100,912242,44
8248,249,9014,1439167,1439416,14
6631,274,9014,1390940,1391214,22
1463,52,9014,443003,443055,29
6973,65,9014,443013,443078,34
4647,65,9015,792084,792149,3
8285,215,9015,1297421,1297636,16
6237,162,9015,1297500,1297662,39
7018,229,9016,1419580,1419809,14
2643,125,9016,671385,671510,15
8900,49,9016,165651,165700,31
4749,252,9016,1391009,1391261,38
7541,72,9017,443096,443168,9
1930,221,9017,1133142,1133363,10
6987,136,9017,792117,792253,13
4601,84,9017,553311,553395,15
8137,150,9017,671469,671619,21
2745,216,9017,1133207,1133423,45
8122,54,9017,671596,671650,48
4200,55,9018,553403,553458,24
1815,111,9018,912296,912407,28
8974,47,9018,165745,165792,30
5481,212,9019,1391080,1391292,8
5965,99,9019,671603,671702,11
3037,285,9019,1439186,1439471,39
7194,207,9019,912253,912460,41
8414,94,9020,792274,792368,22
7161,24,9020,246415,246439,25
1315,15,9020,165835,165850,39
2829,128,9020,792272,792400,44
8389,181,9020,1027163,1027344,44
1792,56,9021,671746,671802,3
1717,235,9021,1297555,1297790,25
8079,233,9021,1133293,1133526,26
2564,158,9021,1027257,1027415,47
9045,73,9022,912490,912563,1
8062,212,9022,1453508,1453720,3
9499,222,9022,1224676,1224898,27
5298,81,9022,553594,553675,34
8316,35,9022,246513,246548,46
6378,126,9022,912500,912626,50
5540,233,9023,1439273,1439506,9
5309,24,9023,340058,340082,43
9060,10,9023,165942,165952,43
5304,206,9023,1224740,1224946,46
1416,236,9023,1391160,1391396,48
4954,44,9023,443490,443534,50
7668,73,9024,912612,912685,4
5835,39,9024,340096,340135,24
6460,215,9024,912528,912743,30
2550,22,9024,246609,246631,33
2403,31,9024,165974,166005,37
4931,155,9024,1027381,1027536,50
5981,142,9024,912680,912822,50
1424,282,9025,1474645,1474927,1
9569,55,9025,671961,672016,4
8111,171,9025,1351215,1351386,7
9912,290,9025,1464012,1464302,14
8638,179,9025,1027430,1027609,18
6238,43,9025,166021,166064,30
4392,271,9025,1297659,1297930,35
7957,48,9025,553814,553862,48
9913,162,9025,1133576,1133738,49
7917,26,9026,340219,340245,4
6664,72,9026,672050,672122,14
5751,271,9026,1133499,1133770,41
9437,238,9027,1464090,1464328,1
8549,253,9027,1464116,1464369,3
1110,149,9027,1133672,1133821,22
1423,205,9027,1133662,1133867,29
8929,282,9027,1133641,1133923,30
8718,285,9028,1464116,1464401,8
9065,134,9028,912968,913102,16
9183,47,9028,553957,554004,19
8562,3,9028,50229,50232,24
2478,175,9028,912955,913130,40
3527,245,9028,1297765,1298010,47
8678,108,9028,672221,672329,47
4834,110,9029,1225005,1225115,6
4051,223,9029,1391297,1391520,19
7551,246,9030,1439381,1439627,8
6661,131,9030,792890,793021,15
8831,29,9031,99783,99812,7
2535,247,9031,1297829,1298076,29
8595,174,9032,1419810,1419984,1
3050,98,9032,792974,793072,7
7186,176,9032,1133903,1134079,16
4233,296,9032,1297826,1298122,31
7562,91,9033,672392,672483,29
9640,113,9033,672401,672514,37
1753,207,9033,1351336,1351543,48
9034,214,9034,1133928,1134142,10
8207,130,9034,1027877,1028007,14
6601,128,9034,913215,913343,28
6672,247,9034,1351335,1351582,28
1012,264,9034,1297945,1298209,45
1033,251,9035,1351360,1351611,34
3388,126,9035,1134117,1134243,48
5285,151,9036,913306,913457,23
7297,98,9036,672606,672704,34
9208,135,9037,672610,672745,32
4929,285,9038,1474661,1474946,1
3394,22,9038,247019,247041,4
7952,19,9038,247028,247047,19
6042,97,9038,672685,672782,27
8805,67,9038,444065,444132,37
3090,152,9038,1134142,1134294,38
7080,197,9038,1298083,1298280,38
8971,170,9038,1028004,1028174,44
5335,213,9038,1134163,1134376,45
2339,16,9039,99951,99967,4
9801,45,9039,340664,340709,12
1276,244,9039,1225167,1225411,37
9681,26,9039,247105,247131,42
4596,182,9040,1419836,1420018,4
8342,39,9040,554431,554470,5
6164,187,9040,672747,672934,10
2649,213,9040,1391395,1391608,11
9951,169,9040,1134309,1134478,25
9722,117,9040,913519,913636,28
9050,216,9040,1134314,1134530,35
1520,198,9040,1351491,1351689,48
2487,203,9041,1391429,1391632,9
3071,107,9041,793387,793494,12
5168,127,9041,444212,444339,17
2431,21,9041,100045,100066,27
6523,269,9041,1351470,1351739,47
3920,142,9042,1134456,1134598,12
8851,1,9042,17868,17869,14
2778,132,9042,444268,444400,17
7431,83,9042,340837,340920,21
3962,284,9043,1391402,1391686,24
2885,280,9043,1391466,1391746,38
4210,288,9043,1453563,1453851,39
2852,17,9043,247302,247319,48
8777,133,9044,1298334,1298467,6
9583,20,9044,100111,100131,8
1433,197,9044,1351651,1351848,11
7338,71,9044,793546,793617,19
7784,135,9044,913690,913825,34
4343,74,9044,793579,793653,39
9686,53,9045,673127,673180,2
6235,26,9045,166604,166630,27
6431,197,9045,1134526,1134723,29
9148,152,9046,1225460,1225612,8
9436,168,9046,1134597,1134765,16
5526,210,9046,1225440,1225650,27
2376,139,9046,673148,673287,32
1084,281,9046,1298261,1298542,37
5563,57,9046,247385,247442,41
9001,254,9047,1464191,1464445,3
1363,281,9047,1464193,1464474,8
7304,31,9047,100210,100241,10
2976,162,9047,913807,913969,18
3565,93,9047,673269,673362,23
8556,13,9047,166726,166739,33
2594,53,9048,341083,341136,34
5883,118,9048,1028489,1028607,43
9530,178,9048,1028468,1028646,44
8235,103,9048,793739,793842,49
7795,246,9048,1225524,1225770,50
8322,288,9049,1474680,1474968,3
2076,273,9049,1351680,1351953,25
7117,295,9049,1391574,1391869,28
1258,140,9049,673358,673498,30
7980,185,9050,1225688,1225873,49
7005,123,9050,914011,914134,50
5183,202,9051,1351813,1352015,12
5491,150,9051,793859,794009,18
4145,86,9051,914087,914173,19
7121,8,9051,100320,100328,23
9644,279,9051,1351804,1352083,25
5179,213,9051,1298508,1298721,28
6206,87,9051,673548,673635,33
3578,295,9051,1225705,1226000,40
4818,247,9051,1351882,1352129,49
6373,105,9052,1134998,1135103,6
9415,206,9052,1391688,1391894,8
2620,295,9052,1419821,1420116,13
8747,159,9052,914193,914352,20
5400,39,9052,166881,166920,40
1751,5,9052,50618,50623,45
8748,121,9053,1225957,1226078,5
3165,298,9053,1474707,1475005,6
4258,152,9053,794079,794231,13
3818,202,9053,1298615,1298817,49
5239,89,9054,1028880,1028969,5
9811,101,9054,444867,444968,10
6077,94,9054,914332,914426,48
4148,12,9055,100410,100422,20
3586,285,9055,1225900,1226185,23
1987,269,9055,1225955,1226224,32
8220,33,9055,341427,341460,38
6365,182,9055,914351,914533,42
9658,19,9056,100434,100453,18
3310,169,9056,673757,673926,21
7715,216,9056,1028871,1029087,42
8281,13,9056,167002,167015,48
5489,250,9057,1351970,1352220,49
8890,88,9058,555267,555355,9
5033,210,9058,1028946,1029156,13
4961,243,9058,1028947,1029190,21
3439,86,9058,555345,555431,34
6910,155,9058,1029065,1029220,34
8668,59,9059,247828,247887,10
3407,155,9059,1298701,1298856,39
1736,201,9060,1226101,1226302,16
1231,210,9061,1439546,1439756,4
6398,277,9061,1453656,1453933,19
7961,236,9061,1298691,1298927,27
4048,122,9061,445132,445254,41
9898,139,9061,794424,794563,42
6641,278,9061,1419933,1420211,43
3187,71,9061,445231,445302,44
7574,170,9062,914626,914796,23
7085,123,9062,914707,914830,49
6530,219,9063,1420021,1420240,7
9496,202,9063,1352131,1352333,12
1032,208,9063,1226242,1226450,27
1266,178,9064,1420085,1420263,2
5704,143,9064,555509,555652,10
7282,233,9064,1420064,1420297,11
6323,62,9064,445359,445421,15
7364,272,9064,1420054,1420326,16
2030,72,9064,248025,248097,41
9462,268,9064,1298815,1299083,45
2788,212,9065,1453738,1453950,2
3717,107,9065,1029383,1029490,19
4918,289,9065,1226311,1226600,40
2965,214,9066,1029359,1029573,13
5908,171,9066,1298960,1299131,39
2055,271,9067,1464251,1464522,7
1183,155,9067,1029484,1029639,16
6972,193,9067,1029490,1029683,23
7135,62,9067,445499,445561,23
3572,69,9067,674336,674405,50
9616,138,9068,1352286,1352424,3
9336,69,9068,341881,341950,26
6619,156,9068,1135460,1135616,28
1421,132,9068,674334,674466,32
2027,177,9068,1029583,1029760,47
1544,202,9069,1352245,1352447,14
4288,62,9069,445591,445653,27
3579,173,9069,1299037,1299210,39
6605,269,9070,1352209,1352478,10
5543,17,9070,167359,167376,29
2625,193,9070,915034,915227,31
6771,298,9071,1420085,1420383,10
7500,172,9071,915106,915278,15
8347,65,9071,555960,556025,45
8629,153,9071,915167,915320,47
1784,225,9072,1391911,1392136,14
9126,194,9072,1226552,1226746,16
2875,165,9072,1029726,1029891,20
6850,134,9072,1029780,1029914,28
9421,298,9072,1391896,1392194,28
2470,230,9072,1029752,1029982,31
7208,91,9072,674689,674780,34
7607,223,9072,1226578,1226801,35
3999,51,9072,167461,167512,41
4609,51,9072,342151,342202,44
9598,62,9072,556122,556184,45
8796,246,9074,1464305,1464551,1
2707,11,9074,100841,100852,14
7899,118,9074,1029921,1030039,24
3389,128,9074,915405,915533,28
8273,245,9074,1135583,1135828,31
7563,70,9074,795185,795255,39
3120,136,9074,674770,674906,40
7703,198,9074,915410,915608,40
4645,20,9074,248477,248497,45
5218,276,9075,1474730,1475006,1
8410,208,9075,1392047,1392255,9
5723,56,9075,342283,342339,15
2392,26,9075,167598,167624,34
3451,242,9076,1464360,1464602,1
9192,98,9076,1135787,1135885,1
2580,83,9076,1030041,1030124,6
7404,290,9076,1453762,1454052,19
3240,82,9076,556287,556369,34
6763,1,9076,18133,18134,50
1778,33,9077,446013,446046,4
6522,26,9077,342363,342389,5
4535,108,9077,915583,915691,7
9397,262,9077,1299133,1299395,20
3648,52,9077,167649,167701,21
5561,274,9078,1470640,1470914,3
6451,203,9078,1030016,1030219,13
9939,234,9078,1226727,1226961,29
2611,90,9079,1030178,1030268,2
4171,49,9080,446073,446122,16
2389,73,9080,248581,248654,41
8852,253,9080,1299200,1299453,47
9596,160,9080,1030170,1030330,50
9420,256,9081,1392086,1392342,16
3008,133,9081,675024,675157,30
6551,101,9081,915783,915884,38
9466,111,9081,446105,446216,41
6426,298,9082,1474744,1475042,3
6111,206,9082,1135852,1136058,18
5088,25,9082,248725,248750,24
2468,279,9082,1226784,1227063,40
4846,10,9083,101045,101055,28
9352,249,9083,1226847,1227096,36
6560,146,9083,915851,915997,37
2427,73,9083,556539,556612,46
7954,252,9084,1464425,1464677,2
6412,229,9084,1226921,1227150,45
2736,120,9085,1227055,1227175,5
8505,243,9085,1464463,1464706,5
9676,277,9085,1470695,1470972,5
5452,250,9085,1227010,1227260,20
4743,202,9085,1030393,1030595,23
2460,249,9085,1030404,1030653,30
7974,113,9085,1030568,1030681,43
7982,91,9085,556655,556746,44
8017,159,9086,1136104,1136263,25
6300,185,9086,1136119,1136304,27
5783,133,9086,1136203,1136336,39
4385,73,9086,795769,795842,48
7176,126,9087,675345,675471,30
4533,76,9087,248868,248944,41
8109,49,9088,675434,675483,1
8707,70,9088,556767,556837,16
7544,228,9088,1227085,1227313,27
3277,104,9088,675450,675554,33
9375,139,9088,916128,916267,35
6808,30,9089,446488,446518,2
3729,30,9089,101180,101210,10
4141,81,9089,446466,446547,18
2924,217,9089,1299351,1299568,25
7395,72,9089,556839,556911,28
9608,239,9089,1227150,1227389,35
4298,145,9090,1136297,1136442,8
7100,109,9090,675529,675638,18
1357,202,9090,1227232,1227434,28
1474,200,9090,1299417,1299617,43
7374,50,9091,675630,675680,1
5167,204,9091,1439780,1439984,5
1148,108,9091,795884,795992,27
2586,172,9091,916222,916394,32
5900,99,9091,675679,675778,33
7396,104,9091,1030790,1030894,39
3293,144,9091,916314,916458,45
6250,126,9092,1299520,1299646,4
5670,28,9092,342923,342951,5
2832,179,9092,1352560,1352739,9
1850,195,9092,1136366,1136561,29
4934,54,9092,342938,342992,44
7340,151,9093,1352616,1352767,3
6966,214,9093,1392228,1392442,12
3856,265,9093,1392214,1392479,24
6681,116,9093,1030894,1031010,38
6085,10,9093,51228,51238,41
5497,296,9093,1420313,1420609,43
2481,95,9093,916517,916612,48
4483,49,9093,446764,446813,49
7016,125,9094,557079,557204,10
5187,160,9094,1227436,1227596,12
7518,116,9094,1136549,1136665,19
6622,224,9094,1227403,1227627,35
4087,171,9094,1030956,1031127,45
7463,163,9095,1299598,1299761,8
8730,300,9095,1030887,1031187,17
6851,190,9096,1420450,1420640,5
4806,40,9096,168227,168267,40
8774,299,9096,1420399,1420698,43
6809,88,9097,796263,796351,25
2869,243,9097,1299601,1299844,27
6262,20,9097,249290,249310,33
4005,15,9097,249300,249315,43
6726,244,9097,1227518,1227762,45
2329,135,9098,1031159,1031294,11
6774,206,9098,1227605,1227811,28
9282,105,9098,557301,557406,32
9553,202,9099,1352708,1352910,14
8813,57,9099,168296,168353,17
6049,248,9099,1352719,1352967,38
8791,54,9100,676112,676166,4
4968,279,9100,1392313,1392592,28
8140,44,9100,447012,447056,29
3563,186,9100,916770,916956,42
3644,45,9100,343241,343286,46
1977,125,9101,1299799,1299924,4
9976,219,9101,916789,917008,21
2782,298,9101,1392345,1392643,25
2464,254,9102,1464497,1464751,5
6065,97,9102,796481,796578,28
1916,118,9102,1031325,1031443,38
8705,172,9102,916923,917095,42
5343,234,9103,1453951,1454185,6
4933,185,9103,916974,917159,15
2696,275,9103,1439772,1440047,19
4093,28,9103,249468,249496,20
2803,245,9103,1031260,1031505,21
8266,141,9103,917105,917246,46
9394,43,9103,343395,343438,49
9371,203,9103,1136825,1137028,50
3878,206,9104,1227802,1228008,16
4710,242,9104,1420550,1420792,19
9270,206,9104,1031412,1031618,26
8975,277,9104,1227791,1228068,31
2794,166,9104,917246,917412,33
6145,113,9104,796781,796894,50
1027,221,9105,1392544,1392765,12
8894,125,9106,796817,796942,23
1765,207,9106,1031512,1031719,33
8171,225,9106,1136919,1137144,42
6956,271,9107,1470718,1470989,2
5413,146,9107,796904,797050,15
7888,216,9107,1031599,1031815,15
4061,88,9107,676593,676681,20
3417,75,9107,447360,447435,26
9388,150,9107,917420,917570,33
7708,80,9107,447402,447482,42
7725,173,9107,1227968,1228141,43
9123,289,9108,1392551,1392840,24
6579,197,9108,917447,917644,30
4361,268,9108,1227932,1228200,31
8995,34,9108,101653,101687,31
5712,23,9108,343681,343704,43
3250,115,9109,1228104,1228219,6
5166,260,9109,1392611,1392871,24
1843,280,9109,1392623,1392903,34
9463,38,9109,343706,343744,35
9789,93,9109,557894,557987,37
7345,211,9109,1392727,1392938,39
5038,176,9109,917601,917777,42
5189,62,9110,343742,343804,8
2295,219,9110,1392759,1392978,19
1197,114,9110,917707,917821,22
9289,36,9110,168692,168728,26
9772,283,9111,1464518,1464801,7
4732,109,9111,676814,676923,23
1004,231,9111,1228140,1228371,47
3914,106,9112,558008,558114,18
5623,92,9112,558044,558136,18
6488,260,9112,1353080,1353340,28
5105,5,9112,18424,18429,37
9919,274,9112,1353102,1353376,46
7315,242,9112,1353175,1353417,49
3300,124,9113,1300171,1300295,5
2847,166,9113,917799,917965,23
2998,122,9113,797317,797439,37
8175,229,9113,1353225,1353454,38
3670,12,9115,168813,168825,2
3641,158,9116,1392853,1393011,1
9036,249,9116,1420605,1420854,48
4085,232,9117,1454018,1454250,5
5739,291,9117,1464543,1464834,9
7043,266,9117,1454038,1454304,9
2187,123,9117,1032057,1032180,38
2060,227,9117,1353358,1353585,43
5092,249,9117,1228401,1228650,45
8311,248,9118,1439898,1440146,14
2721,296,9118,1032000,1032296,17
1974,121,9118,558265,558386,31
2282,10,9118,51603,51613,37
6942,269,9118,1392874,1393143,49
6974,46,9119,677156,677202,2
9653,89,9119,249996,250085,17
6538,18,9119,168928,168946,19
5288,174,9119,1137512,1137686,25
4705,47,9119,558382,558429,39
3674,101,9120,797559,797660,16
5455,275,9121,1470744,1471019,1
6479,241,9121,1464636,1464877,4
4966,266,9121,1137505,1137771,40
2691,154,9122,1228586,1228740,7
6156,152,9122,1137659,1137811,14
2313,252,9122,1228525,1228777,36
3998,157,9122,1032322,1032479,45
7501,192,9123,1393001,1393193,7
8565,195,9123,1137683,1137878,20
2430,34,9123,344182,344216,22
7402,287,9123,1353433,1353720,46
7869,233,9124,918201,918434,21
8838,164,9124,677288,677452,21
5274,230,9124,1300361,1300591,28
2667,140,9125,558535,558675,10
5909,205,9125,1228684,1228889,16
7258,201,9125,1032438,1032639,33
6298,66,9125,448128,448194,35
7729,91,9125,918435,918526,39
2442,121,9125,1032554,1032675,43
9632,264,9126,1470780,1471044,5
1056,157,9126,1137846,1138003,24
7764,88,9126,558671,558759,37
9095,88,9126,677493,677581,46
9330,97,9127,1137924,1138021,1
8989,285,9127,1137778,1138063,21
2180,283,9127,1228664,1228947,40
7720,299,9128,1464623,1464922,14
5337,16,9128,102066,102082,25
1639,147,9128,677559,677706,30
2220,295,9129,1420720,1421015,13
9905,178,9129,918544,918722,32
3176,84,9129,798046,798130,38
3730,171,9130,1138006,1138177,14
9881,179,9130,1032712,1032891,33
2902,260,9130,1393028,1393288,43
3937,93,9131,558876,558969,9
5290,295,9131,1353534,1353829,20
3496,112,9131,918735,918847,25
2554,279,9131,1393047,1393326,28
2453,19,9131,51786,51805,31
7289,155,9132,1393189,1393344,1
4082,170,9132,1393207,1393377,2
4853,275,9132,1470803,1471078,6
6274,288,9132,1393166,1393454,22
3593,260,9132,1138113,1138373,32
8032,217,9133,1300602,1300819,16
7960,22,9134,51816,51838,17
3301,129,9134,1138301,1138430,19
9057,2,9134,18569,18571,24
3001,25,9134,250482,250507,25
2234,258,9134,1228927,1229185,26
2763,59,9134,344587,344646,42
1255,208,9134,1300643,1300851,49
8141,181,9135,1420872,1421053,3
3799,226,9135,1454192,1454418,6
2558,236,9135,918862,919098,21
3285,248,9135,1138329,1138577,33
2692,262,9135,1393265,1393527,38
4299,185,9135,798330,798515,41
8121,286,9136,1474730,1475016,4
4769,46,9136,344704,344750,9
6210,59,9136,448588,448647,9
5474,201,9136,1353840,1354041,12
2280,222,9136,1300752,1300974,16
8720,114,9136,559158,559272,40
4634,206,9136,1033085,1033291,42
9546,292,9137,1474760,1475052,3
4898,260,9137,1454231,1454491,7
6006,197,9137,1229181,1229378,16
9053,206,9138,1440121,1440327,4
2850,120,9138,1033239,1033359,8
2196,9,9138,102275,102284,9
1546,3,9138,18613,18616,11
8783,242,9138,1300800,1301042,13
1277,203,9138,1300870,1301073,22
2873,244,9138,1229243,1229487,29
1980,193,9138,1138611,1138804,35
2294,293,9138,1138566,1138859,41
3743,154,9138,798655,798809,42
8713,242,9138,1229303,1229545,50
1961,128,9139,559370,559498,10
4011,292,9139,1464713,1465005,12
2095,122,9139,344913,345035,17
1065,20,9139,51965,51985,21
2970,215,9139,1138723,1138938,23
4622,226,9139,1138748,1138974,36
1829,292,9140,1474795,1475087,2
1899,35,9140,448917,448952,5
6343,195,9140,1440189,1440384,5
5217,75,9140,678390,678465,38
9876,255,9140,1033408,1033663,41
9957,219,9140,1353955,1354174,43
4713,279,9141,1138794,1139073,30
9291,271,9141,1229392,1229663,42
3019,69,9141,448983,449052,44
4068,29,9141,169615,169644,44
5806,125,9141,1139000,1139125,48
1937,192,9141,1229513,1229705,49
4584,127,9141,919581,919708,50
9610,93,9142,250901,250994,17
4550,177,9142,1139014,1139191,28
9857,108,9142,559611,559719,30
1430,182,9142,1033670,1033852,37
1923,3,9142,18684,18687,41
8468,167,9142,1033713,1033880,44
5459,62,9143,799081,799143,1
5342,163,9143,1139066,1139229,14
9917,37,9143,345222,345259,49
8802,180,9144,1354008,1354188,8
1685,291,9144,1464753,1465044,14
6858,161,9145,919706,919867,33
1146,125,9146,559709,559834,10
7774,93,9146,449149,449242,30
5431,187,9147,1229580,1229767,25
9758,150,9147,919770,919920,35
3427,264,9147,1393442,1393706,43
4045,202,9148,1440224,1440426,1
3045,5,9148,52118,52123,5
8501,129,9148,559780,559909,21
5873,131,9148,678675,678806,30
8259,242,9149,799097,799339,17
8795,56,9149,169806,169862,17
6747,278,9149,1300985,1301263,20
8690,116,9149,449281,449397,21
4621,8,9149,102603,102611,28
5979,60,9149,251162,251222,30
7713,295,9149,1354008,1354303,46
5820,15,9149,102620,102635,49
1037,40,9150,449383,449423,4
6994,160,9150,919860,920020,13
6020,59,9150,559959,560018,16
9355,283,9150,1420968,1421251,38
8080,227,9151,1454347,1454574,1
1180,73,9151,449429,449502,13
4407,108,9151,559966,560074,18
3345,20,9151,251275,251295,19
6162,226,9151,1229712,1229938,20
7316,32,9151,102661,102693,21
4279,249,9151,1229745,1229994,35
4430,151,9152,1139354,1139505,25
1348,65,9152,251275,251340,36
5805,255,9152,1229809,1230064,50
7366,272,9153,1454336,1454608,11
1529,237,9153,1301135,1301372,13
1325,101,9153,560104,560205,15
3865,5,9153,52260,52265,22
6289,289,9153,1393553,1393842,22
4798,78,9153,678988,679066,45
5412,223,9153,1393657,1393880,48
9672,49,9154,345586,345635,13
2360,292,9154,1229899,1230191,31
1787,243,9155,1464821,1465064,3
1191,285,9155,1301185,1301470,42
4130,54,9155,345649,345703,42
7099,268,9156,1454377,1454645,14
4420,71,9156,560245,560316,23
3757,11,9156,52292,52303,26
2355,274,9156,1139472,1139746,30
8442,296,9157,1464794,1465090,14
5877,291,9157,1139544,1139835,30
7355,177,9157,920239,920416,36
9756,220,9157,1139645,1139865,36
5467,164,9158,1301357,1301521,7
9272,181,9158,920314,920495,26
9697,119,9158,920395,920514,27
4965,258,9158,1034250,1034508,41
9113,271,9159,1230060,1230331,33
1157,64,9159,679302,679366,39
2483,53,9160,345832,345885,15
5004,142,9160,799782,799924,26
2316,24,9161,345881,345905,5
1016,90,9161,560436,560526,15
5529,236,9161,1354241,1354477,16
6255,107,9161,799865,799972,16
5499,144,9161,920487,920631,34
1345,54,9161,560529,560583,38
9645,254,9161,1393703,1393957,38
6725,121,9161,1034494,1034615,48
3923,250,9162,1464873,1465123,3
9712,16,9162,170238,170254,16
9888,172,9162,920544,920716,18
9041,40,9162,251658,251698,37
2328,165,9162,1034501,1034666,45
7173,27,9162,251688,251715,47
1408,199,9162,1139820,1140019,50
5545,130,9163,1301477,1301607,3
3532,222,9163,1301435,1301657,22
4472,40,9163,102939,102979,36
9446,263,9163,1034521,1034784,41
5283,38,9163,450010,450048,45
3672,175,9164,1139910,1140085,27
1170,173,9164,1230305,1230478,43
6528,129,9165,800095,800224,20
5297,299,9165,1354266,1354565,37
8448,100,9166,1140051,1140151,6
8984,1,9166,18888,18889,19
4589,242,9166,1354367,1354609,24
9886,120,9166,1034785,1034905,25
5326,175,9166,1034773,1034948,29
1125,266,9166,1354388,1354654,34
5454,127,9166,920877,921004,46
7769,200,9167,679596,679796,10
3658,140,9167,800235,800375,15
2175,213,9167,1230379,1230592,47
5644,176,9167,1301599,1301775,48
3419,138,9167,1034904,1035042,49
6600,142,9168,450132,450274,17
4692,268,9168,1354445,1354713,28
6829,82,9168,679829,679911,33
3175,246,9168,1140057,1140303,40
9839,65,9169,346228,346293,7
1740,193,9169,1140137,1140330,20
5256,49,9169,560945,560994,39
1825,271,9169,1354478,1354749,47
7221,20,9170,251963,251983,6
9940,169,9170,1301678,1301847,9
8789,279,9170,1393717,1393996,13
5566,218,9170,1301681,1301899,28
7765,248,9171,1464899,1465147,4
5515,111,9171,800495,800606,33
9485,65,9171,450373,450438,34
7089,154,9171,800501,800655,42
5934,192,9171,1140265,1140457,50
6844,65,9171,680041,680106,50
6234,254,9173,1464930,1465184,4
2536,231,9173,1354596,1354827,24
2106,283,9173,1393779,1394062,34
6804,81,9173,450456,450537,37
7649,194,9174,1393890,1394084,7
2731,17,9174,103186,103203,8
8771,210,9174,1140358,1140568,44
3821,223,9175,1354677,1354900,38
9162,245,9175,1354699,1354944,49
3360,113,9176,1230760,1230873,5
7918,118,9176,921274,921392,12
9493,37,9176,252135,252172,42
2956,87,9177,561167,561254,9
7978,62,9177,252144,252206,21
5955,226,9177,1301851,1302077,34
5812,183,9178,1230760,1230943,38
9924,46,9179,103236,103282,17
5620,169,9179,1035284,1035453,20
4152,291,9179,1393851,1394142,24
7833,11,9179,52628,52639,32
5553,192,9179,1301941,1302133,38
9226,144,9180,1140593,1140737,11
6346,189,9180,1035360,1035549,33
1728,218,9180,1301969,1302187,38
6348,177,9180,1035435,1035612,47
3339,154,9181,1394004,1394158,1
5663,148,9182,1354862,1355010,3
9024,76,9182,921531,921607,3
4301,256,9182,1454467,1454723,9
9216,130,9182,921520,921650,12
8973,96,9182,450688,450784,21
4512,64,9182,561381,561445,29
9211,63,9182,252292,252355,31
2148,210,9182,1035477,1035687,32
2681,218,9182,1230893,1231111,34
4534,290,9182,1393926,1394216,34
2363,134,9182,561394,561528,41
8571,72,9182,450818,450890,44
3104,69,9182,561476,561545,46
5368,68,9183,252393,252461,21
6602,40,9183,346757,346797,25
8415,32,9183,170823,170855,26
9306,115,9183,1035645,1035760,43
1763,153,9184,1354930,1355083,2
9051,84,9184,680422,680506,7
7306,178,9184,1140714,1140892,46
7678,93,9185,1035723,1035816,5
1380,17,9185,52736,52753,7
9141,198,9185,1394035,1394233,8
8536,78,9185,801093,801171,39
1320,213,9185,1354920,1355133,43
9301,99,9185,921734,921833,43
2817,106,9185,680501,680607,44
1184,289,9185,1354895,1355184,46
2530,37,9186,170914,170951,8
2393,98,9186,346822,346920,17
3548,88,9186,921788,921876,19
6570,107,9186,921796,921903,25
9738,28,9186,252574,252602,38
1831,272,9186,1440334,1440606,39
5292,298,9186,1302116,1302414,42
1267,114,9187,1231172,1231286,3
8570,292,9187,1474785,1475077,3
5679,183,9187,1302265,1302448,14
1352,283,9187,1354965,1355248,18
5790,204,9187,1140910,1141114,20
4892,36,9187,346985,347021,24
4676,66,9187,561721,561787,29
3072,163,9187,1231205,1231368,38
7461,71,9187,346996,347067,40
2633,214,9188,1454545,1454759,3
7731,170,9188,1394149,1394319,3
6470,136,9188,1141044,1141180,8
7267,184,9188,921936,922120,40
9621,228,9189,1302319,1302547,16
2465,25,9189,252721,252746,22
6914,60,9189,451141,451201,34
3852,250,9189,1035875,1036125,41
2988,40,9190,171109,171149,40
9154,48,9191,347127,347175,13
9027,156,9191,1036007,1036163,16
3354,227,9191,1231244,1231471,27
2336,81,9191,561845,561926,34
3759,159,9191,680763,680922,41
3055,114,9191,801425,801539,47
6173,138,9192,1141114,1141252,7
3438,18,9192,103643,103661,8
9823,185,9192,922082,922267,15
6723,11,9192,19085,19096,21
6580,127,9192,801494,801621,29
2967,72,9193,922208,922280,5
5964,205,9193,1302375,1302580,24
9122,99,9194,801557,801656,8
5583,232,9194,1231288,1231520,10
4010,210,9194,1302394,1302604,16
9536,112,9194,922236,922348,28
5032,55,9194,451380,451435,29
3620,195,9194,1036110,1036305,33
7922,227,9194,1231351,1231578,35
5870,31,9195,252936,252967,35
3649,154,9196,1355147,1355301,6
1607,156,9196,1231448,1231604,12
4406,107,9196,922357,922464,38
5067,79,9196,801740,801819,39
2712,214,9196,922285,922499,41
6737,163,9196,1036222,1036385,47
5779,193,9197,1440462,1440655,1
8765,124,9197,922434,922558,16
2177,240,9197,1421239,1421479,19
6308,252,9197,1231421,1231673,23
2469,210,9197,1231501,1231711,27
9852,279,9197,1394116,1394395,28
9841,218,9197,1231549,1231767,29
5630,17,9197,171376,171393,42
3241,157,9198,1231633,1231790,9
6028,144,9198,1141393,1141537,11
9150,107,9198,801940,802047,16
8915,72,9198,562287,562359,34
6916,140,9198,1141434,1141574,43
7367,95,9198,681330,681425,47
4950,215,9199,1454554,1454769,6
9039,162,9199,801956,802118,32
1102,271,9199,1302471,1302742,45
7675,68,9200,562373,562441,11
7139,45,9200,171435,171480,21
9189,190,9200,1231689,1231879,25
1447,29,9200,171473,171502,27
6598,206,9200,1036451,1036657,32
2922,52,9201,253154,253206,7
3126,17,9201,103872,103889,15
8329,145,9201,1036540,1036685,16
9490,268,9201,1421250,1421518,16
4525,24,9201,253211,253235,22
9643,25,9201,103891,103916,40
7236,219,9202,1036546,1036765,13
2668,102,9202,681505,681607,20
8820,189,9202,922708,922897,36
5912,76,9202,562497,562573,47
8440,109,9202,802200,802309,50
1250,146,9203,1036653,1036799,28
9184,123,9203,802243,802366,29
4503,147,9203,1231778,1231925,48
6018,43,9204,253274,253317,7
2202,230,9204,1394244,1394474,19
6268,185,9204,1231796,1231981,22
8490,136,9204,1036754,1036890,24
5733,261,9204,1302584,1302845,27
8411,50,9204,253312,253362,30
4133,135,9204,681640,681775,32
6385,201,9204,1231840,1232041,34
8344,184,9204,1036813,1036997,45
8474,259,9205,1454531,1454790,9
6594,244,9205,1231839,1232083,36
5212,110,9205,681766,681876,47
7669,107,9206,451960,452067,10
2785,264,9206,1421288,1421552,16
7170,103,9206,923025,923128,38
7933,53,9207,347858,347911,27
8829,280,9207,1231869,1232149,31
7148,43,9207,253458,253501,32
9813,183,9207,802412,802595,41
5502,273,9208,1470859,1471132,1
5716,79,9208,923103,923182,5
9447,97,9208,802534,802631,7
5992,201,9208,1302724,1302925,22
8081,194,9208,923060,923254,32
6995,205,9208,1141738,1141943,37
3883,300,9208,1355207,1355507,44
4143,105,9208,681968,682073,44
6503,13,9209,171821,171834,2
3445,81,9209,923236,923317,4
4980,262,9209,1470895,1471157,4
1683,157,9209,923216,923373,20
2183,281,9209,1141758,1142039,30
9245,248,9209,1355301,1355549,34
7743,191,9209,1141920,1142111,46
1594,59,9210,802772,802831,2
5685,68,9210,562976,563044,20
7992,262,9210,1394308,1394570,22
5857,233,9210,1232093,1232326,29
6369,27,9210,253659,253686,29
3916,178,9210,1037164,1037342,35
2861,143,9210,802789,802932,42
5377,147,9211,1355454,1355601,3
2526,131,9211,1142061,1142192,7
4823,227,9211,1421384,1421611,11
9683,192,9211,1232192,1232384,16
9698,257,9211,1302831,1303088,20
7091,284,9211,1394358,1394642,22
3208,50,9211,563143,563193,33
6265,23,9211,253748,253771,39
2834,210,9211,1142129,1142339,50
3708,210,9211,1142188,1142398,50
5952,54,9212,253753,253807,7
9239,74,9212,452406,452480,8
6615,253,9212,1440494,1440747,12
2724,126,9212,803002,803128,44
2820,186,9212,1355498,1355684,48
5095,58,9213,563214,563272,25
5469,229,9213,1142244,1142473,26
3573,161,9213,803042,803203,36
1209,130,9213,1142370,1142500,43
1464,169,9214,1394518,1394687,3
9850,212,9214,1454629,1454841,3
1117,54,9214,563291,563345,24
7478,195,9214,1037443,1037638,42
7138,121,9215,1232403,1232524,5
8328,284,9215,1440502,1440786,16
1556,91,9215,452565,452656,26
8797,112,9215,563298,563410,36
2937,252,9215,1232360,1232612,45
6903,19,9216,172106,172125,29
4504,109,9216,563352,563461,32
3484,193,9216,1142449,1142642,46
9896,258,9217,1440562,1440820,12
4411,9,9217,19332,19341,31
1876,245,9217,1142455,1142700,32
7006,188,9217,1142544,1142732,45
5316,83,9218,1037725,1037808,5
5048,283,9218,1394494,1394777,28
4815,116,9218,1037744,1037860,43
9166,82,9219,682591,682673,12
5656,74,9219,452748,452822,15
9478,77,9219,682619,682696,22
2191,12,9219,172197,172209,24
7270,54,9219,348519,348573,34
8020,161,9219,1037739,1037900,46
6877,289,9220,1474791,1475080,1
5748,277,9221,1394543,1394820,13
6407,267,9221,1421484,1421751,19
1370,201,9221,1037813,1038014,33
8620,6,9221,19357,19363,37
7530,71,9221,803482,803553,43
4816,293,9221,1440597,1440890,48
8310,64,9222,348582,348646,10
7990,183,9222,1303147,1303330,14
8642,72,9222,452861,452933,18
1869,73,9222,682772,682845,22
9927,200,9222,1142680,1142880,29
6048,21,9222,53415,53436,30
6578,17,9222,53428,53445,30
2705,240,9222,1421578,1421818,39
1261,252,9222,1232559,1232811,50
4042,192,9223,1037974,1038166,18
4459,126,9223,924125,924251,27
4433,9,9223,104476,104485,33
6958,195,9223,1142787,1142982,46
6411,72,9223,682887,682959,50
3080,118,9224,1232717,1232835,2
1087,116,9224,924200,924316,14
5329,64,9224,563747,563811,28
3379,294,9224,1303099,1303393,42
6392,278,9225,1454602,1454880,14
7753,36,9225,104496,104532,21
6296,136,9226,682906,683042,31
6728,272,9226,1394690,1394962,38
2498,172,9226,803666,803838,40
7816,167,9226,682952,683119,41
6483,46,9227,453121,453167,22
4306,283,9228,1474815,1475098,6
2699,261,9228,1232693,1232954,15
6019,271,9228,1232730,1233001,15
9229,278,9228,1142906,1143184,21
7123,59,9228,563947,564006,24
3307,228,9228,1232829,1233057,27
9714,254,9228,1355719,1355973,28
1401,288,9228,1142998,1143286,41
8981,167,9229,1394840,1395007,1
5985,201,9229,803850,804051,21
6067,97,9229,803975,804072,28
6366,19,9229,104632,104651,44
9299,36,9229,453298,453334,45
7996,192,9230,1440747,1440939,2
1526,206,9230,1440766,1440972,3
5240,242,9230,1440759,1441001,9
5999,72,9230,453326,453398,13
2884,290,9230,1355788,1356078,29
1547,126,9230,804030,804156,44
7962,117,9230,804060,804177,44
7435,58,9231,683346,683404,6
1156,118,9231,683325,683443,13
5372,192,9231,1038385,1038577,20
1412,155,9231,1143244,1143399,25
3137,63,9231,453440,453503,42
4699,41,9232,254514,254555,27
5101,102,9232,924576,924678,38
4863,92,9232,804164,804256,50
7873,6,9233,53601,53607,15
2704,56,9233,683458,683514,19
6376,237,9233,1143198,1143435,32
3763,277,9233,1303340,1303617,37
6695,299,9234,1474834,1475133,4
3590,157,9234,1038538,1038695,34
5885,196,9235,1440843,1441039,2
4753,50,9235,453552,453602,12
6477,59,9235,564292,564351,22
9862,176,9235,924642,924818,23
6500,66,9235,683555,683621,24
9673,111,9235,564309,564420,32
3813,1,9235,19491,19492,43
4641,180,9236,564294,564474,17
3266,94,9236,1038627,1038721,19
8130,63,9236,564441,564504,22
3858,102,9236,924762,924864,43
4334,295,9236,1355847,1356142,45
6202,2,9236,19498,19500,45
2894,96,9236,683593,683689,47
6738,137,9237,1303571,1303708,3
3673,181,9237,1421772,1421953,6
7928,281,9237,1474873,1475154,6
4691,167,9237,683594,683761,10
5823,31,9237,254732,254763,15
9695,284,9237,1303497,1303781,26
8493,167,9237,1038687,1038854,34
9581,133,9237,924875,925008,45
5332,265,9238,1355935,1356200,10
7166,280,9239,1233111,1233391,15
4445,185,9239,1233244,1233429,22
4158,4,9240,53709,53713,1
6167,224,9240,1454732,1454956,5
9993,57,9240,254791,254848,30
9359,281,9240,1440847,1441128,39
1662,45,9240,453856,453901,45
3702,156,9241,1233326,1233482,8
4124,24,9241,172833,172857,11
5860,50,9241,564703,564753,14
2349,149,9241,924995,925144,29
1262,186,9241,1143546,1143732,34
5622,75,9242,925106,925181,3
8083,192,9242,1356071,1356263,9
6712,128,9242,925096,925224,16
8054,84,9242,683931,684015,49
3403,72,9242,683963,684035,50
4660,228,9243,1421810,1422038,11
3092,170,9243,1143633,1143803,22
4642,131,9243,1143702,1143833,39
3754,178,9243,683948,684126,41
7639,34,9243,254964,254998,47
7803,60,9244,804663,804723,4
4693,295,9244,1303589,1303884,31
6397,293,9245,1421766,1422059,10
3845,220,9245,1143690,1143910,23
1545,76,9245,564934,565010,35
5651,178,9245,925201,925379,42
3264,184,9245,1143759,1143943,50
8354,123,9246,1039034,1039157,25
6052,49,9246,454144,454193,28
4102,260,9247,1356053,1356313,10
5494,191,9247,804709,804900,21
8856,249,9247,1143745,1143994,31
7457,214,9247,1143830,1144044,35
9965,48,9247,255105,255153,37
5982,170,9247,684249,684419,41
1175,131,9247,804855,804986,47
2663,36,9247,349792,349828,49
6105,40,9248,173069,173109,21
6888,115,9248,565098,565213,36
3583,55,9249,565170,565225,22
2215,297,9249,1394932,1395229,34
9068,170,9250,1395087,1395257,4
3038,259,9250,925297,925556,17
3860,262,9250,1303726,1303988,20
9267,70,9250,565242,565312,28
2041,67,9250,349879,349946,32
9262,122,9250,804991,805113,33
4787,174,9250,1039154,1039328,45
1875,36,9251,454403,454439,3
9573,295,9251,1421788,1422083,13
7175,213,9252,1440941,1441154,6
1301,155,9252,1144000,1144155,12
2630,254,9252,1303790,1304044,18
6304,144,9252,1233568,1233712,19
1469,66,9252,565359,565425,20
3442,186,9252,1039281,1039467,35
2693,268,9252,1039260,1039528,41
5126,29,9253,173247,173276,8
5188,214,9253,1421904,1422118,8
2110,206,9253,1039379,1039585,13
7026,89,9253,565424,565513,18
7024,289,9253,1395077,1395366,22
1718,277,9253,1356194,1356471,27
8215,276,9253,1233543,1233819,31
2713,166,9253,925712,925878,36
1445,266,9254,1356249,1356515,34
5936,123,9254,805311,805434,35
5899,195,9254,805282,805477,41
4175,231,9255,1303956,1304187,16
6894,98,9255,350136,350234,17
6617,294,9255,1395101,1395395,47
6487,104,9256,684806,684910,15
8527,186,9256,1356389,1356575,19
1924,255,9256,1233698,1233953,26
4598,125,9257,1304128,1304253,3
6593,284,9257,1454691,1454975,14
3209,11,9257,105335,105346,23
4662,50,9257,454757,454807,28
2092,212,9257,1395234,1395446,39
6246,27,9257,255575,255602,46
7049,29,9257,255586,255615,47
8397,58,9258,454775,454833,13
6565,14,9258,173469,173483,19
4909,156,9258,684854,685010,21
3862,241,9258,1233782,1234023,36
5376,14,9259,173501,173515,14
3382,144,9259,925943,926087,45
9140,180,9260,1356453,1356633,7
1678,206,9260,1039663,1039869,10
5990,124,9261,1304190,1304314,5
3237,175,9261,1304167,1304342,8
8506,172,9261,926009,926181,23
6395,143,9261,685039,685182,30
6213,147,9261,685067,685214,31
1332,175,9261,926039,926214,32
7695,199,9261,1304192,1304391,43
7663,36,9262,454986,455022,3
2229,86,9262,805671,805757,22
3308,64,9262,454996,455060,35
2300,222,9263,1233914,1234136,46
6469,122,9263,926151,926273,46
5976,41,9264,255765,255806,8
8165,67,9264,455043,455110,9
6655,13,9264,105492,105505,12
4672,300,9264,1356356,1356656,15
1446,123,9264,1039858,1039981,22
8891,32,9264,255818,255850,35
2454,292,9265,1454711,1455003,39
9986,116,9265,1039911,1040027,48
8027,7,9266,105522,105529,22
6788,212,9266,1039860,1040072,36
6800,181,9266,926230,926411,36
9531,10,9267,105548,105558,6
7088,131,9267,926314,926445,16
2172,120,9267,1039986,1040106,43
4581,224,9267,1395274,1395498,48
1620,152,9268,805841,805993,13
9026,9,9268,105569,105578,33
5852,2,9268,19760,19762,44
7741,65,9269,685409,685474,14
8588,178,9269,805844,806022,21
6537,197,9269,1304270,1304467,24
2216,13,9269,54204,54217,40
1099,136,9270,1144529,1144665,9
5418,227,9270,1234021,1234248,10
3361,172,9270,805932,806104,30
6886,241,9271,1465022,1465263,2
6284,82,9271,455279,455361,8
6489,63,9271,255960,256023,21
3791,261,9271,1356501,1356762,28
4402,110,9271,566167,566277,32
7212,62,9271,455354,455416,46
3096,187,9272,926401,926588,32
4450,27,9272,350775,350802,39
5302,139,9272,926474,926613,44
9757,3,9273,19801,19804,2
6777,56,9273,350771,350827,7
3682,283,9273,1465000,1465283,12
9594,108,9273,926551,926659,25
2808,70,9274,455413,455483,7
5980,262,9274,1454798,1455060,11
7863,94,9274,685627,685721,11
4978,159,9274,1304403,1304562,19
2291,250,9274,1421996,1422246,39
1403,213,9274,1144621,1144834,50
6347,68,9275,926670,926738,1
8828,86,9275,455486,455572,8
6666,104,9275,926658,926762,24
9224,258,9275,1356600,1356858,25
9489,9,9275,105737,105746,28
3174,226,9275,1395379,1395605,48
9687,201,9275,1304459,1304660,49
2111,12,9276,105749,105761,19
4785,149,9276,1040219,1040368,27
4817,133,9276,926716,926849,37
9300,277,9276,1304432,1304709,44
7044,211,9276,1395419,1395630,48
9201,298,9277,1356646,1356944,35
8946,143,9277,1144866,1145009,38
4289,234,9278,1465068,1465302,1
5209,213,9278,1454883,1455096,5
1172,135,9278,1304680,1304815,6
5945,5,9278,54355,54360,12
4566,195,9278,1356797,1356992,14
7032,300,9278,1234327,1234627,32
3982,168,9278,806397,806565,40
1046,228,9278,1144916,1145144,42
5588,180,9279,1145005,1145185,16
1789,98,9279,685968,686066,20
8481,255,9279,1356790,1357045,49
5450,115,9280,926975,927090,9
6899,161,9280,926981,927142,33
8716,255,9280,1234437,1234692,33
8124,292,9280,1356790,1357082,35
1435,175,9280,1040538,1040713,44
2866,232,9281,1145090,1145322,23
8517,130,9281,806671,806801,23
2372,9,9281,54397,54406,40
6155,149,9281,927138,927287,44
5082,276,9281,1304662,1304938,45
6291,2,9281,19875,19877,49
5776,22,9282,54411,54433,17
6330,75,9282,566749,566824,23
7442,211,9282,1145189,1145400,35
7994,2,9282,19881,19883,35
9767,287,9282,1145162,1145449,41
3366,86,9282,686261,686347,45
8970,51,9283,686307,686358,5
9003,2,9283,19888,19890,12
3932,59,9283,351247,351306,32
3507,109,9283,566799,566908,36
6630,28,9283,256472,256500,46
6678,190,9283,1145292,1145482,47
2399,166,9284,1395515,1395681,4
4890,127,9284,566845,566972,10
1505,155,9284,686265,686420,21
3272,161,9285,1145374,1145535,25
5599,263,9286,1304732,1304995,29
5724,33,9287,174229,174262,8
5184,53,9287,351361,351414,9
4159,123,9287,566934,567057,10
6961,22,9287,54503,54525,30
7237,46,9287,256557,256603,32
5933,49,9287,567019,567068,38
1791,266,9287,1395469,1395735,43
3481,16,9287,174293,174309,45
4560,197,9287,1145427,1145624,47
3519,63,9288,456117,456180,20
1107,146,9289,1356995,1357141,4
6287,67,9289,806948,807015,19
1713,265,9289,1040754,1041019,21
6714,176,9289,1040882,1041058,35
9818,76,9289,807005,807081,38
3833,241,9289,1422056,1422297,48
4121,215,9290,1145463,1145678,36
1910,282,9290,1422046,1422328,38
7793,135,9290,686508,686643,40
2384,125,9290,927502,927627,45
8214,224,9291,1454890,1455114,5
3375,172,9291,1304941,1305113,12
3874,134,9291,807087,807221,23
4262,114,9291,567199,567313,32
4831,210,9291,1395628,1395838,39
1304,105,9291,807153,807258,46
4470,158,9291,1234798,1234956,48
3454,225,9292,1454918,1455143,4
5219,12,9292,54603,54615,7
9825,254,9292,927483,927737,17
7352,267,9292,1395626,1395893,22
7400,252,9292,1234779,1235031,23
2741,248,9292,1304972,1305220,27
4866,233,9292,1305019,1305252,27
8292,265,9292,1234859,1235124,32
8637,59,9292,256805,256864,36
5824,164,9293,927736,927900,20
7389,262,9293,1305028,1305290,20
5349,107,9293,567412,567519,40
1297,191,9293,1041207,1041398,44
8025,254,9294,1441073,1441327,12
9092,224,9294,1145769,1145993,15
9323,160,9294,927863,928023,26
7796,55,9294,351796,351851,42
8895,220,9295,1145797,1146017,10
6536,40,9295,351839,351879,12
1575,118,9295,686939,687057,18
2402,90,9295,686989,687079,27
1615,58,9295,256954,257012,30
8888,293,9295,1395659,1395952,34
6396,159,9295,1145912,1146071,49
5649,147,9296,1145947,1146094,22
9261,105,9296,928008,928113,22
4396,283,9296,1234974,1235257,23
2266,68,9296,456657,456725,37
3334,67,9296,687104,687171,50
4192,248,9297,1441111,1441359,9
3221,260,9297,1357088,1357348,10
5121,252,9297,1235072,1235324,26
2843,81,9297,687177,687258,28
3983,294,9297,1145955,1146249,30
3348,228,9297,1146059,1146287,36
7815,215,9297,1146120,1146335,44
4974,216,9297,1395782,1395998,48
2806,49,9298,687292,687341,5
1162,209,9298,687188,687397,17
5215,274,9298,1441133,1441407,39
1236,77,9298,687349,687426,49
5573,158,9298,1041593,1041751,50
6050,61,9299,807769,807830,3
8129,223,9299,1422229,1422452,7
3263,250,9299,1146177,1146427,40
5185,10,9299,174828,174838,43
1906,201,9299,1146260,1146461,44
8177,41,9300,567967,568008,3
8581,289,9300,1465028,1465317,9
8923,89,9300,687440,687529,12
1417,166,9300,1146335,1146501,16
3922,281,9300,1305201,1305482,20
5458,17,9301,174874,174891,22
5781,296,9301,1357151,1357447,36
1358,195,9302,1441251,1441446,1
5077,298,9302,1465059,1465357,11
1603,214,9302,1305352,1305566,16
2046,39,9302,106446,106485,17
3289,132,9302,1041850,1041982,25
9799,40,9303,457055,457095,24
6920,252,9303,1146391,1146643,31
3303,290,9303,1235262,1235552,32
3180,187,9303,1357322,1357509,39
9125,105,9304,568110,568215,18
4989,115,9304,928510,928625,22
9048,199,9304,1235422,1235621,25
7290,198,9304,1146559,1146757,37
2898,174,9305,1146632,1146806,14
4308,80,9306,568207,568287,47
8232,97,9307,1146722,1146819,6
3068,197,9307,1235462,1235659,28
5165,134,9307,1042041,1042175,28
9069,176,9307,1042033,1042209,33
2652,213,9307,1146684,1146897,37
1274,280,9307,1441235,1441515,39
1711,86,9308,568297,568383,15
5680,127,9308,687762,687889,15
7242,172,9308,928660,928832,15
6432,34,9308,352476,352510,29
1161,141,9309,1357402,1357543,3
4154,279,9309,1474826,1475105,5
3634,190,9309,1357397,1357587,8
9963,54,9309,568406,568460,22
2199,249,9309,1357366,1357615,34
8836,84,9309,568419,568503,34
8677,98,9309,928816,928914,43
8679,156,9309,1042187,1042343,46
2011,76,9309,808296,808372,48
8098,292,9310,1474851,1475143,1
8914,278,9310,1474890,1475168,1
2256,152,9310,1146881,1147033,24
7864,150,9310,928868,929018,29
7017,201,9311,1441395,1441596,3
2333,59,9311,808392,808451,5
8150,239,9311,1146846,1147085,32
1106,171,9311,1042290,1042461,35
3217,178,9311,1357506,1357684,39
4208,272,9312,1235575,1235847,15
7144,274,9312,1235623,1235897,15
3182,131,9312,929055,929186,16
7384,65,9312,352674,352739,18
9274,291,9312,1395925,1396216,28
6880,205,9313,1147025,1147230,20
2462,164,9313,1235796,1235960,43
5331,33,9313,457565,457598,48
9444,50,9314,688197,688247,1
9265,36,9314,352755,352791,23
4618,172,9314,1147107,1147279,27
5301,110,9314,808581,808691,33
4629,12,9314,106719,106731,46
9555,154,9315,1235832,1235986,7
1986,144,9315,1147173,1147317,24
2236,264,9315,1147091,1147355,30
3342,243,9315,1147156,1147399,32
8010,44,9315,457651,457695,50
5853,248,9316,1465192,1465440,6
4300,76,9316,568767,568843,7
2409,11,9316,106771,106782,19
3679,186,9316,1042603,1042789,29
1851,192,9316,929247,929439,32
5125,137,9316,808757,808894,33
7565,227,9317,1235790,1236017,10
2669,101,9317,929367,929468,14
4284,143,9317,1235899,1236042,39
4908,251,9317,1305562,1305813,46
8910,222,9318,1455042,1455264,4
4661,4,9318,55094,55098,6
8091,266,9318,1042640,1042906,21
6791,202,9318,1042757,1042959,23
6380,156,9318,929469,929625,29
9539,31,9318,352995,353026,33
3951,252,9318,1235894,1236146,35
3942,132,9318,808960,809092,42
2684,88,9318,929580,929668,48
1279,104,9319,1147426,1147530,4
1308,61,9319,457869,457930,11
2910,256,9319,1147339,1147595,15
8231,300,9319,1305575,1305875,23
4467,115,9319,929644,929759,28
7310,267,9319,1147403,1147670,30
4297,3,9319,55144,55147,34
6569,281,9319,1235944,1236225,40
9327,65,9320,353098,353163,10
5584,239,9320,1305657,1305896,13
6834,229,9321,1455066,1455295,4
6297,219,9321,1396064,1396283,14
8358,29,9321,353169,353198,45
6673,222,9322,1455101,1455323,5
7229,290,9322,1465178,1465468,11
5950,8,9322,106937,106945,14
5134,257,9322,1396090,1396347,16
1245,133,9322,809253,809386,35
7704,110,9322,688823,688933,35
5834,113,9323,1043131,1043244,7
3385,61,9323,353215,353276,26
3630,294,9323,1305737,1306031,26
4304,22,9323,258115,258137,33
2492,232,9323,1236163,1236395,47
9626,143,9324,1357696,1357839,1
1171,264,9324,1357602,1357866,10
2952,14,9324,107001,107015,44
1958,84,9325,1043248,1043332,2
4777,73,9325,458133,458206,15
4115,56,9325,458164,458220,34
5169,137,9325,929891,930028,35
1457,242,9325,1357664,1357906,49
5581,131,9326,1305977,1306108,3
2171,243,9326,1465249,1465492,4
8366,191,9326,1236333,1236524,24
2211,185,9326,1147797,1147982,34
9784,279,9326,1305896,1306175,44
1570,239,9326,1357720,1357959,49
3820,216,9327,1455165,1455381,5
6608,174,9327,689036,689210,10
2195,122,9327,930062,930184,16
6273,22,9327,258274,258296,19
4949,181,9327,1043329,1043510,23
8764,230,9327,1147861,1148091,26
4987,191,9327,930078,930269,31
6409,165,9328,809567,809732,30
3740,186,9328,1147943,1148129,34
6559,299,9328,1357714,1358013,50
9627,149,9329,1148032,1148181,12
1746,101,9329,569557,569658,26
1797,240,9329,1147997,1148237,26
3963,147,9329,1236506,1236653,48
5591,283,9330,1474894,1475177,2
2245,50,9330,258384,258434,18
5086,202,9330,930228,930430,30
9094,103,9331,1148185,1148288,6
8193,192,9331,1396218,1396410,7
3511,164,9331,930321,930485,18
9215,241,9331,1306101,1306342,25
6838,61,9331,353606,353667,26
3864,231,9333,1455200,1455431,4
7771,89,9333,1043634,1043723,4
7549,120,9333,689411,689531,15
8173,174,9333,1236575,1236749,22
9625,87,9333,689482,689569,28
5929,16,9334,55363,55379,7
2099,210,9334,1357877,1358087,14
3336,12,9334,55377,55389,26
7573,68,9335,930503,930571,3
1518,300,9335,1465236,1465536,14
4508,3,9335,20355,20358,27
3993,92,9336,809941,810033,14
4649,159,9337,1396297,1396456,4
8223,138,9337,1043681,1043819,12
9467,264,9337,1236575,1236839,26
5160,144,9338,1357995,1358139,1
6873,172,9338,1422591,1422763,2
5282,280,9338,1470968,1471248,4
3392,77,9338,689647,689724,33
8087,283,9338,1396241,1396524,34
6267,119,9338,1148411,1148530,39
7791,261,9338,1306239,1306500,44
7238,159,9339,1306359,1306518,7
7075,8,9339,55429,55437,29
3265,90,9339,353783,353873,31
1405,38,9339,175953,175991,40
3281,8,9339,107310,107318,42
4764,92,9340,1043886,1043978,5
4745,142,9340,810075,810217,13
2176,177,9340,1148438,1148615,28
7399,185,9340,1148459,1148644,47
7886,121,9341,1236852,1236973,6
8921,53,9341,258662,258715,10
7249,228,9341,1396327,1396555,14
8388,64,9341,570007,570071,16
1324,251,9341,1043866,1044117,30
1524,201,9341,1148522,1148723,37
8241,168,9342,1396418,1396586,1
5547,70,9342,458810,458880,7
6789,193,9342,1358064,1358257,9
8561,31,9342,258764,258795,25
9973,88,9342,458839,458927,40
2052,129,9343,1306451,1306580,5
9246,48,9344,570104,570152,6
5986,204,9344,1043993,1044197,10
2374,132,9344,810263,810395,15
7284,156,9344,689885,690041,31
4464,224,9344,930737,930961,41
6716,192,9344,1148608,1148800,50
6032,222,9345,1455266,1455488,5
9706,86,9345,810391,810477,22
1036,11,9345,107455,107466,35
5205,107,9346,1236946,1237053,2
6391,214,9346,1306411,1306625,28
3618,262,9346,1306403,1306665,45
9073,3,9347,20447,20450,4
1503,80,9347,354085,354165,21
6947,49,9347,459038,459087,28
8908,62,9347,459045,459107,34
8090,80,9347,459048,459128,40
3974,225,9347,1236927,1237152,50
9926,259,9348,1471006,1471265,2
1517,9,9348,107508,107517,16
7877,260,9348,1306455,1306715,20
6283,52,9348,459121,459173,35
7802,145,9348,931008,931153,37
6727,189,9348,810451,810640,41
5862,33,9349,459187,459220,2
7912,107,9349,1148869,1148976,6
7987,230,9349,1306533,1306763,28
8577,191,9350,1358128,1358319,19
2087,233,9350,1237044,1237277,35
5804,111,9350,570356,570467,40
5881,283,9350,1148808,1149091,41
2899,154,9350,810621,810775,42
7705,68,9350,690275,690343,50
1205,77,9351,459291,459368,9
7659,296,9351,1358061,1358357,20
3352,36,9351,259111,259147,28
9854,222,9351,1148931,1149153,42
2556,196,9352,1441629,1441825,3
9116,73,9352,459365,459438,9
6917,74,9352,259123,259197,17
7692,9,9352,107630,107639,22
3801,54,9352,570529,570583,33
8792,46,9352,259179,259225,44
8932,178,9352,1044406,1044584,47
6669,35,9353,354441,354476,16
2801,7,9353,107654,107661,22
5757,71,9353,570555,570626,29
4465,253,9353,1044392,1044645,30
9357,81,9353,459432,459513,40
3459,180,9354,1422664,1422844,3
5318,24,9354,259265,259289,4
3992,274,9354,931159,931433,17
5533,179,9354,570554,570733,17
1959,7,9354,55735,55742,25
8391,223,9354,1148992,1149215,26
8656,257,9354,1306623,1306880,45
2947,3,9354,20528,20531,49
3585,11,9355,107728,107739,3
7656,150,9355,1149122,1149272,11
1511,185,9355,1149128,1149313,27
3269,40,9355,259347,259387,32
6499,280,9355,1306657,1306937,45
2522,256,9356,1149153,1149409,15
4752,7,9356,55769,55776,20
5810,234,9356,1237204,1237438,35
5461,41,9356,459631,459672,38
9902,71,9356,459628,459699,42
5099,64,9356,570807,570871,45
2768,209,9357,1441649,1441858,1
7529,248,9357,1465345,1465593,2
8823,194,9357,1044700,1044894,13
5162,260,9357,1306742,1307002,20
8892,158,9357,931552,931710,23
5437,25,9357,107798,107823,41
5225,206,9358,1149325,1149531,20
6907,73,9358,690661,690734,22
1058,270,9358,1237279,1237549,23
7584,260,9358,1237334,1237594,36
2312,133,9358,690677,690810,40
7682,187,9358,931640,931827,40
3034,85,9359,1044931,1045016,4
6934,242,9359,1422664,1422906,14
2941,43,9359,571028,571071,19
8737,253,9359,1358222,1358475,28
1321,214,9360,1455321,1455535,3
8832,194,9360,1441719,1441913,5
1127,298,9360,1358245,1358543,44
3892,79,9360,571060,571139,47
9217,232,9361,1306886,1307118,13
3538,84,9361,571101,571185,15
7655,185,9361,931817,932002,15
1368,42,9361,459964,460006,19
4309,64,9361,354879,354943,26
2386,87,9361,459943,460030,30
6707,268,9361,1237486,1237754,42
4779,170,9362,1237611,1237781,12
5026,136,9362,1045082,1045218,24
2841,171,9362,931924,932095,32
5995,252,9362,1237585,1237837,44
1886,286,9362,1358307,1358593,47
8072,251,9363,1455307,1455558,7
3556,224,9363,1422757,1422981,11
9337,108,9363,354985,355093,17
1477,81,9363,460087,460168,18
1312,164,9363,932048,932212,44
5328,252,9364,931997,932249,17
7101,237,9365,1149632,1149869,15
5291,189,9365,1237727,1237916,16
6954,139,9365,571306,571445,21
8431,148,9365,1149773,1149921,25
8955,162,9365,1045240,1045402,34
3377,69,9365,571419,571488,46
5308,31,9366,355199,355230,22
5066,99,9367,811592,811691,9
9507,40,9367,355220,355260,23
5175,159,9367,1149800,1149959,25
8652,23,9367,176955,176978,25
1738,178,9367,1045282,1045460,44
3576,6,9367,55991,55997,46
2448,165,9368,1307028,1307193,7
1313,36,9368,259906,259942,9
6115,59,9368,176974,177033,17
9339,94,9368,1045393,1045487,19
1817,264,9368,1237712,1237976,36
1929,66,9368,259920,259986,36
3610,74,9368,811711,811785,48
5568,207,9369,691134,691341,17
7524,247,9370,1441705,1441952,11
8034,199,9371,1307033,1307232,22
1271,30,9372,108150,108180,7
9987,94,9372,460354,460448,30
4463,265,9372,1237798,1238063,33
7728,154,9372,1149955,1150109,38
1240,131,9373,1149995,1150126,7
3786,234,9373,1237854,1238088,10
7248,34,9373,108202,108236,21
3062,42,9373,460473,460515,33
3350,241,9373,1237895,1238136,35
4997,206,9373,1150001,1150207,44
1116,77,9374,460502,460579,9
2569,23,9374,177163,177186,34
3571,33,9375,177171,177204,8
1631,69,9375,571669,571738,12
5336,3,9375,56124,56127,38
1599,82,9376,811852,811934,14
5928,211,9376,1237961,1238172,27
9534,39,9377,177202,177241,10
4507,76,9377,571710,571786,12
2982,246,9377,1237978,1238224,20
2823,213,9377,1238052,1238265,27
2584,191,9377,1238109,1238300,28
5072,44,9377,260144,260188,40
9264,65,9377,460617,460682,42
2504,103,9378,1150227,1150330,4
8770,224,9378,1238112,1238336,29
2830,143,9378,932573,932716,33
1966,252,9378,1307006,1307258,37
4681,33,9379,260210,260243,34
4967,89,9379,812028,812117,38
3669,174,9379,932603,932777,42
7339,176,9380,1307126,1307302,19
7246,55,9380,460727,460782,29
8644,266,9380,1358402,1358668,34
9552,111,9380,691624,691735,42
7783,76,9381,571901,571977,12
9008,172,9381,932699,932871,33
1178,83,9381,460779,460862,40
5532,151,9382,1358545,1358696,2
3616,280,9382,1470995,1471275,4
5811,238,9382,1238243,1238481,35
3780,175,9383,1307199,1307374,12
1571,136,9383,812174,812310,20
3418,190,9383,932775,932965,31
1009,30,9383,355738,355768,45
2871,61,9384,812283,812344,6
8206,157,9384,571951,572108,17
3751,211,9384,1150322,1150533,44
2835,57,9385,260379,260436,21
5263,30,9385,108447,108477,21
1207,196,9385,1045792,1045988,26
3500,189,9385,812260,812449,30
8951,37,9385,260438,260475,44
2259,8,9385,56281,56289,49
4437,31,9386,460988,461019,3
4119,108,9386,932921,933029,7
5100,37,9386,355829,355866,28
2658,47,9386,460994,461041,29
2764,284,9387,1422728,1423012,13
7583,205,9387,1238332,1238537,27
6613,222,9387,1307190,1307412,34
9465,73,9387,572159,572232,34
8454,123,9387,812423,812546,44
7979,166,9388,1307281,1307447,19
5586,23,9389,355927,355950,1
1186,10,9389,108554,108564,19
4543,278,9389,1358487,1358765,47
7074,121,9389,933034,933155,50
2761,223,9390,1455359,1455582,3
1051,16,9390,108567,108583,18
7594,14,9390,20808,20822,21
2156,153,9390,1150536,1150689,38
3155,188,9390,1307337,1307525,43
8403,192,9390,1307375,1307567,43
1769,10,9390,108589,108599,49
5475,170,9391,1046027,1046197,20
2783,19,9391,108598,108617,27
4346,292,9392,1358521,1358813,20
1846,107,9392,812619,812726,34
7785,285,9392,1396543,1396828,34
9209,147,9393,1046143,1046290,14
1989,283,9393,1238490,1238773,32
9452,208,9393,1046145,1046353,40
8573,124,9394,1307515,1307639,5
9207,122,9394,692154,692276,18
3279,229,9394,1238593,1238822,20
8343,168,9394,933252,933420,36
8398,219,9394,1238635,1238854,37
7424,230,9394,1358647,1358877,38
6424,234,9394,1046260,1046494,40
1549,141,9394,1150802,1150943,48
5257,109,9394,812874,812983,50
1673,251,9395,1238681,1238932,18
6096,299,9395,1455321,1455620,39
6753,176,9396,1307528,1307704,12
1470,44,9396,356184,356228,15
1155,203,9396,1046392,1046595,32
7552,274,9396,1358658,1358932,46
9358,111,9396,812986,813097,47
9177,183,9397,1422892,1423075,2
7217,145,9397,1046512,1046657,16
1208,147,9397,813013,813160,26
5596,236,9397,1150846,1151082,36
6781,41,9397,108750,108791,36
3489,160,9397,1046556,1046716,45
4856,87,9398,1046649,1046736,1
5674,223,9398,1238804,1239027,13
8166,275,9398,1441755,1442030,19
7474,279,9398,1150869,1151148,21
3683,78,9398,356308,356386,31
8743,225,9398,1150972,1151197,33
7521,208,9399,1151031,1151239,20
3398,224,9399,1151049,1151273,36
7110,104,9399,933772,933876,38
2449,292,9399,1441791,1442083,48
8674,218,9400,1455420,1455638,4
6743,22,9400,177900,177922,11
6134,145,9400,1046812,1046957,16
7895,151,9400,461563,461714,17
2642,229,9400,1238891,1239120,37
1249,268,9400,1396712,1396980,38
1653,67,9400,356454,356521,40
9054,33,9400,261019,261052,42
5399,100,9400,692726,692826,47
3997,291,9401,1465318,1465609,8
5107,150,9401,461669,461819,17
3468,141,9402,572830,572971,10
5891,48,9402,572937,572985,19
6761,112,9402,692740,692852,26
4585,223,9402,1238971,1239194,45
6996,271,9403,1358828,1359099,34
8070,207,9403,1307712,1307919,38
7817,60,9403,356609,356669,42
4964,188,9403,1239095,1239283,49
1247,150,9404,1151344,1151494,11
3516,222,9404,1151330,1151552,35
3936,258,9404,1396773,1397031,38
7845,261,9404,1396822,1397083,43
8324,113,9405,934020,934133,8
5017,171,9405,933990,934161,36
4303,1,9406,20959,20960,5
2606,129,9406,1151504,1151633,19
2934,103,9407,934082,934185,7
4049,131,9407,813549,813680,23
6519,193,9407,934026,934219,31
4625,151,9407,813582,813733,40
6410,223,9408,1239137,1239360,20
6531,129,9408,934144,934273,27
8065,294,9408,1307719,1308013,33
2919,238,9408,1422959,1423197,39
1273,263,9409,1307808,1308071,35
3102,122,9411,1307964,1308086,1
2444,272,9411,1471014,1471286,2
5749,45,9411,573249,573294,6
8725,68,9411,356828,356896,7
9479,26,9411,356877,356903,19
2925,157,9411,934244,934401,23
3934,295,9411,1307860,1308155,36
9439,65,9411,693205,693270,43
7235,174,9411,1047197,1047371,44
9579,277,9411,1358954,1359231,47
6467,223,9412,1455476,1455699,1
9475,123,9413,693220,693343,32
7697,247,9413,1239348,1239595,37
2525,252,9413,1307988,1308240,47
2189,43,9413,462219,462262,50
5468,177,9414,1047322,1047499,29
6126,142,9415,813901,814043,26
9028,57,9415,357004,357061,32
2591,248,9415,1239426,1239674,35
5525,185,9415,934419,934604,40
5875,29,9415,261479,261508,46
4793,238,9416,1423018,1423256,19
5554,242,9417,1308037,1308279,10
9893,271,9417,1359033,1359304,27
1832,264,9417,1308088,1308352,35
1863,177,9417,1047482,1047659,50
5128,176,9418,1423100,1423276,2
9684,219,9418,1423077,1423296,11
5901,291,9418,1047431,1047722,17
7755,156,9418,1151885,1152041,28
8238,233,9418,1239620,1239853,46
2565,202,9419,1441967,1442169,2
7131,294,9419,1359093,1359387,20
8627,128,9419,1047705,1047833,24
5721,215,9419,1151959,1152174,50
9966,124,9420,573616,573740,10
4285,239,9420,1441951,1442190,11
1465,101,9420,573697,573798,13
8467,92,9420,814295,814387,22
1968,97,9420,693657,693754,35
7588,297,9421,1471003,1471300,8
8554,252,9421,1423140,1423392,19
7540,219,9421,1308302,1308521,25
1176,298,9421,1308280,1308578,26
1145,245,9421,1308377,1308622,27
8807,214,9421,1152133,1152347,44
4052,148,9422,1359321,1359469,1
6241,87,9422,1047944,1048031,2
8302,117,9422,934919,935036,12
6796,232,9422,1397087,1397319,19
7109,296,9422,1152134,1152430,21
8567,68,9422,814507,814575,43
6924,158,9423,1397178,1397336,6
3613,53,9423,573942,573995,14
6705,190,9423,1359356,1359546,19
8959,189,9423,1047957,1048146,23
6172,200,9423,1239947,1240147,25
9764,33,9423,261803,261836,28
3274,94,9423,693907,694001,35
4610,283,9424,1465372,1465655,11
2659,5,9424,56889,56894,28
9875,2,9424,21086,21088,47
9904,264,9425,1455501,1455765,7
7222,53,9425,357467,357520,9
9585,112,9425,693953,694065,23
1616,84,9425,694004,694088,29
6526,236,9426,1442035,1442271,7
9088,129,9426,1048099,1048228,14
8212,91,9426,694042,694133,34
3128,16,9426,109440,109456,35
6756,234,9426,1152337,1152571,42
5049,51,9427,357556,357607,44
4697,198,9429,1240036,1240234,25
9110,133,9429,935132,935265,47
7330,267,9430,1471060,1471327,1
5300,165,9430,1152485,1152650,22
2463,76,9431,462873,462949,9
8318,153,9431,1152520,1152673,12
2226,237,9431,1152482,1152719,15
3026,193,9431,1359439,1359632,48
5012,14,9432,178751,178765,1
5097,249,9432,1465453,1465702,4
6194,205,9432,1442127,1442332,4
1645,273,9432,1397181,1397454,13
5774,114,9432,814799,814913,16
8913,51,9432,262004,262055,26
6060,140,9432,935294,935434,35
6936,200,9432,1048262,1048462,42
9220,231,9432,1359501,1359732,43
8293,133,9433,574252,574385,10
9488,191,9433,694253,694444,10
2613,53,9433,574383,574436,14
4195,270,9433,1240116,1240386,23
3817,128,9433,935407,935535,27
5648,75,9433,574418,574493,28
6053,14,9434,109574,109588,8
9428,211,9434,1397270,1397481,11
7677,274,9434,1455548,1455822,14
1568,295,9434,1308642,1308937,44
8671,169,9434,1048452,1048621,50
9248,71,9434,694491,694562,50
3947,209,9435,1397319,1397528,8
8427,120,9435,1152808,1152928,39
1219,109,9435,1048563,1048672,43
1758,176,9435,1152786,1152962,46
4375,275,9436,1397287,1397562,28
7233,37,9436,357901,357938,28
2647,8,9436,109636,109644,42
1793,13,9436,178937,178950,48
9404,182,9437,1240330,1240512,49
6720,74,9438,935659,935733,2
8706,266,9438,1240287,1240553,15
5884,35,9438,262233,262268,27
3151,93,9438,815145,815238,28
7040,239,9438,1152862,1153101,33
9991,71,9438,463282,463353,37
2980,152,9438,1240435,1240587,39
7482,280,9438,1308747,1309027,44
7811,155,9440,574573,574728,17
3369,215,9441,1308846,1309061,25
2412,95,9441,463337,463432,36
8353,95,9441,935782,935877,43
7788,295,9442,1474810,1475105,3
5284,298,9442,1474849,1475147,5
7963,75,9442,463409,463484,15
9795,229,9442,935721,935950,21
3546,105,9443,1153117,1153222,2
6610,18,9443,179076,179094,9
2165,240,9443,1423321,1423561,14
8352,11,9443,109755,109766,15
3675,228,9443,1240493,1240721,20
3191,229,9443,1359653,1359882,24
1226,103,9443,574760,574863,32
6863,178,9443,1153150,1153328,34
9618,120,9444,1240652,1240772,4
6643,201,9444,1397423,1397624,11
9396,164,9444,1048876,1049040,37
3022,181,9444,1359742,1359923,39
8994,192,9444,1309016,1309208,43
6893,272,9444,1359689,1359961,47
4536,200,9445,1442201,1442401,6
1094,275,9445,1465479,1465754,8
8041,180,9445,1359830,1360010,8
7403,248,9445,1359799,1360047,25
7140,169,9445,1049022,1049191,47
8557,265,9445,1359813,1360078,47
5874,239,9446,1359878,1360117,22
7908,179,9446,1153384,1153563,34
9221,242,9446,1049050,1049292,41
5551,256,9447,1049100,1049356,30
9007,11,9447,109875,109886,38
2145,243,9447,1309157,1309400,47
6233,83,9448,1049312,1049395,2
8289,250,9448,1397428,1397678,16
3283,136,9448,695075,695211,40
7446,205,9448,1153458,1153663,50
2451,116,9449,1240933,1241049,1
3254,26,9449,358401,358427,14
8477,280,9449,1442178,1442458,48
8085,150,9450,1049364,1049514,28
3515,112,9450,815754,815866,47
1759,249,9451,1442227,1442476,14
4648,91,9451,695219,695310,47
3040,115,9452,1240989,1241104,1
8985,146,9452,1153609,1153755,8
7861,22,9452,262699,262721,22
8162,235,9452,1359968,1360203,24
8052,138,9452,936403,936541,34
4374,181,9452,1049442,1049623,35
3859,260,9452,1397497,1397757,38
7419,266,9453,1423425,1423691,19
3512,20,9453,262749,262769,50
2065,56,9454,463954,464010,29
6000,138,9454,695295,695433,36
1722,256,9454,1309315,1309571,37
3504,99,9454,815917,816016,46
8665,2,9455,21258,21260,4
4403,214,9455,1309407,1309621,38
5714,226,9455,1153683,1153909,42
5096,271,9456,1471111,1471382,5
5827,224,9456,1423511,1423735,8
5111,163,9456,1309503,1309666,9
3054,239,9456,1309449,1309688,13
8127,38,9456,464112,464150,19
5611,102,9456,936635,936737,25
8604,46,9456,358654,358700,28
2137,227,9456,1241101,1241328,45
9451,4,9457,21272,21276,20
6812,41,9457,179458,179499,30
6108,287,9457,1309439,1309726,42
7269,121,9458,936692,936813,11
4075,61,9458,464158,464219,13
6758,111,9458,816112,816223,16
6612,129,9458,816130,816259,23
9589,89,9458,816186,816275,49
1019,257,9459,1241141,1241398,23
3185,200,9459,1241228,1241428,34
4885,275,9459,1309483,1309758,36
9164,221,9459,1360091,1360312,38
7397,73,9460,575552,575625,29
3075,226,9460,1309590,1309816,34
8897,9,9460,110117,110126,42
4666,5,9460,57339,57344,49
7124,36,9461,464313,464349,6
5132,241,9461,1153938,1154179,31
1064,154,9462,1360187,1360341,3
4480,2,9462,21315,21317,15
6124,192,9462,1049852,1050044,23
8379,40,9463,575654,575694,2
1043,10,9463,110146,110156,16
4544,71,9463,575641,575712,23
9481,26,9463,263044,263070,24
4094,27,9463,57359,57386,31
4386,104,9463,1049958,1050062,48
2038,242,9464,1465541,1465783,4
7597,106,9464,816374,816480,16
2590,156,9464,936887,937043,23
9661,258,9465,1360122,1360380,13
1592,180,9465,1154076,1154256,16
7000,114,9465,695827,695941,37
6266,171,9465,695815,695986,41
7266,172,9466,1423589,1423761,2
7805,231,9466,1154084,1154315,26
1364,12,9466,57416,57428,40
9884,128,9467,1050051,1050179,9
1730,281,9467,1360160,1360441,47
2425,170,9468,937011,937181,36
3550,80,9468,575854,575934,47
3349,116,9469,1241482,1241598,4
7751,99,9469,1154269,1154368,5
2769,118,9469,1050124,1050242,7
5672,175,9469,937104,937279,33
6592,67,9469,464599,464666,47
4650,17,9469,263237,263254,48
2780,242,9470,1309671,1309913,10
7023,164,9470,937158,937322,15
6319,25,9470,179774,179799,27
6204,223,9470,1154213,1154436,44
3452,261,9470,1397607,1397868,49
9870,233,9470,1241452,1241685,50
1664,173,9471,1360310,1360483,7
9980,60,9471,359150,359210,26
3086,186,9471,1050206,1050392,35
4315,274,9471,1154265,1154539,41
8592,7,9472,57509,57516,6
6450,111,9472,937365,937476,7
3736,55,9472,359216,359271,8
9709,102,9472,576055,576157,42
5947,108,9472,1050337,1050445,43
5278,234,9473,1442279,1442513,8
7906,210,9473,1309781,1309991,16
9259,94,9473,696267,696361,16
9590,208,9473,1309810,1310018,28
9235,45,9473,464843,464888,33
4425,2,9474,21404,21406,32
6708,148,9474,816801,816949,32
2318,174,9474,1050361,1050535,35
4127,256,9474,1397661,1397917,38
6146,234,9474,1360347,1360581,43
3065,182,9474,1154487,1154669,47
6524,101,9475,1154589,1154690,2
9605,71,9475,576238,576309,11
8043,248,9475,1397690,1397938,16
8300,61,9476,464941,465002,9
9348,113,9476,937567,937680,22
4899,51,9476,359422,359473,27
2032,165,9476,1050495,1050660,47
3017,2,9478,21420,21422,1
7472,113,9478,1241736,1241849,5
6790,293,9478,1360320,1360613,15
4981,272,9478,1309883,1310155,18
3953,176,9478,1050582,1050758,33
4163,117,9479,696513,696630,18
1905,120,9479,817084,817204,20
6898,81,9479,359498,359579,21
3704,183,9480,1241761,1241944,22
3761,124,9480,937712,937836,27
9547,102,9480,696630,696732,33
6363,62,9480,359568,359630,37
6902,72,9480,465097,465169,42
3927,297,9480,1360354,1360651,45
8826,204,9480,1154678,1154882,45
4880,76,9481,465134,465210,32
8602,231,9481,937716,937947,41
3643,54,9482,696756,696810,6
4694,243,9482,1397705,1397948,16
2009,34,9482,465225,465259,19
3533,117,9482,817246,817363,29
7550,61,9482,263687,263748,31
9519,102,9482,465192,465294,41
5896,224,9482,1241812,1242036,45
5222,255,9483,1465551,1465806,5
3371,252,9483,1241856,1242108,20
2346,258,9483,1310024,1310282,27
8719,286,9483,1397716,1398002,34
2674,41,9483,180206,180247,40
4383,158,9483,937956,938114,44
4500,204,9484,1397814,1398018,12
6352,238,9484,1050780,1051018,41
2019,174,9485,1423624,1423798,2
1414,35,9485,359826,359861,25
4562,209,9485,1050846,1051055,31
6055,5,9486,21496,21501,11
6402,125,9486,938093,938218,27
5361,69,9486,817512,817581,48
1406,242,9487,1465590,1465832,3
4101,263,9487,938014,938277,17
5436,261,9487,1310148,1310409,27
3611,282,9487,1242016,1242298,33
7143,93,9487,697073,697166,33
4802,96,9487,697087,697183,44
5763,158,9488,1155007,1155165,24
9867,70,9488,359925,359995,30
9947,224,9488,1050975,1051199,32
1932,202,9488,1051033,1051235,36
8044,285,9488,1423572,1423857,43
5769,140,9489,1155062,1155202,11
5516,226,9489,1242122,1242348,18
8101,218,9490,1155035,1155253,36
9276,88,9491,576870,576958,15
2210,15,9492,264032,264047,1
6700,283,9492,1474839,1475122,4
8869,142,9492,576878,577020,10
1808,50,9492,465631,465681,16
5015,136,9492,938379,938515,16
5207,38,9492,264058,264096,18
7645,256,9492,1423664,1423920,19
5371,207,9492,1310307,1310514,38
8313,230,9492,1051178,1051408,40
3255,255,9492,1242209,1242464,44
7169,172,9493,1051297,1051469,20
5339,242,9493,1155154,1155396,23
6306,175,9493,1242327,1242502,38
8597,243,9493,1423708,1423951,48
9040,219,9494,1455732,1455951,1
5321,145,9494,1242409,1242554,7
2230,212,9494,1397985,1398197,8
5325,56,9494,465777,465833,11
7039,62,9494,180546,180608,17
6711,128,9494,938612,938740,34
5238,71,9494,360210,360281,36
4002,53,9494,577143,577196,38
9810,78,9495,577136,577214,9
3042,242,9495,1360670,1360912,22
8116,189,9495,1051443,1051632,23
9258,80,9495,465857,465937,42
3252,171,9496,1398058,1398229,2
1233,161,9496,1398091,1398252,3
7469,11,9496,110908,110919,4
4215,292,9496,1423696,1423988,10
7079,112,9496,697513,697625,15
4791,28,9496,57917,57945,17
9309,30,9496,180674,180704,18
2931,26,9496,264292,264318,22
9511,63,9496,577270,577333,29
3887,139,9496,697528,697667,30
4413,6,9496,21604,21610,36
6331,272,9496,1360725,1360997,47
5717,281,9497,1474864,1475145,1
1375,183,9497,1360850,1361033,9
6007,205,9497,1310517,1310722,22
2971,191,9497,938740,938931,32
9723,78,9497,577371,577449,34
9316,219,9497,1155426,1155645,42
4567,230,9498,1242502,1242732,10
5129,295,9498,1398038,1398333,25
5089,62,9498,264386,264448,36
6964,146,9498,1051676,1051822,46
8881,245,9499,1465648,1465893,6
5083,268,9499,1398120,1398388,49
8132,218,9499,1310619,1310837,49
7153,45,9500,264449,264494,7
6041,147,9500,1155616,1155763,11
9907,54,9501,360524,360578,8
2096,261,9501,1242600,1242861,15
2143,66,9501,577544,577610,28
2706,173,9501,938983,939156,33
4078,210,9501,1155631,1155841,35
4513,281,9502,1474886,1475167,2
3555,44,9502,264523,264567,26
7907,51,9502,180873,180924,36
8800,132,9503,939093,939225,16
3088,20,9503,58051,58071,30
7885,142,9503,697865,698007,31
5787,183,9503,818256,818439,41
8744,132,9503,939126,939258,46
1820,3,9503,58090,58093,48
5641,28,9504,264602,264630,15
8523,122,9504,1155750,1155872,39
4644,245,9504,1242688,1242933,50
1335,270,9505,1398146,1398416,10
2261,67,9505,577725,577792,29
5345,294,9505,1398168,1398462,34
8977,183,9505,1155793,1155976,34
9159,211,9505,1155817,1156028,37
5204,110,9505,698081,698191,44
7662,87,9506,1052008,1052095,6
2524,136,9506,1051993,1052129,22
9455,60,9506,577834,577894,38
7385,231,9506,1242774,1243005,44
1185,92,9507,698180,698272,33
6104,196,9507,1361006,1361202,39
2628,146,9507,1052052,1052198,46
2929,211,9508,1442437,1442648,5
1229,7,9508,111210,111217,24
5798,188,9508,1155925,1156113,37
8301,57,9509,818608,818665,3
7884,166,9509,1398336,1398502,5
8404,26,9509,181091,181117,8
2542,4,9509,21706,21710,12
9487,271,9509,1423804,1424075,16
4238,99,9509,577916,578015,30
8574,45,9509,181106,181151,36
6521,80,9509,698307,698387,45
9241,203,9510,1361076,1361279,12
1322,220,9510,1052096,1052316,31
1757,250,9510,1155984,1156234,33
7158,245,9510,1242897,1243142,45
2184,114,9510,818699,818813,47
8466,239,9511,1465687,1465926,4
9778,30,9511,111289,111319,10
8699,225,9511,1242983,1243208,27
8593,243,9511,1361093,1361336,49
1629,245,9512,1442446,1442691,11
9693,249,9512,1361140,1361389,25
7617,37,9512,264875,264912,44
6258,153,9513,1156256,1156409,38
7015,94,9513,939644,939738,43
2097,137,9513,939639,939776,46
3295,106,9514,1243184,1243290,1
1715,107,9514,818861,818968,12
4991,5,9514,58252,58257,23
1034,30,9515,264930,264960,9
8475,153,9515,698502,698655,21
4046,255,9515,1310839,1311094,29
8228,230,9515,1052334,1052564,30
9083,224,9515,1243130,1243354,45
2250,52,9516,698680,698732,4
2994,8,9516,111399,111407,6
9314,298,9516,1471122,1471420,7
1359,141,9516,1052505,1052646,14
2164,64,9516,578273,578337,29
3541,260,9516,1052455,1052715,30
9508,51,9516,466822,466873,50
1655,62,9517,466835,466897,20
9503,14,9517,21798,21812,21
6393,182,9517,1156344,1156526,34
2516,267,9517,1310884,1311151,35
4717,98,9517,466855,466953,36
8533,105,9517,698739,698844,42
4212,102,9518,939890,939992,7
8420,46,9518,466944,466990,16
8402,295,9518,1423870,1424165,38
8016,183,9519,1052630,1052813,23
4998,256,9519,1243209,1243465,26
2732,296,9519,1310913,1311209,31
1584,294,9519,1310961,1311255,42
6702,148,9519,940002,940150,47
3826,218,9520,1455835,1456053,1
8495,12,9520,58361,58373,7
3837,201,9520,1052744,1052945,15
6225,87,9520,698931,699018,27
6663,159,9520,1243415,1243574,48
1684,56,9521,698987,699043,4
6063,95,9521,467057,467152,31
9969,232,9521,1243380,1243612,35
1468,171,9521,698939,699110,41
2378,29,9522,265247,265276,20
7063,188,9522,1052829,1053017,26
7901,290,9522,1156495,1156785,30
9770,72,9522,819361,819433,39
5243,137,9522,578556,578693,41
4563,218,9522,1156598,1156816,42
1641,256,9522,1423968,1424224,48
8430,39,9523,467253,467292,4
9512,68,9523,699144,699212,22
4531,134,9523,1053000,1053134,25
3135,34,9523,111611,111645,36
3783,194,9523,1311124,1311318,38
1135,176,9523,699112,699288,41
9510,206,9524,1398450,1398656,9
5443,251,9524,1361269,1361520,28
8222,134,9524,940286,940420,29
9509,31,9524,361561,361592,38
3623,53,9524,361565,361618,47
1800,147,9524,940328,940475,50
1632,147,9525,1361396,1361543,5
3194,125,9525,940385,940510,27
6950,45,9525,265435,265480,32
2461,288,9525,1311131,1311419,36
4090,131,9526,1053116,1053247,22
4558,63,9527,699353,699416,19
1502,274,9527,1311194,1311468,20
9803,237,9527,1361344,1361581,24
7295,269,9527,1243578,1243847,26
1328,10,9527,21925,21935,30
4345,292,9527,1361343,1361635,46
1970,300,9528,1471131,1471431,11
5765,233,9528,1243693,1243926,18
7309,173,9528,1156929,1157102,27
9085,37,9528,265560,265597,34
1045,124,9528,940591,940715,46
1153,253,9528,1311343,1311596,46
5695,71,9528,578977,579048,46
5144,199,9529,1442558,1442757,3
2081,265,9529,1455832,1456097,8
5429,23,9529,181794,181817,11
5267,111,9529,819747,819858,16
4362,64,9529,467578,467642,23
5916,98,9529,579001,579099,26
2996,219,9529,1053276,1053495,32
3800,180,9529,940637,940817,40
3692,185,9530,1424114,1424299,5
1444,75,9530,467654,467729,44
5348,282,9530,1398489,1398771,49
8194,168,9531,1398634,1398802,1
4018,284,9531,1398562,1398846,28
6940,206,9531,1157062,1157268,35
6986,211,9531,1157104,1157315,35
2751,257,9531,1243846,1244103,36
2457,240,9531,1361581,1361821,38
6090,297,9531,1157127,1157424,41
4457,186,9532,1361667,1361853,19
6097,29,9532,361981,362010,45
8108,148,9533,1157321,1157469,25
6505,192,9533,1157318,1157510,50
9464,9,9534,111903,111912,1
4781,273,9534,1471190,1471463,6
7762,194,9534,1244013,1244207,25
9405,158,9534,1157418,1157576,28
5334,37,9535,181963,182000,26
4551,292,9535,1243976,1244268,32
3697,293,9535,1455855,1456148,39
2614,293,9535,1244049,1244342,40
2759,70,9535,579323,579393,46
8030,282,9535,1361653,1361935,47
2491,43,9536,579376,579419,4
6321,287,9536,1311571,1311858,26
8157,29,9536,265895,265924,29
9286,178,9536,941065,941243,36
1316,48,9536,362122,362170,46
8202,104,9537,1157626,1157730,3
9734,29,9537,182070,182099,37
8224,276,9538,1471226,1471502,3
8384,224,9538,1455970,1456194,4
1458,237,9538,1311669,1311906,13
3012,240,9538,1361757,1361997,28
3134,31,9538,362194,362225,33
5681,3,9538,58705,58708,33
9324,121,9539,820263,820384,23
3276,104,9539,579441,579545,36
9887,262,9539,1157586,1157848,40
3977,278,9539,1424129,1424407,43
7113,178,9539,1053933,1054111,45
6486,60,9539,579549,579609,50
7320,181,9540,1424253,1424434,1
4201,120,9540,941309,941429,16
8270,256,9540,1244283,1244539,36
6221,204,9541,1361863,1362067,14
5904,260,9541,1244340,1244600,26
9387,194,9541,1244444,1244638,28
9453,230,9541,1157793,1158023,36
9408,4,9541,22056,22060,37
1651,228,9541,1361876,1362104,38
6058,138,9542,1157927,1158065,8
8773,154,9542,700133,700287,21
7889,103,9542,941483,941586,24
4001,94,9542,820536,820630,28
8822,102,9542,820565,820667,50
7362,231,9543,1455997,1456228,3
1119,93,9543,579731,579824,15
4462,211,9543,1311843,1312054,16
2398,211,9543,1157925,1158136,18
9353,80,9543,700319,700399,22
5503,199,9543,1157977,1158176,29
1010,23,9543,58797,58820,31
8039,152,9543,941555,941707,33
6377,186,9543,1054213,1054399,35
8009,287,9543,1442644,1442931,39
8704,211,9544,1398809,1399020,12
3560,218,9544,1311919,1312137,24
8031,177,9544,820718,820895,30
6448,227,9544,1311942,1312169,34
4873,27,9544,266266,266293,38
4418,122,9545,1054369,1054491,24
6054,99,9546,1158168,1158267,3
4794,178,9546,941697,941875,13
8063,138,9546,579925,580063,21
9753,205,9546,941718,941923,30
3244,138,9547,941816,941954,29
4716,79,9547,580034,580113,44
7539,288,9547,1311944,1312232,45
6327,221,9548,1456028,1456249,4
3332,13,9548,58877,58890,7
9077,202,9548,1312078,1312280,24
3476,135,9548,580052,580187,31
5484,201,9549,1361994,1362195,12
6830,103,9549,700629,700732,23
4857,268,9549,1158118,1158386,30
7174,14,9549,112286,112300,49
5887,193,9550,1442770,1442963,3
5692,196,9550,700614,700810,17
6751,81,9550,468625,468706,18
1838,54,9550,266422,266476,21
9816,70,9550,580222,580292,28
8284,159,9550,1312172,1312331,39
5357,95,9550,362739,362834,41
1644,106,9550,1054551,1054657,43
1381,118,9550,942017,942135,49
4226,280,9551,1455998,1456278,14
6302,47,9551,362831,362878,20
2551,94,9551,362824,362918,21
6417,193,9551,1158295,1158488,27
4491,72,9552,580283,580355,7
4600,210,9552,1158312,1158522,18
8939,150,9552,821118,821268,18
1976,208,9552,1398887,1399095,39
5084,6,9553,59001,59007,3
8646,70,9553,821225,821295,39
8147,282,9553,1158300,1158582,41
8941,188,9554,1424364,1424552,2
2740,3,9554,22203,22206,27
3446,91,9554,700914,701005,29
1093,95,9554,580397,580492,44
6478,24,9555,182651,182675,11
1224,215,9555,1054623,1054838,13
1663,12,9555,112449,112461,15
5557,157,9555,821253,821410,15
4320,177,9555,1158455,1158632,16
3954,206,9555,1158457,1158663,18
1076,161,9555,942178,942339,26
6388,260,9556,1471253,1471513,1
2723,84,9556,1054826,1054910,3
7133,154,9556,1362150,1362304,5
6182,14,9556,59058,59072,10
2069,179,9556,1244822,1245001,22
1818,204,9556,1158553,1158757,37
9923,127,9556,701068,701195,40
1008,87,9557,1054899,1054986,5
5968,51,9557,363133,363184,9
5683,245,9557,1362104,1362349,22
9540,91,9557,942369,942460,39
7640,189,9557,1054849,1055038,42
9564,260,9557,1398895,1399155,49
4837,202,9558,1244888,1245090,16
1198,272,9558,1312239,1312511,29
2447,258,9558,1312289,1312547,45
4040,159,9558,1055017,1055176,50
4855,220,9559,1398959,1399179,14
3367,158,9559,942519,942677,33
5127,244,9559,1244982,1245226,50
4371,125,9560,580718,580843,10
3462,231,9560,1312375,1312606,16
2253,102,9560,580786,580888,18
4571,145,9560,821692,821837,18
6383,146,9560,1055138,1055284,28
9996,292,9561,1456032,1456324,39
4286,151,9561,1055178,1055329,50
9097,67,9562,580890,580957,12
7561,196,9562,1055179,1055375,23
7730,56,9563,580938,580994,14
9932,180,9563,580869,581049,17
8096,205,9563,821770,821975,21
5962,181,9563,1055242,1055423,29
6554,32,9563,266967,266999,49
2766,93,9564,1158896,1158989,3
8243,250,9564,1055243,1055493,30
4635,143,9564,821919,822062,36
4419,203,9565,1158823,1159026,20
2747,35,9565,112663,112698,30
3444,110,9565,581075,581185,32
8833,2,9565,22299,22301,35
2893,122,9565,1158925,1159047,39
1456,121,9565,822004,822125,44
5170,75,9565,469392,469467,44
9741,35,9566,469443,469478,3
5640,5,9566,59235,59240,19
3213,16,9566,183016,183032,22
5994,244,9566,1158870,1159114,33
8983,31,9566,363541,363572,33
9175,218,9567,1424384,1424602,11
7392,235,9567,1424398,1424633,12
6003,123,9567,701615,701738,13
5023,291,9567,1158896,1159187,21
2108,38,9567,363605,363643,22
8135,264,9567,1245073,1245337,23
8516,42,9568,581283,581325,2
2503,181,9568,1362280,1362461,7
5957,266,9568,1465729,1465995,7
5319,12,9568,183105,183117,24
5007,248,9568,1312461,1312709,29
4180,89,9568,701777,701866,33
6828,291,9568,1362223,1362514,35
5062,62,9569,581344,581406,25
8400,141,9569,822200,822341,26
6684,49,9569,267192,267241,37
8510,150,9569,1245297,1245447,43
7062,109,9569,1055666,1055775,48
9506,230,9570,1456140,1456370,4
1543,159,9570,1159212,1159371,14
2639,190,9571,701803,701993,17
6482,183,9571,1055659,1055842,23
3824,286,9571,1312511,1312797,26
7436,280,9571,1362293,1362573,47
7328,105,9571,1055806,1055911,48
4514,253,9572,1362335,1362588,10
3492,38,9572,183221,183259,37
9873,207,9572,1245346,1245553,47
6071,128,9573,702043,702171,13
8338,94,9573,822446,822540,24
1580,200,9573,1055786,1055986,26
3722,48,9573,363873,363921,35
3171,14,9574,59369,59383,10
6455,166,9574,943188,943354,13
8504,108,9574,581594,581702,30
9935,45,9574,267383,267428,32
5430,64,9574,469842,469906,47
6818,223,9575,1424462,1424685,11
1601,29,9575,267430,267459,25
7444,136,9575,1245446,1245582,39
4447,39,9575,183328,183367,40
6216,109,9575,702175,702284,44
7691,15,9576,183369,183384,9
1242,240,9576,1312627,1312867,10
5971,274,9576,1245371,1245645,15
6372,66,9576,267461,267527,21
4735,113,9576,702277,702390,23
8924,272,9576,1312651,1312923,29
9906,206,9576,1055912,1056118,32
5700,93,9576,943395,943488,38
2523,264,9577,1471256,1471520,4
5604,122,9577,1056021,1056143,9
2876,33,9577,267560,267593,12
6212,138,9577,1056026,1056164,12
5244,153,9577,1312807,1312960,19
5253,192,9577,1056041,1056233,20
5972,23,9577,113045,113068,41
4185,61,9578,822746,822807,3
2406,18,9578,183479,183497,6
1448,273,9578,1312736,1313009,35
7156,283,9578,1442836,1443119,39
4062,2,9579,22434,22436,13
1963,286,9579,1399079,1399365,24
7037,172,9579,943492,943664,42
4451,266,9579,1399156,1399422,43
7880,252,9579,1424514,1424766,48
1822,11,9580,59500,59511,10
3031,204,9580,1159540,1159744,45
8958,45,9581,364157,364202,23
8274,131,9581,581921,582052,41
2323,144,9582,1362594,1362738,2
3543,174,9582,1362583,1362757,7
2641,181,9582,943611,943792,26
6901,53,9582,364225,364278,27
8312,126,9582,581983,582109,41
1159,259,9583,1362545,1362804,25
9250,156,9583,943703,943859,29
4272,56,9583,267728,267784,36
7022,137,9583,943760,943897,46
3756,19,9584,267781,267800,3
6165,164,9584,1399302,1399466,4
1810,49,9584,364306,364355,9
2338,294,9584,1465748,1466042,9
7449,141,9584,582089,582230,10
3386,168,9584,1313057,1313225,39
4381,173,9584,1313089,1313262,39
4780,164,9585,1399344,1399508,3
4469,179,9585,1159722,1159901,27
3107,257,9585,1424567,1424824,48
5951,232,9586,1456201,1456433,5
9004,65,9586,364387,364452,8
2094,289,9586,1245765,1246054,15
1337,163,9586,943919,944082,20
7081,143,9586,582228,582371,21
9859,66,9586,702794,702860,39
7657,54,9586,582341,582395,50
8912,239,9587,1442942,1443181,7
8368,191,9587,1362740,1362931,9
3431,282,9587,1399313,1399595,10
4561,289,9587,1465771,1466060,14
7813,67,9587,470465,470532,27
1849,98,9588,1159949,1160047,1
2936,71,9588,582424,582495,28
5025,207,9589,1399432,1399639,19
4800,221,9589,1313219,1313440,22
8458,160,9589,1159970,1160130,24
4790,89,9589,582464,582553,42
4587,297,9590,1474826,1475123,1
1772,189,9590,1362835,1363024,11
4225,108,9590,823222,823330,11
3296,300,9590,1465801,1466101,19
3544,267,9590,1245982,1246249,23
2315,268,9590,1246037,1246305,26
4251,265,9590,1399475,1399740,43
3009,109,9590,703005,703114,44
6652,63,9590,582612,582675,49
9728,1,9591,22530,22531,5
3742,163,9591,1313372,1313535,9
1773,188,9591,1056650,1056838,18
4557,271,9591,1399519,1399790,38
5684,47,9591,470716,470763,50
7210,66,9592,470719,470785,15
2807,28,9592,268147,268175,16
6706,41,9592,364757,364798,20
1841,141,9592,1056753,1056894,22
4084,40,9592,268169,268209,27
4405,195,9592,944223,944418,32
9920,274,9592,1399569,1399843,38
2074,227,9593,1456296,1456523,1
6892,219,9593,1313419,1313638,16
5627,76,9593,470790,470866,37
8040,150,9593,1160242,1160392,38
8064,205,9593,1056805,1057010,42
1538,220,9594,1456328,1456548,6
2975,270,9594,1471290,1471560,6
4994,30,9594,268266,268296,13
8092,33,9594,183999,184032,26
4196,138,9594,1160314,1160452,43
8295,133,9595,1313559,1313692,3
5961,239,9595,1362982,1363221,22
3168,148,9595,703202,703350,31
4951,74,9596,944517,944591,4
7532,61,9596,470919,470980,12
3918,227,9596,1160296,1160523,15
2560,241,9596,1363021,1363262,22
1741,89,9596,470955,471044,32
1491,123,9596,823596,823719,34
1023,115,9596,1057049,1057164,39
9591,12,9597,59783,59795,7
4952,243,9597,1363062,1363305,22
9558,25,9597,268382,268407,23
9237,257,9597,1443060,1443317,39
5051,152,9598,1246430,1246582,9
5230,26,9598,113520,113546,21
1235,125,9598,944599,944724,27
2193,26,9598,268418,268444,28
5438,169,9598,944582,944751,32
5652,140,9598,944636,944776,37
2983,218,9599,1456371,1456589,3
3337,18,9599,268459,268477,14
2331,200,9599,1057062,1057262,15
2622,143,9599,944703,944846,20
4859,214,9599,1160452,1160666,29
5764,145,9599,944763,944908,33
6509,295,9599,1363083,1363378,45
1847,125,9600,944832,944957,34
3785,293,9600,1363139,1363432,46
7308,85,9601,583089,583174,9
7835,48,9601,583140,583188,19
5247,186,9601,1246519,1246705,24
9312,2,9601,22617,22619,34
8662,22,9601,268550,268572,48
1834,83,9601,703613,703696,49
7365,173,9602,1424853,1425026,3
3316,75,9602,944947,945022,5
9729,239,9603,1465895,1466134,6
3739,135,9603,1057270,1057405,11
1113,184,9603,703584,703768,17
5080,166,9603,1313757,1313923,48
7925,195,9603,1160639,1160834,50
8784,153,9604,1363337,1363490,5
8850,237,9604,823934,824171,17
7452,155,9604,944992,945147,29
4643,211,9604,1160682,1160893,35
3078,55,9604,184311,184366,36
8077,270,9604,1313716,1313986,50
2637,31,9605,365309,365340,48
3123,287,9605,1443109,1443396,48
8615,80,9606,583332,583412,47
6651,122,9606,1160840,1160962,48
2883,40,9606,471438,471478,50
3149,255,9607,1443177,1443432,11
7547,206,9607,1399809,1400015,12
2490,119,9607,1057480,1057599,24
9376,15,9607,113735,113750,29
9361,98,9607,945201,945299,38
4919,116,9607,824255,824371,46
8889,292,9608,1465873,1466165,11
3552,262,9608,1363335,1363597,34
3931,216,9609,1456429,1456645,1
7559,38,9609,113755,113793,17
9021,172,9609,945204,945376,26
3268,77,9609,268765,268842,41
2270,36,9610,365445,365481,23
8877,130,9610,1057544,1057674,24
3163,10,9610,184481,184491,33
4845,167,9610,945284,945451,33
5022,231,9611,1456448,1456679,4
8998,246,9611,1443268,1443514,11
2100,164,9611,1160926,1161090,28
4295,251,9611,1160881,1161132,31
3441,119,9611,824450,824569,37
6129,189,9611,1363487,1363676,39
1985,88,9612,471621,471709,32
4421,299,9612,1313886,1314185,42
9102,102,9612,824542,824644,50
1466,140,9613,824539,824679,15
9730,179,9613,1246830,1247009,24
7386,78,9613,583652,583730,46
9899,274,9613,1443274,1443548,48
8916,154,9614,1363570,1363724,4
8048,156,9614,1399963,1400119,5
9234,175,9614,1314087,1314262,8
2689,142,9614,1161132,1161274,11
9930,264,9614,1424969,1425233,19
6355,110,9614,583707,583817,30
8286,8,9614,22712,22720,30
4341,100,9614,583754,583854,42
9093,150,9615,1363641,1363791,5
9197,212,9615,1443372,1443584,5
7468,232,9615,1443371,1443603,9
4110,228,9615,1161146,1161374,26
4108,199,9616,1363644,1363843,14
8867,122,9616,583820,583942,21
9572,282,9616,1399932,1400214,34
5181,123,9616,704268,704391,36
9238,121,9616,1161320,1161441,39
8444,147,9616,1161338,1161485,43
3755,258,9617,1471305,1471563,2
2101,288,9617,1471297,1471585,7
2635,46,9617,365822,365868,15
8363,237,9617,824721,824958,17
1946,81,9617,704401,704482,28
3320,37,9617,365880,365917,29
5701,116,9617,583962,584078,36
6271,78,9617,824906,824984,43
3828,110,9619,1057961,1058071,39
3491,218,9619,1363721,1363939,43
2836,17,9619,184783,184800,45
3587,226,9620,1314251,1314477,22
9031,162,9620,945722,945884,23
6066,225,9620,1425100,1425325,39
8636,15,9620,184812,184827,48
3292,206,9621,1443462,1443668,3
1253,154,9621,1363850,1364004,6
7334,31,9621,365972,366003,48
8190,265,9622,1471349,1471614,1
3351,186,9622,1425202,1425388,6
5713,234,9622,1456534,1456768,6
8607,112,9622,704538,704650,23
5894,268,9622,1443480,1443748,39
6889,81,9622,825077,825158,43
7875,89,9623,945901,945990,19
1879,106,9623,704619,704725,20
5076,297,9623,1425171,1425468,24
1671,48,9624,704701,704749,1
9343,282,9624,1456518,1456800,14
7606,41,9624,269308,269349,18
4789,247,9624,1363920,1364167,24
7709,169,9624,1058121,1058290,44
5830,212,9624,1247233,1247445,47
6166,78,9625,1058247,1058325,1
8073,161,9625,1247311,1247472,9
7086,9,9625,114143,114152,12
7430,264,9625,1425241,1425505,16
5882,232,9625,1247315,1247547,47
4928,161,9626,1400280,1400441,3
7932,149,9626,1364075,1364224,3
9174,152,9626,704771,704923,31
8126,42,9627,584377,584419,3
7234,44,9627,184943,184987,36
7329,298,9628,1400193,1400491,25
5490,272,9628,1314527,1314799,29
2851,20,9628,60262,60282,30
7754,106,9628,704872,704978,37
6439,223,9628,1364066,1364289,38
5226,168,9629,584346,584514,17
3119,279,9629,1247443,1247722,23
9260,4,9629,60305,60309,48
8853,246,9630,1465994,1466240,3
6023,289,9630,1058261,1058550,17
1060,61,9630,366260,366321,37
8899,109,9630,946231,946340,38
4494,84,9630,705003,705087,49
5809,173,9631,1400364,1400537,4
5223,268,9631,1456581,1456849,9
3961,244,9631,1443574,1443818,12
2040,24,9631,185092,185116,32
1472,53,9631,472495,472548,46
9204,45,9632,366349,366394,11
5472,167,9632,1161864,1162031,14
3840,152,9632,825395,825547,36
9624,170,9633,1314735,1314905,9
6094,91,9633,705095,705186,11
3869,58,9633,269603,269661,21
7634,263,9633,1314689,1314952,29
6815,159,9633,825460,825619,40
7494,254,9633,1314745,1314999,47
4003,266,9634,1456605,1456871,12
9532,260,9634,1247641,1247901,23
7466,195,9634,1247761,1247956,24
7858,31,9634,269701,269732,28
3170,55,9635,472647,472702,47
4626,35,9635,269726,269761,47
7837,230,9636,1456675,1456905,6
4161,47,9636,185219,185266,30
4924,110,9636,584714,584824,30
1467,223,9636,1314831,1315054,34
7635,266,9636,1443626,1443892,39
4404,5,9636,60433,60438,45
6813,52,9636,472711,472763,49
1668,69,9637,825688,825757,6
4088,36,9637,366557,366593,22
9111,37,9637,269796,269833,27
4439,178,9637,946421,946599,32
5391,129,9637,1162111,1162240,43
6458,82,9638,1058728,1058810,3
5120,255,9638,1314852,1315107,37
7680,175,9638,1058711,1058886,45
1283,212,9639,1400442,1400654,9
1309,148,9639,705310,705458,21
3888,295,9639,1400408,1400703,25
4914,184,9639,1247938,1248122,25
2949,38,9639,269894,269932,34
4416,222,9639,1314959,1315181,34
5031,46,9639,185378,185424,41
5354,107,9639,825835,825942,45
2544,160,9640,1400563,1400723,5
9787,167,9640,946619,946786,15
1088,136,9640,1058870,1059006,22
4943,70,9640,705511,705581,22
4580,294,9640,1364207,1364501,35
5963,115,9640,585007,585122,40
4282,102,9640,705524,705626,44
5658,157,9641,1248052,1248209,11
7127,121,9641,1162318,1162439,19
8507,290,9641,1314984,1315274,36
1638,201,9641,946729,946930,40
9400,261,9642,1471360,1471621,5
9851,176,9642,1315141,1315317,8
6008,208,9642,1400560,1400768,19
7324,228,9642,1058952,1059180,32
8688,29,9643,185536,185565,11
6089,211,9643,1059019,1059230,13
2891,191,9643,1248119,1248310,16
2600,143,9643,1162418,1162561,38
5815,267,9644,1471384,1471651,6
6201,239,9644,946888,947127,21
7920,224,9645,1425442,1425666,9
5659,31,9645,366935,366966,33
6970,99,9645,705761,705860,37
8268,289,9645,1315146,1315435,50
9000,175,9646,1059169,1059344,18
2867,254,9646,1059153,1059407,30
8168,49,9646,366987,367036,47
4489,101,9647,585339,585440,15
1495,130,9647,826223,826353,18
6757,262,9647,1248156,1248418,23
7332,224,9647,1162460,1162684,36
6943,171,9647,705853,706024,41
9331,73,9648,473289,473362,9
8169,176,9648,1162539,1162715,27
7503,229,9648,1059312,1059541,40
2006,258,9648,1315225,1315483,47
8151,98,9649,1162658,1162756,5
1548,244,9649,1248249,1248493,20
5203,58,9649,270284,270342,21
3502,152,9649,947254,947406,23
1654,229,9649,1315301,1315530,28
1801,265,9649,1248282,1248547,31
3228,171,9649,1315394,1315565,39
7413,128,9649,1059559,1059687,49
3177,192,9649,1162701,1162893,50
9525,300,9650,1474809,1475109,2
8074,119,9650,706123,706242,18
9879,299,9650,1315328,1315627,23
4444,211,9650,1059577,1059788,31
6337,258,9651,1471431,1471689,6
2091,41,9651,367278,367319,9
5956,35,9651,270439,270474,28
5460,278,9651,1315422,1315700,37
6998,197,9651,826552,826749,41
8287,300,9651,1364338,1364638,45
6408,101,9652,826696,826797,28
5755,114,9652,585741,585855,32
7758,257,9652,1248475,1248732,42
3231,119,9652,1059799,1059918,43
7036,202,9652,1364474,1364676,48
4369,56,9652,473648,473704,49
9385,90,9653,1059866,1059956,5
6588,247,9653,1315532,1315779,10
6752,289,9653,1059717,1060006,17
8572,252,9653,1364476,1364728,22
5932,278,9653,1400585,1400863,28
9834,9,9653,114899,114908,28
1656,72,9653,585944,586016,29
4938,173,9653,706395,706568,41
6660,228,9653,1248627,1248855,45
5931,85,9654,1060010,1060095,3
4992,137,9654,947734,947871,45
8511,194,9655,826843,827037,21
8265,14,9655,186027,186041,33
2238,277,9655,1315608,1315885,45
6928,275,9656,1471453,1471728,1
3721,147,9656,1364653,1364800,2
8264,105,9656,1163124,1163229,6
7525,263,9656,1456744,1457007,12
7298,193,9657,1364644,1364837,12
9070,4,9657,60819,60823,14
8131,215,9657,1315775,1315990,24
1804,42,9657,186059,186101,26
8351,270,9657,1364616,1364886,34
7787,159,9657,1060092,1060251,37
8788,225,9657,1425527,1425752,39
7600,281,9657,1425511,1425792,43
8530,288,9657,1364700,1364988,46
8778,190,9657,1163216,1163406,50
7422,164,9658,1400806,1400970,4
1949,273,9658,1466065,1466338,9
8598,107,9658,827191,827298,16
4559,282,9658,1400759,1401041,22
7651,23,9658,270795,270818,23
8628,276,9658,1248908,1249184,33
4542,250,9658,1248969,1249219,36
1676,20,9659,186181,186201,29
5922,102,9659,586252,586354,30
5482,6,9659,115054,115060,43
4291,25,9659,186204,186229,46
4690,279,9660,1425564,1425843,16
5287,242,9660,1364865,1365107,24
7116,266,9660,1315983,1316249,35
6923,142,9661,474023,474165,17
6960,231,9661,1249105,1249336,20
9498,295,9661,1364859,1365154,29
4921,228,9661,1249184,1249412,47
5822,141,9662,1163550,1163691,24
3192,255,9662,1163482,1163737,31
4033,104,9662,1060543,1060647,39
9749,191,9663,1060486,1060677,13
6640,48,9663,586471,586519,19
1101,54,9663,367856,367910,32
5541,277,9663,1316036,1316313,36
4189,1,9663,23154,23155,38
7084,293,9663,1425599,1425892,43
2155,134,9663,948360,948494,46
2124,221,9664,1456827,1457048,3
8457,163,9664,948392,948555,20
8255,283,9664,1400861,1401144,28
1030,32,9664,115149,115181,31
4805,106,9664,707140,707246,33
8911,164,9664,1060631,1060795,46
4606,206,9665,1163653,1163859,20
6932,182,9665,1060688,1060870,37
1533,87,9665,367957,368044,41
7427,101,9665,586588,586689,42
7522,4,9666,23178,23182,17
2123,131,9666,948537,948668,27
6195,160,9666,948555,948715,35
8733,94,9666,948645,948739,39
2582,90,9666,586664,586754,42
6207,96,9666,827707,827803,49
2728,4,9666,61016,61020,50
5664,16,9667,23191,23207,31
9662,204,9667,1163701,1163905,45
6582,300,9668,1475520,1475820,1
8195,156,9668,1401019,1401175,3
3784,100,9668,827758,827858,8
2296,142,9668,1163812,1163954,24
3635,124,9668,707320,707444,30
8909,87,9668,586771,586858,42
6658,279,9669,1249307,1249586,23
6745,4,9669,23222,23226,32
7942,26,9669,368186,368212,48
3059,221,9669,1249402,1249623,50
2870,151,9670,707380,707531,30
3827,74,9670,474540,474614,32
6125,193,9671,1365094,1365287,8
5560,84,9671,707471,707555,11
5958,235,9671,1316218,1316453,27
2033,45,9671,186541,186586,41
1223,217,9672,1456868,1457085,3
1954,123,9672,948805,948928,16
7745,103,9672,948848,948951,24
6816,224,9672,948794,949018,30
7752,202,9672,1060884,1061086,36
1103,168,9673,1316319,1316487,8
7812,70,9673,474675,474745,8
4882,168,9673,1060959,1061127,20
7853,150,9673,948965,949115,20
1565,60,9674,828059,828119,2
3153,207,9674,1443868,1444075,4
1293,232,9674,1443862,1444094,9
8059,85,9674,587019,587104,9
4293,57,9674,271365,271422,26
6457,101,9674,828068,828169,45
6449,269,9675,1466097,1466366,7
1476,204,9675,1061003,1061207,42
7738,234,9675,1163933,1164167,42
6232,209,9676,707649,707858,17
9351,9,9676,115444,115453,19
1590,68,9676,587144,587212,28
1719,88,9676,707797,707885,29
9366,217,9676,1061060,1061277,40
6938,87,9676,587186,587273,44
3103,60,9677,474918,474978,12
1522,102,9677,1061198,1061300,19
3897,137,9677,587185,587322,21
4053,160,9677,1249606,1249766,48
9804,209,9678,1443935,1444144,5
4109,154,9678,1061213,1061367,16
4134,25,9678,271557,271582,25
7693,50,9678,368585,368635,27
2995,217,9678,1164009,1164226,42
7211,260,9679,1471493,1471753,5
9390,33,9679,115510,115543,17
2012,25,9679,186836,186861,34
1951,206,9679,1164071,1164277,44
4759,295,9679,1425762,1426057,49
4698,247,9680,1249604,1249851,26
8049,156,9680,1061362,1061518,27
6859,193,9681,1061357,1061550,15
4983,17,9681,115573,115590,18
6247,254,9681,1164126,1164380,32
3013,70,9682,949408,949478,1
6121,122,9682,1249753,1249875,4
1410,240,9682,1249682,1249922,20
6345,181,9682,1249766,1249947,28
8843,58,9682,368733,368791,32
1001,204,9682,1164280,1164484,35
9080,50,9682,186923,186973,36
5427,221,9683,1456920,1457141,6
8037,204,9683,1164321,1164525,18
9763,2,9683,23346,23348,20
8769,267,9683,1061491,1061758,21
5464,72,9683,708172,708244,24
7134,224,9683,1249767,1249991,35
9524,200,9683,1164395,1164595,37
2710,117,9684,1249899,1250016,1
1723,36,9684,475267,475303,6
2770,219,9684,1425875,1426094,8
9147,190,9684,828543,828733,30
9914,108,9684,587593,587701,32
3114,4,9684,61339,61343,42
3819,285,9685,1316385,1316670,50
5888,18,9686,271822,271840,1
9091,196,9686,1249925,1250121,24
1038,227,9686,1365237,1365464,38
1672,192,9686,1316534,1316726,38
1953,110,9686,1061833,1061943,43
6362,129,9686,949686,949815,45
3033,97,9686,708345,708442,46
8846,83,9687,1061871,1061954,4
3052,24,9687,271875,271899,6
2960,249,9687,1061745,1061994,21
2811,226,9687,1316553,1316779,22
3640,194,9687,1250059,1250253,24
8491,124,9687,708411,708535,26
2477,258,9687,1316563,1316821,29
9989,186,9687,949778,949964,36
4098,6,9687,23405,23411,41
2272,53,9687,708537,708590,43
2356,132,9687,1061955,1062087,49
8001,98,9688,587848,587946,42
4638,81,9689,587886,587967,15
7956,182,9689,1164650,1164832,27
3969,100,9689,949928,950028,39
2701,207,9689,1164676,1164883,45
8056,143,9690,1164762,1164905,8
4838,284,9690,1316595,1316879,20
6826,120,9690,828967,829087,35
6670,139,9690,949983,950122,47
6556,169,9691,1401178,1401347,5
5428,180,9691,1365313,1365493,9
5435,50,9691,369185,369235,47
8676,180,9691,1250186,1250366,49
5476,4,9692,61436,61440,5
5595,170,9692,1062090,1062260,37
7423,171,9693,1401207,1401378,3
9416,119,9693,1062170,1062289,7
2188,47,9693,369247,369294,15
3686,90,9693,588070,588160,15
9494,261,9693,1401158,1401419,38
5404,288,9693,1456875,1457163,39
4888,242,9694,1425903,1426145,19
2838,70,9694,369288,369358,40
7947,35,9694,272160,272195,42
7923,116,9695,950146,950262,16
3030,71,9695,187308,187379,17
6835,45,9695,115918,115963,17
7768,150,9695,475668,475818,17
9344,100,9695,588129,588229,32
8435,189,9695,1164907,1165096,46
2414,4,9695,61529,61533,47
8619,121,9695,829160,829281,47
2497,280,9696,1316765,1317045,20
7685,32,9696,272247,272279,20
9775,175,9697,1425987,1426162,3
5768,138,9697,950206,950344,20
1216,17,9697,187441,187458,46
1454,279,9698,1250257,1250536,15
7650,70,9698,475868,475938,42
3359,87,9698,588255,588342,44
6895,275,9699,1062215,1062490,21
7489,300,9699,1316816,1317116,26
3948,135,9699,829311,829446,42
4434,159,9699,950313,950472,44
4668,56,9700,708982,709038,6
4221,223,9700,1425964,1426187,9
7052,157,9700,1062410,1062567,16
1461,299,9700,1401252,1401551,25
9072,269,9701,1471495,1471764,4
9378,64,9701,588426,588490,12
2276,167,9701,950398,950565,13
7859,11,9701,116084,116095,13
7054,160,9701,950451,950611,44
1828,200,9702,1401395,1401595,7
3461,27,9702,61614,61641,17
9030,149,9702,950508,950657,35
7356,290,9702,1365434,1365724,46
1085,95,9702,950609,950704,48
1845,53,9703,588534,588587,24
6896,40,9703,369676,369716,25
1044,150,9703,1250543,1250693,48
9411,255,9704,1401367,1401622,16
2054,148,9704,829548,829696,18
4847,137,9704,829609,829746,20
8870,98,9704,950658,950756,24
8378,242,9704,1317048,1317290,27
8335,102,9704,829696,829798,46
8377,166,9705,1401484,1401650,2
8712,120,9705,1165274,1165394,19
3857,74,9705,369749,369823,21
7890,275,9705,1365532,1365807,34
1760,212,9705,1165266,1165478,50
2756,37,9706,588696,588733,2
8684,31,9706,187679,187710,7
8337,222,9706,1425995,1426217,12
7542,123,9706,588652,588775,31
4941,209,9706,1165331,1165540,37
2612,100,9707,476285,476385,10
7432,151,9707,1250677,1250828,39
9718,227,9707,1062651,1062878,40
2113,226,9707,1250640,1250866,45
1005,166,9708,1317202,1317368,7
8456,159,9708,1250746,1250905,9
1331,186,9708,950844,951030,15
4944,79,9708,476409,476488,32
4599,284,9708,1317149,1317433,37
7596,4,9708,61762,61766,48
5131,13,9709,116277,116290,4
4415,297,9709,1317191,1317488,26
4080,190,9709,1165509,1165699,29
9486,106,9710,829993,830099,16
3517,214,9710,950919,951133,21
4006,240,9710,1365621,1365861,24
8535,178,9710,1250852,1251030,24
3872,258,9710,1250818,1251076,26
7009,59,9710,476563,476622,35
2267,282,9710,1165532,1165814,41
7187,23,9711,272824,272847,5
6506,122,9711,709559,709681,15
7119,206,9711,1165648,1165854,20
8992,265,9711,1365639,1365904,34
4081,224,9711,1062977,1063201,40
1827,300,9711,1365666,1365966,46
8528,289,9712,1474813,1475102,6
7218,22,9712,116373,116395,10
3409,106,9712,589049,589155,26
5650,152,9712,1063123,1063275,28
7673,135,9712,951249,951384,45
4044,47,9713,370205,370252,35
9675,209,9714,1444041,1444250,5
8630,203,9714,1063125,1063328,13
5924,95,9714,589152,589247,15
4089,11,9714,116426,116437,20
4778,212,9714,1063179,1063391,23
1374,204,9714,1165770,1165974,37
9206,49,9714,589245,589294,39
4166,221,9714,1165787,1166008,42
7688,49,9715,709855,709904,1
6857,174,9715,1401550,1401724,4
7357,63,9715,370304,370367,7
7798,11,9715,116470,116481,12
2510,211,9715,1165864,1166075,45
9279,1,9715,23638,23639,48
9342,138,9715,1165972,1166110,48
6667,230,9716,1426039,1426269,12
1866,15,9716,116486,116501,15
5784,267,9716,1426026,1426293,16
3188,285,9716,1317433,1317718,20
7781,45,9716,188052,188097,41
4564,129,9717,1166059,1166188,7
8164,151,9717,830460,830611,15
6087,2,9717,23655,23657,16
4454,21,9717,273072,273093,24
1721,116,9717,709937,710053,32
2142,1,9717,23660,23661,42
9903,8,9718,116540,116548,5
3554,196,9718,709931,710127,10
5629,57,9718,273079,273136,21
4848,164,9718,710001,710165,41
7104,24,9719,273143,273167,14
3343,207,9719,1251073,1251280,16
6220,2,9719,23674,23676,17
8772,223,9719,1251087,1251310,20
6160,136,9719,710088,710224,31
1112,215,9719,1251139,1251354,46
2023,132,9719,1063539,1063671,49
3539,74,9720,830632,830706,19
5000,255,9720,1317491,1317746,35
5116,24,9721,370553,370577,1
3471,156,9721,1166174,1166330,25
8756,236,9721,1251195,1251431,29
2237,212,9721,951596,951808,41
8525,230,9721,1365835,1366065,49
8142,144,9722,1365944,1366088,1
7891,259,9722,1471530,1471789,6
2268,106,9722,951757,951863,7
6913,279,9722,1466147,1466426,11
3615,126,9722,477092,477218,17
4875,46,9722,477189,477235,24
9587,268,9722,1251285,1251553,26
6277,106,9722,710339,710445,44
7706,252,9723,1466215,1466467,1
7830,140,9723,1251440,1251580,7
6153,106,9723,830812,830918,9
6016,23,9723,273383,273406,14
4232,238,9723,1426133,1426371,19
6820,9,9723,116725,116734,38
4824,37,9724,273389,273426,11
4903,93,9724,710421,710514,16
4230,139,9724,830817,830956,26
1220,274,9724,1365926,1366200,27
3410,286,9724,1251391,1251677,31
7287,262,9724,1401620,1401882,43
5011,242,9725,830829,831071,17
6026,123,9725,710508,710631,36
6787,176,9725,1063792,1063968,44
6625,275,9725,1401652,1401927,49
2127,149,9726,1166466,1166615,25
8645,103,9726,1063924,1064027,43
2897,187,9727,1426210,1426397,6
9149,190,9727,1063900,1064090,20
7516,232,9727,1166446,1166678,23
7393,287,9727,1444069,1444356,39
2752,120,9728,589898,590018,31
1354,112,9728,831132,831244,33
5039,292,9728,1426181,1426473,43
1132,2,9728,23775,23777,46
4869,289,9729,1474829,1475118,5
1561,272,9729,1471569,1471841,6
7313,78,9729,952124,952202,6
6490,131,9729,710741,710872,13
7021,266,9729,1251592,1251858,23
7721,149,9729,952125,952274,29
6056,21,9730,273625,273646,4
4377,88,9730,710845,710933,11
9160,244,9730,1366146,1366390,28
1098,202,9730,1317899,1318101,43
1576,66,9730,590118,590184,45
5140,52,9730,477598,477650,46
8812,203,9731,1444215,1444418,6
9379,12,9731,62178,62190,7
6501,205,9731,1166657,1166862,18
7609,96,9731,590140,590236,18
2042,255,9732,1366205,1366460,22
7163,108,9732,952280,952388,24
1669,26,9732,116917,116943,26
6546,193,9732,1166741,1166934,27
1725,20,9732,188624,188644,47
9458,278,9732,1444179,1444457,48
4317,299,9733,1401822,1402121,25
5250,221,9733,1317999,1318220,34
3286,237,9734,1466287,1466524,2
8545,2,9734,23814,23816,18
5146,64,9734,371111,371175,26
5252,266,9734,1251817,1252083,36
4422,252,9734,1251866,1252118,42
7750,221,9734,1166883,1167104,42
1136,284,9734,1401908,1402192,49
7499,277,9735,1457024,1457301,19
9384,20,9735,62244,62264,21
8066,118,9735,477755,477873,41
2297,248,9735,1426385,1426633,48
2509,288,9736,1474858,1475146,1
5192,69,9736,477847,477916,9
1042,203,9736,1366449,1366652,12
1521,105,9736,711119,711224,13
6576,45,9736,371288,371333,13
3782,122,9736,952527,952649,16
6029,272,9736,1166949,1167221,41
9232,200,9737,1444333,1444533,4
4651,28,9737,273923,273951,28
1455,35,9738,188784,188819,8
2725,97,9738,831633,831730,14
9699,84,9738,711233,711317,16
4922,240,9738,831548,831788,17
4103,183,9738,1366511,1366694,39
4750,229,9738,1064439,1064668,40
9891,187,9739,1426511,1426698,2
6081,192,9739,1064519,1064711,15
5248,109,9739,371383,371492,17
8242,157,9739,831740,831897,30
9922,225,9739,1252058,1252283,35
6200,66,9739,371474,371540,40
1018,179,9740,952659,952838,13
2935,202,9740,1318209,1318411,24
1771,139,9740,952742,952881,44
7702,172,9741,952748,952920,13
5359,132,9741,952824,952956,16
6827,281,9741,1167067,1167348,21
8216,10,9741,62382,62392,26
8600,10,9741,62388,62398,26
3047,36,9741,274124,274160,42
5448,284,9741,1318189,1318473,50
5151,163,9742,1252208,1252371,11
6118,79,9742,371583,371662,21
1891,167,9742,831972,832139,30
4905,128,9742,1167290,1167418,43
6912,27,9742,371661,371688,45
2853,69,9743,478210,478279,15
7846,278,9743,1318245,1318523,18
3602,179,9743,1252250,1252429,22
9689,222,9743,1064723,1064945,32
1003,240,9743,1252241,1252481,45
1743,202,9744,1366526,1366728,14
3355,86,9744,832193,832279,14
4608,37,9744,189054,189091,37
8987,257,9744,1167316,1167573,40
5814,182,9745,1426536,1426718,5
6326,257,9745,1318325,1318582,18
9059,22,9745,189107,189129,20
7448,239,9745,1167425,1167664,26
6865,100,9745,711753,711853,37
8804,296,9746,1474883,1475179,1
9785,265,9746,1471636,1471901,2
9607,61,9746,832328,832389,6
9655,49,9746,478417,478466,29
5699,252,9747,1457124,1457376,7
1063,155,9747,590862,591017,17
3169,152,9748,711766,711918,21
5969,227,9748,1064951,1065178,32
4312,142,9748,953188,953330,35
8011,6,9748,62531,62537,47
8350,85,9749,1065109,1065194,3
7213,153,9749,1252446,1252599,7
9340,174,9749,711859,712033,10
3955,285,9749,1466316,1466601,11
5600,93,9749,711981,712074,11
2818,274,9749,1366592,1366866,25
4022,27,9749,189261,189288,32
2746,34,9749,371979,372013,45
4768,276,9750,953165,953441,17
5055,72,9750,712063,712135,25
1232,180,9750,953306,953486,26
5743,205,9750,1167593,1167798,29
9016,98,9751,832488,832586,8
4891,74,9751,712135,712209,14
1955,206,9751,1065122,1065328,33
1579,196,9751,1252472,1252668,34
2583,189,9752,1426629,1426818,2
7470,191,9752,1167673,1167864,29
7303,93,9752,591235,591328,32
10000,118,9752,832580,832698,35
1265,192,9752,1318520,1318712,38
1485,144,9753,591267,591411,10
1884,207,9753,1402199,1402406,11
7434,146,9753,1167777,1167923,11
3374,233,9753,1318509,1318742,13
5227,287,9753,1444332,1444619,16
3633,263,9753,1318544,1318807,20
7641,184,9753,1065370,1065554,20
7281,239,9753,1252596,1252835,35
1873,28,9753,478897,478925,43
3996,197,9753,1366747,1366944,48
9711,172,9754,953642,953814,26
8669,246,9754,1318626,1318872,27
2939,185,9754,953673,953858,31
4055,279,9755,1474916,1475195,2
4664,167,9755,1065517,1065684,27
5989,292,9755,1402198,1402490,28
7224,182,9755,832847,833029,31
9636,156,9755,712453,712609,41
8367,12,9755,117610,117622,49
1306,16,9756,62701,62717,7
1442,227,9756,1426655,1426882,9
2687,13,9756,189551,189564,22
2695,174,9756,1252787,1252961,22
2855,12,9756,189565,189577,33
9807,139,9756,953840,953979,45
8275,191,9757,1065587,1065778,23
4264,123,9757,833026,833149,33
6989,270,9757,1252747,1253017,33
7926,92,9757,479056,479148,36
7268,265,9757,1167965,1168230,40
9967,157,9758,1168105,1168262,14
4613,122,9758,1065766,1065888,24
8949,148,9758,1168144,1168292,24
8498,213,9758,1318746,1318959,25
5198,104,9758,712725,712829,37
7319,253,9759,1466400,1466653,3
3210,273,9759,1444413,1444686,48
3950,166,9760,954034,954200,15
4792,73,9760,833266,833339,19
2726,21,9760,117695,117716,41
4473,4,9760,62782,62786,43
2645,16,9760,189659,189675,45
5378,130,9760,833248,833378,47
8635,209,9761,1444513,1444722,1
9889,104,9761,833300,833404,8
3911,218,9761,1318826,1319044,28
1716,266,9761,1168160,1168426,30
2169,239,9761,1168227,1168466,32
9218,4,9762,24113,24117,2
4217,190,9762,1168306,1168496,37
9779,258,9762,1168291,1168549,40
2488,3,9763,62823,62826,1
1319,274,9763,1471671,1471945,6
8834,25,9763,117765,117790,10
9649,256,9763,954131,954387,17
2428,221,9763,1318876,1319097,28
8345,98,9763,591965,592063,32
8948,9,9763,117812,117821,39
7589,59,9763,479401,479460,47
7734,194,9764,1444567,1444761,1
5389,264,9764,1252950,1253214,42
1799,296,9764,1366846,1367142,46
6281,227,9765,1318960,1319187,16
7098,184,9766,1426813,1426997,4
8898,280,9766,1457196,1457476,12
8068,197,9766,1366994,1367191,14
1659,145,9766,833599,833744,23
9943,196,9766,1066121,1066317,23
2432,104,9766,479496,479600,31
7838,254,9766,1319008,1319262,35
9335,109,9766,713172,713281,35
2912,298,9766,1366930,1367228,44
1513,269,9766,1319075,1319344,50
4495,290,9767,1474930,1475220,1
9584,120,9767,1253326,1253446,6
1288,89,9767,592202,592291,13
7459,31,9767,117896,117927,41
2632,207,9767,1367080,1367287,48
2909,123,9767,954587,954710,49
4488,254,9768,1471730,1471984,2
5506,244,9768,1066263,1066507,30
8252,298,9768,1367048,1367346,35
1660,74,9768,713361,713435,38
3229,59,9768,372911,372970,40
1193,10,9768,117961,117971,49
5753,200,9769,1402484,1402684,7
6968,295,9769,1471710,1472005,8
7872,3,9769,62961,62964,14
3589,277,9769,1319226,1319503,44
7618,97,9769,833920,834017,45
4568,290,9770,1466465,1466755,12
1853,265,9770,1444621,1444886,14
8330,146,9770,1066508,1066654,28
9727,142,9770,954766,954908,44
2799,57,9770,713509,713566,48
6870,295,9771,1474959,1475254,6
6256,209,9772,1444728,1444937,6
4686,50,9772,479837,479887,24
4953,251,9772,1253408,1253659,26
7325,256,9772,1444712,1444968,39
3087,60,9772,373066,373126,40
3091,178,9773,1367303,1367481,7
6564,130,9773,1253579,1253709,19
9682,100,9773,713559,713659,23
7775,272,9773,1253472,1253744,40
8931,48,9773,373149,373197,42
6313,287,9773,1319371,1319658,45
6803,94,9774,713633,713727,11
9195,201,9774,1066643,1066844,13
9948,190,9774,1319494,1319684,14
9017,73,9774,834200,834273,39
8544,231,9774,1168995,1169226,42
7949,147,9775,1367357,1367504,3
4179,180,9775,1367349,1367529,7
6925,216,9775,1066736,1066952,31
8902,265,9775,1253588,1253853,32
5686,68,9775,592666,592734,35
4556,161,9775,1066857,1067018,45
6059,80,9776,955163,955243,4
7112,156,9776,1253719,1253875,8
7380,42,9776,275543,275585,40
4595,100,9776,834327,834427,46
5462,130,9777,1066927,1067057,14
5534,243,9777,1169102,1169345,15
2886,134,9777,592713,592847,21
8178,148,9777,834355,834503,32
8793,160,9777,955192,955352,33
3183,226,9778,1457372,1457598,3
5442,36,9778,118184,118220,17
3455,251,9778,1253675,1253926,26
3181,4,9778,24276,24280,39
9252,232,9778,1253755,1253987,46
2531,236,9780,1253786,1254022,18
3603,35,9781,480253,480288,2
3771,47,9781,480256,480303,25
5913,206,9781,1253865,1254071,28
4429,46,9781,190284,190330,31
1805,184,9781,1253921,1254105,49
3020,64,9782,373469,373533,32
5147,12,9782,118267,118279,49
6131,266,9782,1402567,1402833,49
8333,34,9783,275712,275746,15
3809,84,9783,714050,714134,16
5696,47,9783,480318,480365,24
5731,100,9783,955409,955509,39
8095,287,9783,1169263,1169550,41
9127,62,9783,373566,373628,42
4255,124,9784,1254031,1254155,4
1128,259,9784,955333,955592,17
3121,288,9784,1319494,1319782,23
4333,46,9784,480421,480467,33
8239,280,9784,1402583,1402863,34
3302,39,9784,373667,373706,49
8962,269,9784,1402634,1402903,49
2275,138,9785,1067227,1067365,16
2837,254,9785,1319617,1319871,29
8174,183,9785,1067259,1067442,37
6338,217,9786,1457400,1457617,1
3358,106,9786,1169600,1169706,3
3463,44,9786,373731,373775,15
4047,149,9786,955637,955786,29
2064,162,9787,1402778,1402940,5
8694,33,9787,190476,190509,7
5880,179,9787,1319748,1319927,11
4063,65,9787,275898,275963,21
6929,258,9787,1367441,1367699,28
9108,189,9787,955683,955872,36
5737,285,9787,1319726,1320011,44
2138,201,9788,1169624,1169825,29
2872,45,9788,190537,190582,36
5634,142,9788,1254246,1254388,39
5085,126,9788,955845,955971,50
5380,160,9788,1067458,1067618,50
1057,276,9789,1319768,1320044,26
5872,276,9789,1426939,1427215,43
9671,121,9790,593231,593352,36
5275,274,9790,1319844,1320118,44
9269,12,9790,190628,190640,48
3201,113,9790,835057,835170,50
4029,129,9791,835092,835221,33
8857,199,9791,1067520,1067719,36
4235,264,9792,1457379,1457643,8
4925,56,9792,714554,714610,19
1978,260,9792,1319915,1320175,29
2501,37,9792,276095,276132,44
5609,58,9793,835229,835287,1
4843,40,9793,593416,593456,6
4019,223,9793,1319989,1320212,16
9418,185,9793,1254388,1254573,25
3625,38,9793,276141,276179,34
9566,6,9794,118560,118566,1
9666,266,9794,1471769,1472035,3
6476,149,9794,1254453,1254602,9
9975,157,9794,1067706,1067863,16
5898,269,9794,1427039,1427308,19
5619,167,9794,956078,956245,26
6638,23,9794,190745,190768,27
9296,153,9795,1320118,1320271,19
8013,296,9795,1320030,1320326,26
3651,2,9795,24409,24411,29
8553,207,9795,1067748,1067955,32
3981,275,9795,1320104,1320379,45
2043,268,9795,1402798,1403066,49
5613,240,9796,1254527,1254767,18
7993,278,9796,1367573,1367851,27
2017,5,9797,63408,63413,6
5742,8,9797,63410,63418,11
8521,43,9797,374114,374157,13
9445,236,9797,1254608,1254844,29
5137,97,9797,593589,593686,30
6116,29,9797,374159,374188,39
1904,27,9797,118653,118680,41
1693,259,9798,1457425,1457684,9
4173,225,9798,1170049,1170274,15
5833,61,9798,593679,593740,16
7777,197,9798,1067971,1068168,18
3322,122,9798,593664,593786,31
8441,25,9798,190882,190907,44
4351,95,9798,835539,835634,49
8187,223,9798,1320274,1320497,49
7839,257,9799,1457458,1457715,7
7763,161,9799,1170170,1170331,16
3067,254,9799,956315,956569,17
9287,276,9799,1444817,1445093,48
6637,109,9800,1254820,1254929,5
9409,3,9800,24468,24471,15
9606,253,9800,1367690,1367943,25
6093,248,9800,1254748,1254996,26
4820,163,9800,835648,835811,30
7937,83,9800,481137,481220,40
8515,297,9801,1367688,1367985,18
2973,276,9801,1320372,1320648,37
2708,214,9803,1170292,1170506,18
9739,39,9803,374402,374441,20
4246,153,9803,1170388,1170541,24
8695,146,9803,956601,956747,35
9422,289,9804,1427096,1427385,13
9615,250,9804,1444859,1445109,14
3267,247,9804,1402925,1403172,16
4811,18,9804,191064,191082,22
7792,169,9804,715106,715275,41
4573,72,9805,594020,594092,12
5789,135,9805,715176,715311,40
9527,138,9806,1367908,1368046,1
3448,237,9806,1466550,1466787,2
2314,49,9806,374522,374571,11
1602,259,9806,1367830,1368089,13
8502,239,9806,1068305,1068544,41
2605,20,9807,276653,276673,4
6871,20,9807,276663,276683,33
6749,223,9807,1254955,1255178,37
1982,4,9808,63602,63606,19
4280,208,9808,1068419,1068627,23
4683,289,9808,1320500,1320789,26
2798,284,9808,1367849,1368133,46
9824,13,9809,191189,191202,19
6922,156,9809,1170588,1170744,28
7130,134,9809,836032,836166,42
4515,24,9809,191202,191226,44
6466,98,9809,836093,836191,49
6244,80,9810,956937,957017,6
9063,202,9810,1068533,1068735,13
1072,226,9810,1170552,1170778,15
5311,12,9810,24539,24551,21
8661,109,9810,836171,836280,27
8623,95,9811,715506,715601,20
3775,176,9811,1367975,1368151,39
3219,110,9812,1255156,1255266,4
4872,99,9812,1170724,1170823,6
3401,189,9812,1367984,1368173,11
8862,98,9812,836265,836363,14
3750,176,9812,1170704,1170880,28
6979,66,9813,481620,481686,35
6764,266,9813,1255062,1255328,42
1626,126,9813,957074,957200,50
2375,250,9814,1466567,1466817,3
7502,185,9814,1368021,1368206,11
2604,132,9814,481636,481768,17
6219,276,9814,1367973,1368249,27
2567,24,9814,276893,276917,29
9370,206,9814,1170803,1171009,29
5647,86,9814,374837,374923,41
2888,284,9814,1320693,1320977,50
1287,194,9815,1427270,1427464,4
9395,54,9815,481772,481826,35
3863,281,9816,1402983,1403264,22
1483,197,9816,1170910,1171107,44
4389,18,9817,191406,191424,6
2080,217,9817,1427274,1427491,7
9981,146,9817,1255345,1255491,7
8763,185,9817,715715,715900,10
1298,270,9817,1255276,1255546,23
4829,114,9817,836531,836645,29
5024,224,9817,1170979,1171203,42
4708,140,9818,1069006,1069146,49
7416,7,9819,119135,119142,1
6445,263,9819,1170992,1171255,31
7735,57,9819,715954,716011,48
6098,50,9820,481934,481984,20
8858,289,9820,1171011,1171300,21
5405,296,9820,1368057,1368353,29
5709,189,9820,1171169,1171358,29
5172,139,9820,715985,716124,32
9322,139,9820,957438,957577,47
7285,196,9821,1403098,1403294,8
7807,60,9821,277112,277172,10
8486,216,9821,1171175,1171391,10
9263,78,9821,277134,277212,17
4547,41,9821,277188,277229,32
8608,113,9821,836737,836850,34
6208,50,9821,191591,191641,36
6566,158,9821,836727,836885,36
5001,292,9822,1474950,1475242,1
5708,275,9822,1471797,1472072,2
6864,109,9822,1255519,1255628,3
9609,145,9822,594799,594944,10
3429,80,9822,594891,594971,23
5008,199,9822,1069157,1069356,26
4632,215,9822,957497,957712,30
1114,78,9822,716251,716329,33
8522,183,9822,1069231,1069414,45
2543,235,9823,1320884,1321119,13
3200,53,9823,595015,595068,24
7929,103,9823,482199,482302,31
9308,140,9823,957670,957810,46
4150,131,9824,1321009,1321140,6
2903,160,9824,1255521,1255681,9
7145,292,9824,1171223,1171515,21
3154,68,9824,716383,716451,24
5606,63,9824,375363,375426,40
5698,84,9824,595081,595165,42
3043,169,9825,716329,716498,10
5382,42,9825,482383,482425,22
3522,44,9825,277430,277474,26
2186,1,9825,24702,24703,42
9843,297,9826,1474982,1475279,5
3688,49,9826,595167,595216,38
7581,259,9827,1471854,1472113,6
9389,209,9827,1171343,1171552,10
9497,15,9827,119417,119432,15
8186,198,9827,716402,716600,17
5907,140,9827,595189,595329,21
3497,296,9827,1320926,1321222,26
1024,199,9827,1403180,1403379,39
8237,247,9827,1368246,1368493,49
7661,211,9828,1457616,1457827,1
9548,136,9828,837081,837217,23
5479,87,9829,482517,482604,26
6983,93,9829,595327,595420,37
1356,217,9829,1171443,1171660,42
7515,237,9830,1466675,1466912,1
4727,169,9830,1403269,1403438,4
8321,95,9830,837195,837290,25
7369,131,9830,837200,837331,35
2321,266,9830,1368304,1368570,47
8103,47,9831,716728,716775,2
2616,186,9831,1069531,1069717,23
1528,90,9831,482649,482739,30
1935,17,9831,277667,277684,33
2304,84,9832,375659,375743,21
1427,168,9832,1069584,1069752,29
8702,106,9832,482674,482780,31
3383,188,9832,1069594,1069782,42
1142,100,9832,716759,716859,44
8534,70,9832,595530,595600,49
7341,178,9832,1069661,1069839,50
8686,184,9833,1427430,1427614,1
7445,23,9833,277750,277773,4
1812,35,9833,277756,277791,12
2578,35,9834,119588,119623,21
7228,52,9834,595578,595630,24
2475,239,9834,1321152,1321391,34
1606,201,9834,1368419,1368620,48
5850,143,9835,837384,837527,18
6248,95,9835,595603,595698,18
9294,160,9835,958071,958231,20
9817,173,9835,958111,958284,23
8854,70,9836,595681,595751,12
9044,279,9836,1403209,1403488,28
1055,117,9836,1069823,1069940,43
5728,92,9837,837545,837637,14
1129,289,9837,1403259,1403548,24
4239,46,9837,192127,192173,41
4631,178,9838,958215,958393,23
1586,66,9838,375916,375982,26
7216,113,9838,595740,595853,32
8499,87,9838,958323,958410,39
8886,110,9839,1255851,1255961,6
7849,214,9839,1171631,1171845,26
3558,5,9839,64157,64162,35
3480,134,9839,958349,958483,45
3081,40,9840,483038,483078,4
5949,87,9840,837685,837772,38
8734,132,9841,837666,837798,13
8875,86,9841,717073,717159,27
9595,149,9841,717044,717193,31
6755,221,9841,1069823,1070044,32
7484,112,9841,837747,837859,33
6168,136,9842,1321352,1321488,3
7966,245,9842,1445001,1445246,12
1964,14,9843,119766,119780,4
6507,242,9843,1445039,1445281,7
1699,119,9843,958450,958569,9
4665,21,9843,64208,64229,17
7828,95,9843,1070000,1070095,19
3889,24,9844,376141,376165,3
5601,96,9844,837852,837948,14
4328,94,9844,595996,596090,18
1894,164,9844,717192,717356,21
6668,54,9844,376178,376232,34
4889,216,9844,1321353,1321569,38
5578,129,9845,596037,596166,10
9071,265,9845,1255794,1256059,32
8926,123,9846,837909,838032,33
7898,68,9846,483286,483354,34
3978,231,9847,1171751,1171982,23
2819,210,9847,1070005,1070215,36
8848,56,9847,483346,483402,47
9762,191,9847,1368540,1368731,48
1786,281,9848,1403323,1403604,13
7517,43,9848,376327,376370,16
2242,271,9848,1321379,1321650,45
2671,277,9849,1457585,1457862,12
4703,77,9849,596241,596318,12
1398,214,9849,1171892,1172106,20
1967,293,9849,1368507,1368800,35
9295,23,9849,376405,376428,43
6120,263,9850,1471857,1472120,3
1257,279,9850,1466661,1466940,9
1574,71,9850,596322,596393,11
4844,220,9850,1403459,1403679,14
2529,195,9850,1256068,1256263,24
2634,275,9850,1368626,1368901,34
8341,154,9851,717515,717669,21
6324,88,9851,717603,717691,46
1138,12,9852,192522,192534,1
2765,23,9852,278322,278345,16
5799,282,9852,1445068,1445350,16
7699,7,9852,64338,64345,39
5879,4,9853,64343,64347,19
2022,277,9854,1403472,1403749,38
7940,295,9854,1321587,1321882,44
5694,193,9854,1172147,1172340,45
7142,167,9855,596394,596561,17
8560,204,9855,838200,838404,21
5633,230,9855,1368744,1368974,24
3205,151,9855,717699,717850,30
2413,228,9855,1070391,1070619,32
8658,9,9855,120015,120024,47
5449,219,9856,1427511,1427730,7
5518,282,9856,1466682,1466964,8
7437,266,9856,1457679,1457945,11
5752,165,9856,958926,959091,15
5836,102,9856,838432,838534,28
1415,248,9856,1172194,1172442,40
7479,149,9856,1070564,1070713,46
5639,188,9856,1256284,1256472,49
4976,235,9857,1445170,1445405,9
3005,186,9857,959026,959212,32
7587,299,9858,1466694,1466993,14
9500,153,9858,959119,959272,47
3531,289,9859,1403583,1403872,25
6379,106,9859,596750,596856,32
3884,217,9859,1256357,1256574,46
8672,33,9860,483911,483944,4
6148,294,9860,1474989,1475283,5
8153,256,9860,1457756,1458012,7
4471,269,9860,1321820,1322089,20
3904,21,9860,192765,192786,46
2566,300,9861,1475025,1475325,6
3503,54,9861,596867,596921,25
7905,274,9861,1368897,1369171,47
2737,212,9861,1321955,1322167,49
9401,132,9862,1172554,1172686,7
6697,216,9862,1403738,1403954,11
2571,130,9862,838730,838860,29
5522,50,9862,376899,376949,34
3097,166,9862,959297,959463,42
9169,103,9862,1070853,1070956,43
1280,196,9862,1172543,1172739,45
4256,72,9862,596987,597059,49
6386,259,9862,1403725,1403984,49
8371,181,9863,1369058,1369239,7
4296,89,9864,597008,597097,18
5492,279,9864,1321979,1322258,26
6014,38,9864,192882,192920,40
2868,98,9864,718232,718330,44
6891,13,9865,120228,120241,15
8872,69,9865,278747,278816,21
8423,230,9865,1172618,1172848,23
9865,137,9865,718247,718384,36
3365,29,9865,377059,377088,38
8038,282,9865,1322009,1322291,42
3684,205,9865,1322141,1322346,43
6229,173,9865,1071000,1071173,50
2365,262,9866,1457801,1458063,7
9551,234,9866,1172728,1172962,26
7256,207,9866,1403821,1404028,39
2223,81,9867,718400,718481,7
7736,96,9867,839031,839127,7
3842,54,9867,377141,377195,8
7724,139,9867,597160,597299,21
6083,230,9867,1172788,1173018,36
3879,254,9868,1471915,1472169,1
1947,147,9868,1071141,1071288,27
7305,224,9868,1256700,1256924,27
6252,203,9868,1071156,1071359,42
5110,212,9869,1403866,1404078,39
5946,218,9869,959643,959861,41
2720,171,9870,1322258,1322429,11
2179,170,9870,1172954,1173124,28
3605,149,9870,718519,718668,31
8139,206,9870,1256783,1256989,46
2555,111,9871,718603,718714,15
5313,178,9871,597357,597535,17
2494,79,9871,597485,597564,20
3814,191,9871,1071261,1071452,36
4896,91,9872,718664,718755,11
4836,81,9872,597535,597616,15
4353,226,9872,1256788,1257014,18
2944,212,9872,1322255,1322467,22
3597,65,9872,718736,718801,24
8210,195,9872,1173043,1173238,45
9737,175,9872,1071401,1071576,45
1499,293,9872,1369066,1369359,46
6254,78,9872,718805,718883,50
8871,184,9873,1427717,1427901,4
8541,221,9873,1403904,1404125,12
8816,182,9873,1322368,1322550,14
3141,186,9873,1369237,1369423,19
1650,150,9873,960004,960154,20
3710,161,9873,960019,960180,26
5677,242,9874,1256918,1257160,26
8612,222,9874,1173195,1173417,44
7111,237,9874,1256972,1257209,45
9012,63,9875,484676,484739,15
5505,165,9875,1173325,1173490,22
2415,8,9875,120546,120554,33
2082,281,9875,1322352,1322633,37
9329,217,9875,1369243,1369460,43
2822,127,9876,1322552,1322679,5
7654,204,9876,1445325,1445529,6
4455,117,9876,839581,839698,33
9702,166,9876,960190,960356,36
2718,2,9876,25128,25130,45
4169,278,9876,1403910,1404188,49
8519,56,9877,719112,719168,3
2441,250,9877,1457847,1458097,7
7042,269,9877,1457865,1458134,8
8308,206,9877,719033,719239,17
6748,252,9877,1369337,1369589,24
1149,295,9877,1322527,1322822,33
5920,217,9877,1071752,1071969,40
7028,219,9877,960295,960514,41
8218,202,9878,1404042,1404244,9
5381,44,9878,598033,598077,19
8664,69,9878,484923,484992,42
9794,88,9878,598014,598102,44
2664,11,9878,120666,120677,50
4957,49,9878,484977,485026,50
1768,52,9879,279469,279521,8
4774,289,9879,1173439,1173728,21
2364,142,9879,960446,960588,33
4135,218,9880,1173552,1173770,18
4186,15,9880,120702,120717,20
5063,273,9880,1071826,1072099,21
9774,109,9880,719358,719467,42
1140,28,9881,193538,193566,18
7943,299,9882,1475049,1475348,3
4803,278,9882,1445355,1445633,39
3131,153,9882,1173670,1173823,49
5407,82,9882,719440,719522,49
4738,245,9883,1445415,1445660,11
6586,203,9883,1257317,1257520,25
7244,127,9883,1072080,1072207,25
8603,290,9883,1369419,1369709,27
5498,36,9883,120758,120794,31
6767,225,9883,1072064,1072289,32
2158,275,9883,1322689,1322964,35
2181,142,9884,1173799,1173941,9
9231,140,9884,1173817,1173957,11
6782,168,9884,840011,840179,31
7191,17,9884,64943,64960,36
6132,209,9884,1173798,1174007,37
7480,114,9885,840111,840225,11
2954,57,9885,378075,378132,15
9104,264,9885,1257341,1257605,31
6741,69,9885,840196,840265,43
4111,244,9885,1322759,1323003,46
8008,204,9886,1445483,1445687,5
8798,218,9886,1457951,1458169,6
3453,140,9886,960790,960930,20
7633,256,9886,1322813,1323069,37
6575,118,9886,598417,598535,40
9196,52,9886,719768,719820,43
1527,226,9887,1427840,1428066,39
8933,189,9888,1427907,1428096,4
1737,261,9888,1457942,1458203,7
2090,90,9888,719799,719889,33
9459,265,9888,1404162,1404427,38
6915,206,9888,1404251,1404457,39
3695,29,9888,193766,193795,40
7718,57,9888,378247,378304,42
2552,285,9889,1257560,1257845,15
1749,35,9889,279847,279882,47
9275,9,9890,65043,65052,8
5590,67,9890,485426,485493,9
6311,58,9890,378303,378361,15
4497,31,9890,279889,279920,16
9132,58,9890,598578,598636,22
9107,89,9890,598583,598672,23
3112,10,9890,120963,120973,29
2161,105,9890,840357,840462,45
2496,278,9891,1475084,1475362,3
9318,98,9891,598624,598722,18
9311,6,9891,65076,65082,25
9885,149,9891,1174122,1174271,25
5846,9,9891,65082,65091,26
5059,139,9892,1369729,1369868,3
9953,214,9892,1427933,1428147,8
2859,135,9892,840415,840550,35
4721,258,9892,1445513,1445771,39
3335,178,9892,719900,720078,41
1687,231,9893,1458026,1458257,3
3713,31,9893,280002,280033,20
7510,75,9893,720032,720107,22
4688,53,9893,485611,485664,28
7862,135,9893,961010,961145,29
6154,257,9893,1072453,1072710,30
5585,199,9893,1072541,1072740,32
7066,176,9893,961063,961239,36
5691,28,9893,485707,485735,43
8518,288,9894,1475103,1475391,5
4656,246,9894,1323029,1323275,10
5770,2,9894,25321,25323,14
4342,274,9894,1257718,1257992,15
1383,146,9894,1072676,1072822,27
5433,288,9894,1458020,1458308,39
3604,178,9894,720169,720347,41
8736,224,9894,1257822,1258046,45
7114,45,9895,378621,378666,23
6677,227,9895,1072685,1072912,31
1393,18,9895,194054,194072,39
2279,228,9895,961196,961424,41
2502,283,9896,1475136,1475419,1
7665,8,9896,121149,121157,5
2574,233,9896,1428050,1428283,11
8622,200,9896,1257916,1258116,28
1806,29,9896,280221,280250,29
3690,185,9896,840745,840930,30
2167,8,9896,121180,121188,33
1361,88,9897,1072884,1072972,4
2098,240,9897,1466888,1467128,5
7832,79,9897,599061,599140,7
7847,47,9897,280253,280300,26
5305,70,9897,599088,599158,46
7871,12,9897,121214,121226,50
9035,298,9898,1471954,1472252,9
3328,184,9898,1072836,1073020,26
2940,191,9898,1174353,1174544,50
7426,220,9899,1323177,1323397,22
2938,286,9899,1404382,1404668,25
9345,130,9899,961493,961623,50
2001,209,9900,1445718,1445927,1
3258,180,9900,1369910,1370090,7
2443,217,9900,1072954,1073171,13
9285,187,9900,1258084,1258271,24
9950,29,9900,486048,486077,43
9450,269,9901,1472018,1472287,1
3211,215,9901,1323288,1323503,16
4436,111,9901,720572,720683,42
5662,87,9902,720618,720705,12
7188,240,9902,1174489,1174729,42
1727,10,9903,194253,194263,1
1089,272,9903,1174502,1174774,30
9307,25,9903,65296,65321,31
7214,51,9903,194253,194304,41
2408,24,9903,280445,280469,45
3053,169,9904,1174635,1174804,16
3805,37,9904,194298,194335,40
5602,71,9905,486129,486200,9
3726,35,9905,280472,280507,13
4588,156,9905,841122,841278,15
9328,59,9905,378965,379024,18
1021,37,9905,121334,121371,36
6224,101,9905,1073221,1073322,39
6493,240,9906,1466946,1467186,4
6315,34,9906,280522,280556,12
2537,257,9906,1258105,1258362,26
3475,87,9906,720763,720850,27
4247,228,9906,1073167,1073395,30
6517,126,9906,961776,961902,34
1562,205,9907,1073234,1073439,15
8849,166,9907,1073307,1073473,29
4452,278,9907,1323271,1323549,36
7825,46,9907,486296,486342,49
2405,298,9908,1475152,1475450,3
7566,126,9908,961897,962023,28
7687,81,9908,379096,379177,36
9842,286,9908,1428129,1428415,38
8451,43,9908,280654,280697,44
3880,267,9909,1445746,1446013,14
8717,229,9909,1073373,1073602,40
6988,151,9909,1073481,1073632,50
4461,237,9910,1445795,1446032,11
8419,208,9910,1258292,1258500,16
7824,236,9910,1369990,1370226,22
8601,54,9910,599616,599670,25
5044,53,9910,194512,194565,31
9377,224,9911,1428253,1428477,9
7251,229,9911,1258351,1258580,29
6852,152,9911,841518,841670,40
7568,140,9911,1174924,1175064,48
5344,64,9912,379263,379327,8
3079,133,9912,599647,599780,10
4711,1,9912,25504,25505,24
9705,66,9912,486488,486554,27
1141,195,9912,1073599,1073794,33
7513,26,9913,280822,280848,24
2341,283,9914,1466947,1467230,9
3893,35,9914,486554,486589,39
3242,74,9914,841672,841746,43
2153,110,9915,721119,721229,15
7433,103,9915,486540,486643,36
1848,257,9916,1472060,1472317,5
3850,249,9916,1073605,1073854,21
4628,16,9916,194678,194694,28
8361,177,9916,1073712,1073889,33
5788,72,9917,962273,962345,5
2353,285,9917,1428242,1428527,13
8263,23,9917,121613,121636,41
4107,151,9918,1370161,1370312,2
2446,47,9918,486680,486727,25
1182,48,9919,721296,721344,5
8376,255,9919,1174917,1175172,15
8650,131,9919,841782,841913,15
5398,41,9919,379493,379534,23
2342,285,9919,1404608,1404893,28
9533,29,9919,121651,121680,36
5414,289,9920,1073728,1074017,17
2945,13,9920,25548,25561,31
2711,270,9920,1404672,1404942,38
7893,270,9920,1323562,1323832,46
4181,153,9921,1404805,1404958,1
4712,105,9921,1175180,1175285,5
2057,140,9921,1370263,1370403,6
3486,60,9921,379562,379622,7
9861,66,9921,379574,379640,10
7443,135,9921,1073990,1074125,22
7155,190,9921,1073976,1074166,23
7031,37,9921,379640,379677,29
9430,108,9921,600005,600113,30
1120,100,9921,841989,842089,49
3567,130,9922,721458,721588,13
6433,57,9922,721545,721602,19
3570,34,9922,379700,379734,24
2882,113,9922,721509,721622,26
6541,183,9922,1175153,1175336,27
7171,296,9922,1258507,1258803,32
3457,275,9922,1370181,1370456,34
4761,249,9922,1370265,1370514,38
3580,65,9922,721637,721702,50
6279,257,9923,1472078,1472335,2
4424,37,9923,194903,194940,10
9152,98,9923,721639,721737,23
2735,122,9923,962576,962698,27
9578,40,9923,194929,194969,30
4714,195,9923,962539,962734,31
5520,3,9923,25623,25626,40
4142,86,9923,600241,600327,42
8023,196,9924,1445903,1446099,2
6642,118,9924,1258785,1258903,4
2842,134,9924,600255,600389,10
4630,103,9924,842155,842258,28
3093,269,9924,1175226,1175495,30
8825,208,9924,1074164,1074372,36
9491,129,9925,842212,842341,37
3720,75,9926,842287,842362,19
6170,135,9926,1258790,1258925,19
1419,165,9926,842253,842418,40
6759,153,9926,721781,721934,41
9915,264,9927,962608,962872,17
4496,211,9928,1074208,1074419,40
3162,185,9928,1370377,1370562,48
1814,204,9928,1175377,1175581,50
5043,204,9929,1074307,1074511,26
8198,195,9929,1175421,1175616,29
5538,149,9930,1074426,1074575,28
6607,261,9930,1370339,1370600,34
4030,222,9930,1175448,1175670,36
6021,85,9930,380059,380144,36
5998,71,9930,487319,487390,42
3048,293,9930,1445855,1446148,48
7637,73,9931,487344,487417,8
5174,145,9931,1175559,1175704,12
5156,78,9931,722058,722136,28
6797,267,9931,1323780,1324047,35
3294,157,9931,1074552,1074709,45
4970,6,9931,65823,65829,49
6307,157,9932,1404869,1405026,3
7441,177,9932,842580,842757,30
8226,273,9932,1258815,1259088,33
2278,12,9933,122055,122067,25
4393,154,9933,963078,963232,29
8568,39,9933,380235,380274,29
2028,169,9934,1404884,1405053,6
9880,61,9934,600741,600802,29
7622,165,9934,842706,842871,32
4314,48,9934,600787,600835,33
5657,179,9934,1074622,1074801,33
3058,213,9934,1074643,1074856,42
1041,59,9935,487545,487604,15
1701,272,9935,1445905,1446177,19
8768,240,9935,1323918,1324158,25
3373,11,9935,65874,65885,26
9800,164,9935,963224,963388,33
9468,296,9936,1466982,1467278,14
4616,101,9936,600838,600939,18
1710,68,9936,600884,600952,27
2890,198,9936,1258992,1259190,34
6946,74,9937,487641,487715,15
9588,249,9937,1175675,1175924,31
4064,29,9937,195354,195383,40
5445,124,9938,963350,963474,12
7253,19,9938,195381,195400,12
3271,215,9938,1074790,1075005,32
3854,99,9938,963431,963530,39
9797,118,9938,1175822,1175940,39
7671,267,9938,1445955,1446222,48
6340,253,9939,1458231,1458484,8
7259,26,9939,281743,281769,12
6282,235,9940,1467064,1467299,1
4586,31,9940,380499,380530,22
6068,45,9940,601036,601081,43
7850,149,9940,1259112,1259261,48
7716,280,9941,1467042,1467322,11
3426,263,9941,1259050,1259313,15
3994,165,9941,1175909,1176074,16
9516,280,9941,1324007,1324287,18
6043,108,9941,963596,963704,22
2877,246,9941,1175917,1176163,23
4685,246,9941,1370543,1370789,25
5612,154,9941,843190,843344,26
5242,219,9941,1259199,1259418,27
4511,20,9941,281864,281884,45
2426,236,9941,1404984,1405220,48
5323,72,9942,963728,963800,2
5426,77,9942,963742,963819,5
3886,121,9942,843314,843435,29
2860,186,9942,1176095,1176281,46
4323,245,9943,1259243,1259488,20
1340,26,9944,380680,380706,14
4250,253,9944,1075118,1075371,30
1029,224,9945,1458324,1458548,6
9847,139,9945,1176206,1176345,7
8408,148,9945,1176216,1176364,12
4249,205,9945,1176199,1176404,20
7797,90,9945,843503,843593,22
7630,197,9945,1259330,1259527,34
5925,87,9945,488017,488104,36
3411,234,9945,1324145,1324379,47
6657,284,9946,1475157,1475441,3
7335,62,9946,843592,843654,5
4958,95,9946,722864,722959,11
4354,206,9946,1405062,1405268,12
4639,108,9946,722896,723004,13
6985,275,9946,1324185,1324460,20
8531,182,9946,1259470,1259652,24
3074,189,9946,963936,964125,32
3733,205,9946,1176363,1176568,35
3760,174,9947,1324312,1324486,9
5206,131,9947,601467,601598,10
8785,60,9948,843723,843783,2
1661,29,9948,66074,66103,31
4522,56,9949,723059,723115,5
8972,58,9949,843734,843792,5
3612,191,9949,1428567,1428758,6
4128,135,9949,843690,843825,26
1702,149,9950,1176466,1176615,14
3465,46,9950,380950,380996,20
2058,49,9950,488295,488344,22
2166,8,9950,122436,122444,23
8315,13,9950,66121,66134,26
4523,183,9950,1176459,1176642,47
3172,43,9950,601640,601683,48
4066,192,9951,1446133,1446325,1
4376,287,9951,1475178,1475465,4
9838,85,9951,601639,601724,9
6382,74,9951,843827,843901,48
6203,15,9952,122457,122472,11
9667,96,9952,723146,723242,11
3108,157,9952,964115,964272,20
3142,130,9952,843832,843962,23
1558,38,9952,282218,282256,27
9504,216,9952,1259515,1259731,29
6419,142,9952,964193,964335,34
7904,31,9952,122496,122527,41
7199,106,9953,843923,844029,29
9708,59,9953,488447,488506,46
8057,52,9953,601789,601841,50
2262,74,9954,964278,964352,1
1943,136,9954,1176572,1176708,9
5261,218,9954,1405124,1405342,12
6149,26,9954,122534,122560,21
5705,74,9954,723319,723393,22
6978,88,9954,723325,723413,27
6939,148,9954,843961,844109,42
6694,281,9954,1428548,1428829,43
6874,120,9954,844034,844154,47
5889,76,9955,964341,964417,3
7534,220,9955,1176561,1176781,23
7265,37,9956,381222,381259,20
9638,4,9956,66220,66224,47
4799,67,9957,381208,381275,30
1169,29,9958,282384,282413,16
4032,14,9958,195952,195966,16
7077,284,9958,1370704,1370988,27
2827,42,9958,381259,381301,35
6012,171,9959,1405232,1405403,2
9633,201,9959,1324441,1324642,24
7381,169,9959,1259698,1259867,38
1069,135,9959,1176764,1176899,39
1095,151,9960,964425,964576,45
6339,15,9961,195996,196011,9
4985,43,9961,488659,488702,25
7003,126,9962,1324534,1324660,1
1050,43,9962,381326,381369,16
8485,269,9962,1324444,1324713,29
9476,194,9963,1075744,1075938,33
5942,168,9963,1075806,1075974,47
8099,122,9964,1324604,1324726,3
3943,140,9964,1324616,1324756,4
8381,95,9964,723598,723693,11
6618,55,9964,602085,602140,14
2307,48,9964,488749,488797,22
2657,65,9964,488760,488825,35
5537,248,9964,1176756,1177004,40
8209,213,9964,964534,964747,41
5281,184,9964,964617,964801,42
4254,85,9965,381452,381537,21
4428,45,9965,488856,488901,24
5892,109,9965,1075941,1076050,43
6494,46,9965,381526,381572,47
2271,300,9965,1428560,1428860,49
9284,98,9966,1176945,1177043,2
2455,170,9966,1405286,1405456,5
3808,32,9966,381572,381604,38
9398,217,9967,1405261,1405478,14
7342,201,9967,1259822,1260023,16
6817,7,9967,122757,122764,22
6731,147,9967,1176984,1177131,25
2367,24,9967,196161,196185,32
4706,76,9967,844499,844575,38
1285,169,9967,964782,964951,42
6471,51,9967,602269,602320,45
1681,9,9967,122785,122794,50
3015,59,9968,381623,381682,8
8279,181,9968,1259872,1260053,49
7220,14,9969,66352,66366,10
2908,299,9969,1428596,1428895,24
6729,75,9970,964924,964999,4
8159,151,9970,1076086,1076237,28
1836,272,9970,1176946,1177218,30
1131,128,9970,964947,965075,34
3010,268,9971,1405286,1405554,38
7150,253,9971,1428682,1428935,48
3524,234,9972,1428735,1428969,11
5411,30,9972,122829,122859,21
1865,104,9972,965035,965139,22
6239,70,9972,723980,724050,24
7818,297,9972,1370896,1371193,37
9431,165,9973,1405459,1405624,1
2557,136,9973,844685,844821,13
9710,4,9973,25990,25994,45
6223,216,9975,1458367,1458583,2
6733,49,9975,724069,724118,3
3189,134,9975,1177204,1177338,8
5041,218,9975,1428785,1429003,11
1068,231,9975,1428792,1429023,14
3143,140,9975,1177273,1177413,43
4773,231,9976,1428827,1429058,8
1770,300,9976,1076190,1076490,17
4993,91,9976,282851,282942,17
3542,87,9976,489195,489282,26
5997,245,9976,1076299,1076544,30
9925,36,9976,489271,489307,45
7575,63,9977,602564,602627,25
5444,73,9977,844911,844984,43
1680,278,9978,1467082,1467360,7
5676,202,9978,1405526,1405728,9
3513,154,9978,602537,602691,17
6511,21,9978,196452,196473,20
9744,248,9978,1260078,1260326,50
9549,34,9979,381989,382023,16
4065,20,9979,283032,283052,19
8380,102,9979,489304,489406,41
4701,256,9979,1260137,1260393,45
2714,150,9979,1177385,1177535,49
9137,113,9979,965322,965435,49
2814,95,9979,845020,845115,50
3099,106,9979,845050,845156,50
1971,282,9980,1446115,1446397,48
6845,162,9981,1405613,1405775,3
8436,81,9981,489419,489500,8
7605,155,9981,724259,724414,31
9364,94,9981,602736,602830,37
8258,201,9981,1405599,1405800,39
6606,117,9982,845109,845226,27
2493,280,9982,1428856,1429136,43
9613,254,9983,1467140,1467394,4
6128,22,9983,123087,123109,7
5056,204,9983,1405660,1405864,12
6158,225,9983,965363,965588,30
5149,231,9983,1177441,1177672,42
2284,148,9984,1371290,1371438,4
6031,192,9984,1371276,1371468,8
8754,228,9984,1428957,1429185,9
7273,100,9984,724482,724582,23
4591,79,9985,602912,602991,9
4120,239,9985,1177519,1177758,36
4612,7,9985,66617,66624,44
2767,128,9986,1076705,1076833,11
4755,198,9986,1371316,1371514,11
1560,220,9986,1177586,1177806,26
5831,136,9986,724546,724682,36
9792,218,9986,1177616,1177834,36
4973,115,9986,1076801,1076916,38
8675,169,9986,845344,845513,40
5941,40,9986,382355,382395,47
1724,205,9987,1076755,1076960,13
7192,236,9987,1324976,1325212,13
4276,46,9987,283358,283404,37
2192,278,9988,1475174,1475452,2
8446,49,9988,603135,603184,4
6095,132,9988,1076893,1077025,8
1013,246,9988,1446214,1446460,9
1497,268,9988,1371307,1371575,10
5730,163,9988,724734,724897,10
6535,167,9988,1325105,1325272,11
1203,228,9988,1177706,1177934,15
7852,240,9988,1371365,1371605,16
1914,25,9988,283481,283506,19
6025,191,9988,1325134,1325325,38
5118,222,9988,1371427,1371649,43
8283,245,9989,1371449,1371694,22
4519,65,9989,489955,490020,27
9567,293,9989,1371442,1371735,37
7989,94,9990,1177976,1178070,1
5079,234,9990,1429016,1429250,11
7930,162,9990,1260618,1260780,12
9406,36,9990,196882,196918,26
2197,151,9990,965909,966060,37
7263,26,9990,382599,382625,43
7916,217,9991,1371571,1371788,43
9968,276,9992,1260579,1260855,15
8703,12,9992,196935,196947,33
7087,225,9992,1260668,1260893,37
3167,142,9992,1178074,1178216,43
3474,230,9992,1260697,1260927,44
3406,47,9993,725113,725160,3
5224,190,9993,1429089,1429279,4
9305,165,9993,1178133,1178298,14
6473,181,9993,1178160,1178341,16
2420,122,9993,845838,845960,35
8681,246,9993,1260725,1260971,36
9483,121,9993,1178265,1178386,39
2809,157,9993,845873,846030,40
4281,54,9993,490193,490247,49
1922,108,9994,845945,846053,11
5019,89,9994,845989,846078,14
2686,26,9994,66823,66849,17
5152,133,9994,845991,846124,20
9460,15,9994,123452,123467,35
9999,104,9994,725250,725354,37
8256,52,9995,283705,283757,8
8529,171,9995,966118,966289,15
1248,23,9995,283753,283776,16
3744,91,9995,382768,382859,21
2685,149,9995,966194,966343,45
8918,30,9996,283780,283810,29
2846,32,9996,123493,123525,31
8230,30,9996,123506,123536,31
1376,22,9996,283800,283822,33
1707,81,9996,490265,490346,37
1856,25,9996,283819,283844,45
2507,152,9997,846068,846220,15
6945,280,9997,1260743,1261023,15
8508,46,9997,603689,603735,19
1188,130,9997,603639,603769,21
1864,74,9997,725394,725468,38
8104,22,9997,283877,283899,38
8089,55,9998,725427,725482,6
1608,61,9998,382908,382969,8
7271,143,9998,846142,846285,15
7667,186,9998,1077320,1077506,18
4248,19,9998,197195,197214,25
1104,19,9998,283929,283948,43
6590,70,9999,725473,725543,25
7616,99,9999,490393,490492,36
7288,167,9999,966260,966427,42
1109,95,9999,725493,725588,47

Average Waiting Time = 873336

Average Turn Around Time = 873485
