Process,Burst Time,Arrival Time,Waiting Time,Turn Around Time,Priority
1,18,2,0,18,1
41,1,11,70,71,1
29,2,27,55,57,1
9,3,67,17,20,1
22,15,4,83,98,1
33,19,59,43,62,1
86,20,24,97,117,1
60,22,59,82,104,1
2,27,20,143,170,1
47,29,21,169,198,1
36,35,40,179,214,1
45,36,70,184,220,1
77,36,74,216,252,1
16,38,20,306,344,1
59,40,45,319,359,1
93,44,4,400,444,1
85,44,45,403,447,1
20,46,13,479,525,1
62,5,88,6037,6042,1
43,24,95,6035,6059,1
13,25,89,6065,6090,1
98,37,90,6089,6126,1
357,55,954,5262,5317,1
416,57,309,5962,6019,1
554,67,351,5977,6044,1
673,88,962,5433,5521,1
3290,1,8621,117018,117019,1
9052,1,8908,116732,116733,1
3017,2,9478,116163,116165,1
9565,3,8111,117532,117535,1
2488,3,9763,115883,115886,1
4158,4,9240,116409,116413,1
9566,6,9794,115859,115865,1
7416,7,9819,115840,115847,1
9464,9,9534,116132,116141,1
1727,10,9903,115772,115782,1
1138,12,9852,115833,115845,1
4423,13,8523,117174,117187,1
2990,14,8004,117706,117720,1
5012,14,9432,116292,116306,1
3186,15,8294,117444,117459,1
2210,15,9492,116261,116276,1
5888,18,9686,116082,116100,1
1519,20,8269,117517,117537,1
5586,23,9389,116417,116440,1
3699,24,8398,117431,117455,1
5116,24,9721,116132,116156,1
6955,27,8743,117134,117161,1
7151,33,8589,117315,117348,1
3566,34,8609,117328,117362,1
1671,48,9624,116347,116395,1
8109,49,9088,116931,116980,1
7688,49,9715,116353,116402,1
5861,50,8700,117417,117467,1
5785,50,8957,117210,117260,1
7374,50,9091,117126,117176,1
9444,50,9314,116953,117003,1
5157,51,8155,118162,118213,1
5259,53,8793,117575,117628,1
9170,54,8798,117623,117677,1
6044,58,8203,118272,118330,1
5609,58,9793,116740,116798,1
8208,59,8332,118259,118318,1
8163,59,8674,117976,118035,1
8863,62,8181,118528,118590,1
5459,62,9143,117628,117690,1
3938,64,8074,118759,118823,1
7286,64,8409,118488,118552,1
6548,66,8105,118856,118922,1
6347,68,9275,117752,117820,1
8917,69,8204,118891,118960,1
3013,70,9682,117482,117552,1
1559,71,8731,118503,118574,1
9045,73,9022,118283,118356,1
2262,74,9954,117424,117498,1
4579,77,8291,119161,119238,1
8401,78,8207,119322,119400,1
6166,78,9625,117982,118060,1
6257,81,8876,118809,118890,1
8494,82,8254,119512,119594,1
9928,83,8087,119761,119844,1
4825,83,8515,119416,119499,1
5202,83,9007,119007,119090,1
110,183,52,127945,128128,1
3505,85,8602,119578,119663,1
3732,87,8886,119379,119466,1
4856,87,9398,118954,119041,1
3261,92,8843,119596,119688,1
3803,93,8292,120239,120332,1
6740,94,8751,119873,119967,1
7989,94,9990,118728,118822,1
9330,97,9127,119685,119782,1
9192,98,9076,119833,119931,1
1849,98,9588,119419,119517,1
827,148,430,128625,128773,1
8199,99,8642,120561,120660,1
3966,99,8952,120350,120449,1
3653,104,8568,1378015,1378119,1
3295,106,9514,1377123,1377229,1
1837,109,8435,1378258,1378367,1
2018,113,8130,1378622,1378735,1
8660,113,8911,1377904,1378017,1
2750,114,8530,1378348,1378462,1
6217,115,8194,1378748,1378863,1
3040,115,9452,1377555,1377670,1
2451,116,9449,1377623,1377739,1
724,166,516,1386572,1386738,1
2710,117,9684,1377520,1377637,1
4883,118,8227,1379044,1379162,1
4358,119,8276,1379063,1379182,1
8842,121,8946,1378462,1378583,1
5365,121,8955,1378524,1378645,1
3102,122,9411,1378139,1378261,1
4339,125,8186,1379436,1379561,1
337,175,842,1386805,1386980,1
7003,126,9962,1377810,1377936,1
3204,129,8530,1379318,1379447,1
3101,131,8988,1378939,1379070,1
9527,138,9806,1378202,1378340,1
9626,143,9324,1378772,1378915,1
7592,144,8432,1379757,1379901,1
5160,144,9338,1378945,1379089,1
8142,144,9722,1378655,1378799,1
6435,146,8388,1380083,1380229,1
9617,147,8086,1380481,1380628,1
3926,148,8627,1380037,1380185,1
4052,148,9422,1379340,1379488,1
7780,149,8311,1380549,1380698,1
7950,149,8718,1380241,1380390,1
3929,151,8965,1413045,1413196,1
2003,152,8016,1414045,1414197,1
2887,153,8139,1413974,1414127,1
4181,153,9921,1412245,1412398,1
3339,154,9181,1413038,1413192,1
6629,155,8344,1413929,1414084,1
7289,155,9132,1413196,1413351,1
3525,157,8853,1413530,1413687,1
3641,158,9116,1413324,1413482,1
8575,165,8068,1414430,1414595,1
9431,165,9973,1412590,1412755,1
1925,166,8888,1413740,1413906,1
8981,167,9229,1413465,1413632,1
693,217,190,1422521,1422738,1
8241,168,9342,1413486,1413654,1
8194,168,9531,1413365,1413533,1
6918,170,8512,1414452,1414622,1
3306,170,8522,1414512,1414682,1
815,222,104,1422950,1423172,1
8595,174,9032,1414144,1414318,1
624,224,969,1422231,1422455,1
3282,175,8668,1414656,1414831,1
7320,181,9540,1413859,1414040,1
5374,182,8000,1415480,1415662,1
5720,184,8527,1415035,1415219,1
8686,184,9833,1413813,1413997,1
5512,187,8296,1415434,1415621,1
126,290,73,1423644,1423934,1
7096,191,8515,1415392,1415583,1
4066,192,9951,1414047,1414239,1
7417,193,8157,1415933,1416126,1
9032,193,8610,1415573,1415766,1
5779,193,9197,1415079,1415272,1
7734,194,9764,1414605,1414799,1
4807,195,8918,1415545,1415740,1
1358,195,9302,1415256,1415451,1
1431,196,8402,1416251,1416447,1
6468,200,8135,1416614,1416814,1
6775,200,8648,1416201,1416401,1
9942,200,8879,1416070,1416270,1
5065,202,8395,1443761,1443963,1
4045,202,9148,1443060,1443262,1
2527,203,8203,1444057,1444260,1
2768,209,9357,1442956,1443165,1
8635,209,9761,1442611,1442820,1
2001,209,9900,1442531,1442740,1
8976,210,8649,1443841,1444051,1
7661,211,9828,1442722,1442933,1
3931,216,9609,1443002,1443218,1
6280,217,8243,1444434,1444651,1
6338,217,9786,1442958,1443175,1
3826,218,9520,1443291,1443509,1
3822,219,8402,1444477,1444696,1
9040,219,9494,1443454,1443673,1
9225,223,8771,1444246,1444469,1
6467,223,9412,1443678,1443901,1
8080,227,9151,1444012,1444239,1
2074,227,9593,1443647,1443874,1
804,278,629,1452638,1452916,1
9268,229,8273,1445122,1445351,1
6772,231,8112,1445362,1445593,1
6616,234,8181,1445374,1445608,1
4289,234,9278,1444361,1444595,1
6282,235,9940,1443783,1444018,1
2073,237,8428,1445380,1445617,1
7515,237,9830,1444065,1444302,1
9437,238,9027,1444955,1445193,1
2068,240,8101,1445969,1446209,1
3451,242,9076,1445084,1445326,1
2489,243,8858,1445394,1445637,1
589,294,196,1454099,1454393,1
8445,246,8417,1446022,1446268,1
8796,246,9074,1445461,1445707,1
8387,249,8950,1445681,1445930,1
9720,251,8162,1464689,1464940,1
7706,252,9723,1463179,1463431,1
3879,254,9868,1463086,1463340,1
8211,255,8312,1464696,1464951,1
3421,255,8532,1464531,1464786,1
8497,257,8165,1464953,1465210,1
8317,258,8471,1464704,1464962,1
2654,260,8591,1464642,1464902,1
2797,260,8768,1464525,1464785,1
8185,260,8862,1464491,1464751,1
6388,260,9556,1463857,1464117,1
8745,262,8296,1465177,1465439,1
8190,265,9622,1463913,1464178,1
7330,267,9430,1464170,1464437,1
9450,269,9901,1463766,1464035,1
5502,273,9208,1464528,1464801,1
5455,275,9121,1464688,1464963,1
6928,275,9656,1464228,1464503,1
5218,276,9075,1464884,1465160,1
9650,277,8497,1465538,1465815,1
8914,278,9310,1464802,1465080,1
9559,280,8372,1465818,1466098,1
5717,281,9497,1464773,1465054,1
1424,282,9025,1465326,1465608,1
2502,283,9896,1464537,1464820,1
4929,285,9038,1465478,1465763,1
9623,286,8600,1466001,1466287,1
6359,287,8001,1466686,1466973,1
5003,288,8869,1465905,1466193,1
2509,288,9736,1465126,1465414,1
6877,289,9220,1465730,1466019,1
4495,290,9767,1465272,1465562,1
7528,292,8313,1466816,1467108,1
8098,292,9310,1465911,1466203,1
5001,292,9822,1465491,1465783,1
5828,293,8658,1466747,1467040,1
8804,296,9746,1465752,1466048,1
4587,297,9590,1466004,1466301,1
1411,298,8728,1466963,1467261,1
6290,299,8502,1467287,1467586,1
1214,300,8501,1467387,1467687,1
6582,300,9668,1466320,1466620,1
28,1,36,602,603,2
5,9,52,587,596,2
24,16,3,645,661,2
34,16,23,641,657,2
4,16,49,631,647,2
70,16,58,638,654,2
49,16,67,645,661,2
91,19,74,654,673,2
17,20,14,733,753,2
50,21,54,713,734,2
68,23,55,733,756,2
39,23,65,746,769,2
57,26,17,817,843,2
51,26,21,839,865,2
79,39,51,835,874,2
21,40,12,913,953,2
53,41,66,899,940,2
298,46,74,932,978,2
25,47,18,1034,1081,2
40,48,44,1055,1103,2
61,48,65,1082,1130,2
99,48,81,1114,1162,2
19,1,87,6896,6897,2
210,8,948,6036,6044,2
82,15,83,6909,6924,2
608,19,198,6809,6828,2
830,28,314,6712,6740,2
452,33,887,6167,6200,2
56,50,90,6997,7047,2
197,52,580,6557,6609,2
937,55,98,7091,7146,2
794,65,98,7146,7211,2
3472,2,8877,127924,127926,2
6911,3,8641,128162,128165,2
9757,3,9273,127533,127536,2
9218,4,9762,127047,127051,2
1413,6,8023,128790,128796,2
2505,7,8505,128314,128321,2
4302,12,8592,128234,128246,2
3670,12,9115,127723,127735,2
7076,13,8864,127986,127999,2
6503,13,9209,127654,127667,2
7283,22,8478,128398,128420,2
1563,30,8780,128118,128148,2
6808,30,9089,127839,127869,2
8479,31,8700,128258,128289,2
5780,32,8021,128968,129000,2
5862,33,9349,127672,127705,2
9011,34,8481,128573,128607,2
4677,35,8581,128507,128542,2
3603,35,9781,127342,127377,2
2756,37,9706,127452,127489,2
1992,40,8223,128972,129012,2
8379,40,9463,127772,127812,2
8516,42,9568,127707,127749,2
1259,44,8308,129009,129053,2
1379,46,8815,128546,128592,2
6106,46,8954,128453,128499,2
6974,46,9119,128334,128380,2
8103,47,9831,127668,127715,2
6854,48,8698,128848,128896,2
9686,53,9045,128549,128602,2
6263,54,8862,128785,128839,2
2963,58,8410,129291,129349,2
1594,59,9210,128549,128608,2
1565,60,9674,128144,128204,2
8785,60,9948,127930,127990,2
5689,61,8179,129759,129820,2
8640,61,8563,129436,129497,2
5323,72,9942,128118,128190,2
2379,73,9011,129121,129194,2
6720,74,9438,128767,128841,2
9647,82,8839,129440,129522,2
6233,83,9448,128913,128996,2
1958,84,9325,129119,129203,2
6241,87,9422,129106,129193,2
2611,90,9079,129536,129626,2
2926,93,8128,130577,130670,2
6624,94,8492,130306,130400,2
5143,96,8271,130621,130717,2
9284,98,9966,129022,129120,2
800,125,991,138732,138857,2
410,129,946,138902,139031,2
752,134,686,139242,139376,2
891,135,563,139450,139585,2
959,151,80,140361,140512,2
6524,101,9475,1385384,1385485,2
2306,102,8460,1386451,1386553,2
2472,102,8857,1386107,1386209,2
2593,105,8060,1386957,1387062,2
3546,105,9443,1385630,1385735,2
5205,107,9346,1385783,1385890,2
6190,109,8400,1386787,1386896,2
249,159,557,1394640,1394799,2
9200,116,8654,1386653,1386769,2
3077,116,8988,1386386,1386502,2
3080,118,9224,1386217,1386335,2
7261,119,8647,1386863,1386982,2
7483,119,8811,1386769,1386888,2
7231,122,8265,1387385,1387507,2
6553,124,8725,1386998,1387122,2
8906,126,8268,1387530,1387656,2
989,230,78,1395697,1395927,2
3868,135,8070,1387886,1388021,2
4620,137,8793,1387249,1387386,2
7806,140,8895,1387235,1387375,2
7094,141,8492,1387729,1387870,2
3995,141,8522,1387791,1387932,2
9078,144,8514,1387891,1388035,2
2323,144,9582,1386918,1387062,2
256,195,459,1396086,1396281,2
3721,147,9656,1387035,1387182,2
1554,151,8580,1420270,1420421,2
5532,151,9382,1419520,1419671,2
4107,151,9918,1419036,1419187,2
5682,152,8213,1420793,1420945,2
1763,153,9184,1419875,1420028,2
6900,157,8977,1420136,1420293,2
6508,160,8688,1420483,1420643,2
9642,161,8898,1420334,1420495,2
5270,166,8209,1421085,1421251,2
8377,166,9705,1419656,1419822,2
6276,168,8845,1420583,1420751,2
7732,169,8791,1420706,1420875,2
4082,170,9132,1420435,1420605,2
3252,171,9496,1420142,1420313,2
6012,171,9959,1419751,1419922,2
805,221,755,1428977,1429198,2
6873,172,9338,1420516,1420688,2
7266,172,9466,1420461,1420633,2
4478,174,8100,1421900,1422074,2
2019,174,9485,1420590,1420764,2
869,224,524,1429576,1429800,2
5128,176,9418,1420807,1420983,2
7760,177,8049,1422253,1422430,2
1266,178,9064,1421316,1421494,2
4492,181,8453,1422006,1422187,2
9177,183,9397,1421144,1421327,2
5797,184,8321,1422304,1422488,2
9891,187,9739,1420971,1421158,2
8941,188,9554,1421244,1421432,2
2583,189,9752,1421135,1421324,2
3944,191,8658,1422319,1422510,2
7996,192,9230,1421839,1422031,2
9014,196,8942,1422220,1422416,2
5885,196,9235,1422024,1422220,2
8023,196,9924,1421432,1421628,2
6587,198,8052,1423401,1423599,2
6585,201,8910,1447921,1448122,2
1634,202,8881,1448002,1448204,2
2565,202,9419,1447517,1447719,2
1187,205,8959,1448030,1448235,2
1542,210,8275,1448770,1448980,2
2788,212,9065,1448041,1448253,2
4352,213,8364,1448805,1449018,2
8385,214,8637,1448596,1448810,2
1696,216,8259,1449039,1449255,2
6223,216,9975,1447390,1447606,2
2781,218,8294,1449138,1449356,2
7368,219,8652,1448849,1449068,2
8811,227,8469,1449102,1449329,2
1227,229,8631,1449018,1449247,2
9038,231,8161,1449568,1449799,2
5616,233,8850,1448961,1449194,2
777,284,362,1457483,1457767,2
3318,235,8085,1449895,1450130,2
8738,237,8507,1449559,1449796,2
3286,237,9734,1448420,1448657,2
3448,237,9806,1448436,1448673,2
163,288,136,1458144,1458432,2
8483,240,8571,1449848,1450088,2
6886,241,9271,1449239,1449480,2
9326,248,8783,1449819,1450067,2
7529,248,9357,1449344,1449592,2
7225,251,8292,1467797,1468048,2
7621,252,8825,1467316,1467568,2
2112,252,8898,1467296,1467548,2
7954,252,9084,1467163,1467415,2
4488,254,9768,1466532,1466786,2
6279,257,9923,1466432,1466689,2
3755,258,9617,1466796,1467054,2
3861,259,8037,1468435,1468694,2
9926,259,9348,1467184,1467443,2
2435,260,8646,1467946,1468206,2
9785,265,9746,1466907,1467172,2
6956,271,9107,1467612,1467883,2
5171,272,8527,1468264,1468536,2
2444,272,9411,1467453,1467725,2
5708,275,9822,1467115,1467390,2
9190,277,8193,1468820,1469097,2
2192,278,9988,1467103,1467381,2
4055,279,9755,1467415,1467694,2
6099,281,8436,1468814,1469095,2
2299,281,8834,1468498,1468779,2
4513,281,9502,1467912,1468193,2
5591,283,9330,1468166,1468449,2
4723,288,8423,1469157,1469445,2
2874,288,8461,1469208,1469496,2
5841,292,8652,1469106,1469398,2
1829,292,9140,1468711,1469003,2
7453,294,8736,1469208,1469502,2
9525,300,9650,1475050,1475350,2
38,15,1,19,34,3
14,1,19,1322,1323,3
75,2,73,1269,1271,3
46,5,63,1281,1286,3
74,7,68,1281,1288,3
78,7,69,1287,1294,3
37,9,32,1331,1340,3
92,26,77,1295,1321,3
55,28,25,1373,1401,3
18,28,31,1395,1423,3
32,29,9,1445,1474,3
84,29,27,1456,1485,3
87,29,67,1445,1474,3
44,31,35,1506,1537,3
23,36,18,1554,1590,3
89,36,75,1533,1569,3
58,37,23,1621,1658,3
64,39,54,1627,1666,3
72,45,12,1708,1753,3
35,45,42,1723,1768,3
54,47,56,1754,1801,3
97,49,64,1793,1842,3
853,12,450,7449,7461,3
332,23,250,7661,7684,3
73,27,90,7844,7871,3
8484,1,8733,136423,136424,3
5084,6,9553,135604,135610,3
4529,8,8825,136338,136346,3
1809,10,8867,136304,136314,3
3585,11,9355,135826,135837,3
2904,12,8409,136783,136795,3
1241,18,8076,137128,137146,3
3756,19,9584,135638,135657,3
7363,23,8637,136604,136627,3
3889,24,9844,135420,135444,3
2619,25,8169,137119,137144,3
3907,29,8799,136514,136543,3
4305,30,8732,136610,136640,3
7408,30,8758,136614,136644,3
4437,31,9386,136016,136047,3
4808,32,8415,137018,137050,3
1181,32,8661,136804,136836,3
2467,34,8968,136529,136563,3
9741,35,9566,135965,136000,3
1875,36,9251,136315,136351,3
7663,36,9262,136340,136376,3
2070,38,8230,137408,137446,3
9365,41,8393,137283,137324,3
8177,41,9300,136417,136458,3
8126,42,9627,136131,136173,3
3406,47,9993,135807,135854,3
6733,49,9975,135872,135921,3
8426,50,8068,137828,137878,3
1792,56,9021,136925,136981,3
8519,56,9877,136125,136181,3
8301,57,9509,136549,136606,3
6050,61,9299,136816,136877,3
4185,61,9578,136598,136659,3
4527,65,8915,137322,137387,3
4647,65,9015,137287,137352,3
7573,68,9335,137032,137100,3
2232,74,8747,137688,137762,3
5199,75,8345,138164,138239,3
5622,75,9242,137342,137417,3
5869,76,8749,137910,137986,3
9024,76,9182,137553,137629,3
5889,76,9955,136856,136932,3
9541,77,8930,137957,138034,3
5237,78,8207,138757,138835,3
4373,78,8966,138076,138154,3
9868,82,8023,139097,139179,3
6458,82,9638,137564,137646,3
2723,84,9556,137728,137812,3
5931,85,9654,137714,137799,3
8350,85,9749,137704,137789,3
1066,86,8345,139193,139279,3
3140,86,8461,139163,139249,3
2286,92,8068,139642,139734,3
2821,92,8966,138836,138928,3
2766,93,9564,138330,138423,3
3701,95,8086,139901,139996,3
358,110,617,147801,147911,3
843,126,683,148037,148163,3
790,133,334,148560,148693,3
1453,98,8272,1393018,1393116,3
6054,99,9546,1391794,1391893,3
7969,100,8865,1392526,1392626,3
2257,102,8040,1393403,1393505,3
8075,102,8156,1393341,1393443,3
8202,104,9537,1392014,1392118,3
3358,106,9786,1391821,1391927,3
6864,109,9822,1391843,1391952,3
9356,111,8053,1393673,1393784,3
1267,114,9187,1392602,1392716,3
6325,115,8592,1393263,1393378,3
8099,122,9964,1391958,1392080,3
4598,125,9257,1392739,1392864,3
5545,130,9163,1392910,1393040,3
5581,131,9326,1392829,1392960,3
3661,133,8302,1393936,1394069,3
8295,133,9595,1392728,1392861,3
9725,136,8031,1394377,1394513,3
4475,136,8181,1394315,1394451,3
6168,136,9842,1392742,1392878,3
6738,137,9237,1393435,1393572,3
3011,138,8508,1394253,1394391,3
9616,138,9068,1393783,1393921,3
5059,139,9892,1393049,1393188,3
1161,141,9309,1393723,1393864,3
602,198,77,1404517,1404715,3
5377,147,9211,1425043,1425190,3
7949,147,9775,1424529,1424676,3
5663,148,9182,1425172,1425320,3
7932,149,9626,1424779,1424928,3
7340,151,9093,1425364,1425515,3
1064,154,9462,1425049,1425203,3
8195,156,9668,1424900,1425056,3
6307,157,9932,1424695,1424852,3
9135,158,8674,1426013,1426171,3
1233,161,9496,1425252,1425413,3
4928,161,9626,1425186,1425347,3
6845,162,9981,1424895,1425057,3
4780,164,9585,1425356,1425520,3
2452,169,8323,1426685,1426854,3
1464,169,9214,1425866,1426035,3
7731,170,9188,1425964,1426134,3
7423,171,9693,1425532,1425703,3
5487,173,8016,1427283,1427456,3
9724,173,8523,1426852,1427025,3
7365,173,9602,1425849,1426022,3
983,223,956,1434521,1434744,3
6860,174,8387,1427216,1427390,3
9775,175,9697,1425983,1426158,3
9894,180,8579,1427179,1427359,3
3459,180,9354,1426487,1426667,3
8141,181,9135,1426789,1426970,3
9805,182,9002,1427006,1427188,3
1593,183,8820,1427273,1427456,3
6941,186,8791,1427388,1427574,3
5887,193,9550,1426718,1426911,3
2343,195,8218,1428146,1428341,3
7881,195,9011,1427451,1427646,3
2556,196,9352,1427208,1427404,3
211,247,329,1436280,1436527,3
5144,199,9529,1450673,1450872,3
7017,201,9311,1450943,1451144,3
4104,202,8063,1452245,1452447,3
8579,202,8303,1452060,1452262,3
1526,206,9230,1451188,1451394,3
3292,206,9621,1450856,1451062,3
2185,208,8475,1452061,1452269,3
4775,210,8613,1451984,1452194,3
8062,212,9022,1451638,1451850,3
9850,212,9214,1451511,1451723,3
2633,214,9188,1451602,1451816,3
1321,214,9360,1451497,1451711,3
1223,217,9672,1451252,1451469,3
2983,218,9599,1451395,1451613,3
2124,221,9664,1451401,1451622,3
6591,222,8496,1452643,1452865,3
2761,223,9390,1451824,1452047,3
7326,225,9000,1452290,1452515,3
6401,226,8805,1452563,1452789,3
3183,226,9778,1451669,1451895,3
2757,228,8551,1452975,1453203,3
7362,231,9543,1452064,1452295,3
1687,231,9893,1451798,1452029,3
3839,233,8274,1453501,1453734,3
6434,238,8162,1453699,1453937,3
3227,242,8162,1453790,1454032,3
1406,242,9487,1452560,1452802,3
1787,243,9155,1452987,1453230,3
6269,245,8494,1453744,1453989,3
8903,245,8826,1453510,1453755,3
8853,246,9630,1452804,1453050,3
3575,248,8104,1469987,1470235,3
3923,250,9162,1468980,1469230,3
2375,250,9814,1468381,1468631,3
2815,251,8484,1469764,1470015,3
8549,253,9027,1469275,1469528,3
7319,253,9759,1468599,1468852,3
5296,254,8175,1470239,1470493,3
9001,254,9047,1469424,1469678,3
9977,263,8218,1470310,1470573,3
6120,263,9850,1468744,1469007,3
9666,266,9794,1468866,1469132,3
2244,272,8773,1469956,1470228,3
5561,274,9078,1469726,1470000,3
8224,276,9538,1469343,1469619,3
3958,277,8594,1470366,1470643,3
2496,278,9891,1469149,1469427,3
6786,279,8520,1470601,1470880,3
4474,280,8298,1470905,1471185,3
8184,282,8200,1471086,1471368,3
5124,283,8738,1470633,1470916,3
6657,284,9946,1469511,1469795,3
8883,287,8592,1470952,1471239,3
8322,288,9049,1470585,1470873,3
9546,292,9137,1470588,1470880,3
8570,292,9187,1470633,1470925,3
4453,295,8974,1470941,1471236,3
7788,295,9442,1470571,1470866,3
9115,296,8383,1471728,1472024,3
6092,297,8522,1471688,1471985,3
6426,298,9082,1475671,1475969,3
2405,298,9908,1474896,1475194,3
2201,299,8741,1476114,1476413,3
7943,299,9882,1475025,1475324,3
66,18,24,1930,1948,4
12,19,25,1947,1966,4
95,20,49,1942,1962,4
94,24,58,1953,1977,4
100,29,17,2018,2047,4
8,30,43,2021,2051,4
76,35,69,2025,2060,4
90,36,33,2096,2132,4
69,36,66,2099,2135,4
15,43,38,2163,2206,4
26,44,22,2222,2266,4
145,3,372,7878,7881,4
315,4,359,7894,7898,4
872,8,109,8148,8156,4
657,17,950,7315,7332,4
6,25,99,8183,8208,4
42,30,82,8225,8255,4
31,47,99,8238,8285,4
556,60,431,7953,8013,4
269,63,307,8137,8200,4
781,65,324,8183,8248,4
389,69,740,7832,7901,4
845,85,680,7961,8046,4
4876,2,8194,146069,146071,4
8665,2,9455,144810,144812,4
9257,3,8602,145665,145668,4
9073,3,9347,144923,144926,4
7469,11,9496,144777,144788,4
5131,13,9709,144575,144588,4
1964,14,9843,144454,144468,4
8086,15,8943,145368,145383,4
2339,16,9039,145287,145303,4
2605,20,9807,144535,144555,4
6056,21,9730,144632,144653,4
3394,22,9038,145345,145367,4
7445,23,9833,144572,144595,4
5318,24,9354,145074,145098,4
4025,25,8194,146258,146283,4
1583,26,8540,145937,145963,4
9181,26,8725,145778,145804,4
7917,26,9026,145503,145529,4
4364,30,8074,146481,146511,4
1778,33,9077,145508,145541,4
8672,33,9860,144758,144791,4
3003,36,8535,146116,146152,4
8251,39,8284,146403,146442,4
8430,39,9523,145203,145242,4
1037,40,9150,145615,145655,4
3081,40,9840,144965,145005,4
2048,41,8889,145956,145997,4
2491,43,9536,145350,145393,4
5710,44,8695,146234,146278,4
8446,49,9988,144985,145034,4
2250,52,9516,145506,145558,4
4526,53,8790,146284,146337,4
8791,54,9100,146027,146081,4
9427,55,8929,146252,146307,4
9569,55,9025,146211,146266,4
1684,56,9521,145770,145826,4
7803,60,9244,146103,146163,4
4243,73,8220,147187,147260,4
7668,73,9024,146456,146529,4
5816,74,8283,147270,147344,4
4951,74,9596,146031,146105,4
6729,75,9970,145731,145806,4
6059,80,9776,146000,146080,4
4197,81,8217,147639,147720,4
3445,81,9209,146728,146809,4
9890,83,8263,147755,147838,4
8846,83,9687,146414,146497,4
2476,84,8242,147942,148026,4
8033,85,8961,147307,147392,4
3034,85,9359,146994,147079,4
5500,86,8268,148170,148256,4
1361,88,9897,146627,146715,4
7771,89,9333,147279,147368,4
7739,91,8491,148210,148301,4
6868,94,8088,148704,148798,4
8014,94,8209,148677,148771,4
335,121,152,157345,157466,4
5923,96,8562,1399419,1399515,4
7636,99,8502,1399528,1399627,4
3061,99,8578,1399504,1399603,4
2504,103,9378,1398756,1398859,4
1279,104,9319,1398871,1398975,4
9402,105,8872,1399375,1399480,4
8781,108,8294,1400011,1400119,4
3219,110,9812,1398554,1398664,4
3349,116,9469,1398960,1399076,4
6642,118,9924,1398574,1398692,4
9586,120,8776,1399793,1399913,4
9618,120,9444,1399198,1399318,4
6121,122,9682,1399033,1399155,4
4545,123,8529,1400261,1400384,4
4255,124,9784,1399082,1399206,4
1977,125,9101,1399842,1399967,4
6250,126,9092,1399929,1400055,4
7744,136,8104,1400996,1401132,4
2207,140,8756,1400433,1400573,4
3943,140,9964,1399318,1399458,4
7972,144,8044,1431917,1432061,4
9280,144,8243,1431767,1431911,4
1107,146,9289,1430770,1430916,4
2284,148,9984,1430126,1430274,4
7672,151,8808,1431355,1431506,4
8916,154,9614,1430605,1430759,4
9156,155,8899,1431379,1431534,4
4649,159,9337,1431001,1431160,4
9098,161,8493,1431909,1432070,4
7046,161,8755,1431713,1431874,4
7903,162,9002,1431532,1431694,4
6671,163,8660,1431941,1432104,4
6165,164,9584,1431085,1431249,4
7422,164,9658,1431080,1431244,4
2399,166,9284,1431523,1431689,4
4268,168,8354,1432524,1432692,4
4727,169,9830,1431121,1431290,4
9068,170,9250,1431775,1431945,4
9219,173,8376,1432724,1432897,4
5809,173,9631,1431547,1431720,4
6857,174,9715,1431541,1431715,4
7154,180,8150,1433185,1433365,4
8963,180,8296,1433124,1433304,4
4596,182,9040,1432465,1432647,4
5517,183,8313,1433279,1433462,4
7098,184,9766,1431914,1432098,4
8871,184,9873,1431896,1432080,4
1479,187,8549,1433309,1433496,4
8933,189,9888,1432062,1432251,4
4202,190,8116,1433928,1434118,4
8956,190,8692,1433447,1433637,4
5224,190,9993,1432241,1432431,4
5078,193,8036,1434293,1434486,4
741,197,445,1441982,1442179,4
581,208,674,1442247,1442455,4
387,215,777,1442355,1442570,4
910,224,482,1442917,1443141,4
668,226,927,1442748,1442974,4
237,228,133,1443722,1443950,4
170,228,902,1443037,1443265,4
696,235,502,1443815,1444050,4
1287,194,9815,1454371,1454565,4
1347,197,8343,1455893,1456090,4
7726,198,8255,1456034,1456232,4
8542,200,8195,1456148,1456348,4
9232,200,9737,1454662,1454862,4
3788,202,8184,1456271,1456473,4
3987,202,8693,1455820,1456022,4
991,252,384,1464137,1464389,4
6194,205,9432,1455197,1455402,4
9053,206,9138,1455552,1455758,4
3153,207,9674,1455078,1455285,4
3921,209,8895,1455920,1456129,4
1231,210,9061,1455819,1456029,4
753,260,502,1464394,1464654,4
3599,211,8306,1456706,1456917,4
8674,218,9400,1455679,1455897,4
4766,220,8926,1456227,1456447,4
6327,221,9548,1455681,1455902,4
8910,222,9318,1455988,1456210,4
8384,224,9538,1455846,1456070,4
2928,225,8118,1457346,1457571,4
5777,225,8841,1456704,1456929,4
3454,225,9292,1456334,1456559,4
9157,227,8629,1457078,1457305,4
2401,227,8723,1457067,1457294,4
6834,229,9321,1456552,1456781,4
9506,230,9570,1456388,1456618,4
3864,231,9333,1456711,1456942,4
5022,231,9611,1456520,1456751,4
4827,232,8427,1457791,1458023,4
6735,232,8859,1457447,1457679,4
8466,239,9511,1456883,1457122,4
6493,240,9906,1456583,1456823,4
6438,241,8093,1458492,1458733,4
6479,241,9121,1457561,1457802,4
2512,242,8950,1457829,1458071,4
2038,242,9464,1457413,1457655,4
2845,243,8546,1458429,1458672,4
2171,243,9326,1457748,1457991,4
429,294,383,1466740,1467034,4
686,294,954,1466269,1466563,4
7765,248,9171,1471342,1471590,4
5097,249,9432,1471135,1471384,4
1211,253,8396,1472226,1472479,4
2989,253,8660,1472021,1472274,4
6234,254,9173,1471567,1471821,4
9613,254,9983,1470817,1471071,4
8616,262,8600,1472260,1472522,4
4980,262,9209,1471719,1471981,4
2523,264,9577,1471419,1471683,4
7382,265,8470,1472596,1472861,4
9072,269,9701,1471436,1471705,4
8340,274,8064,1473148,1473422,4
4271,277,9008,1472284,1472561,4
5282,280,9338,1472037,1472317,4
3616,280,9382,1472079,1472359,4
1798,283,8032,1473515,1473798,4
6700,283,9492,1472144,1472427,4
8121,286,9136,1472589,1472875,4
4376,287,9951,1471866,1472153,4
6695,299,9234,1475728,1476027,4
30,46,1,34,80,5
67,3,19,2269,2272,5
11,4,7,2284,2288,5
7,8,34,2261,2269,5
81,11,31,2272,2283,5
83,15,64,2250,2265,5
10,16,27,2302,2318,5
3,26,16,2329,2355,5
96,26,24,2347,2373,5
27,27,34,2363,2390,5
65,29,16,2408,2437,5
80,30,27,2426,2456,5
71,35,49,2434,2469,5
63,40,29,2489,2529,5
88,41,7,2551,2592,5
612,65,60,2539,2604,5
325,4,356,8981,8985,5
689,8,801,8540,8548,5
48,10,93,9256,9266,5
52,17,82,9277,9294,5
219,30,644,8732,8762,5
984,35,577,8829,8864,5
898,51,447,8994,9045,5
295,82,643,8849,8931,5
4303,1,9406,153394,153395,5
9728,1,9591,153210,153211,5
5476,4,9692,153110,153114,5
3045,5,9148,153658,153663,5
9903,8,9718,153093,153101,5
7665,8,9896,152923,152931,5
8097,11,8150,154677,154688,5
7106,13,8525,154313,154326,5
3848,16,8312,154539,154555,5
7520,17,8700,154167,154184,5
7187,23,9711,153173,153196,5
2316,24,9161,153746,153770,5
6522,26,9077,153854,153880,5
2010,27,8855,154102,154129,5
6680,28,8816,154168,154196,5
5670,28,9092,153920,153948,5
7059,29,8125,154915,154944,5
1899,35,9140,153929,153964,5
4583,37,8345,154759,154796,5
5839,37,8554,154587,154624,5
8022,37,8810,154368,154405,5
8342,39,9040,154175,154214,5
3353,40,8496,154758,154798,5
8107,40,8806,154488,154528,5
1598,43,8004,155330,155373,5
4862,43,8727,154650,154693,5
7742,45,8191,155229,155274,5
1399,47,8668,154797,154844,5
3882,48,8005,155507,155555,5
3082,48,8392,155168,155216,5
4372,48,8948,154660,154708,5
1182,48,9919,153737,153785,5
2806,49,9298,154406,154455,5
8970,51,9283,154470,154521,5
5851,54,8005,155799,155853,5
8879,55,8321,155537,155592,5
4522,56,9949,153964,154020,5
7934,58,8235,155734,155792,5
8972,58,9949,154078,154136,5
2333,59,9311,154774,154833,5
7335,62,9946,154198,154260,5
8412,63,8481,155725,155788,5
2967,72,9193,155076,155148,5
5788,72,9917,154424,154496,5
4460,75,8995,155418,155493,5
3316,75,9602,154886,154961,5
5426,77,9942,154621,154698,5
7623,78,8391,156249,156327,5
6040,79,8258,156460,156539,5
4074,79,8924,155873,155952,5
5716,79,9208,155668,155747,5
5316,83,9218,155737,155820,5
1008,87,9557,155481,155568,5
5358,88,8467,156658,156746,5
6811,88,8906,156307,156395,5
5239,89,9054,156247,156336,5
9385,90,9653,155737,155827,5
4764,92,9340,156140,156232,5
147,124,936,165602,165726,5
960,140,630,166492,166632,5
8663,93,8360,1405924,1406017,5
7678,93,9185,1405146,1405239,5
2400,97,9011,1405367,1405464,5
7201,98,8668,1405761,1405859,5
8151,98,9649,1404832,1404930,5
6047,99,8233,1406300,1406399,5
7751,99,9469,1405117,1405216,5
2979,103,8578,1406061,1406164,5
3622,103,8602,1406094,1406197,5
4712,105,9921,1404832,1404937,5
7072,106,8845,1405967,1406073,5
8503,108,8446,1406426,1406534,5
9304,109,8953,1405981,1406090,5
6637,109,9800,1405197,1405306,5
3360,113,9176,1405884,1405997,5
7472,113,9478,1405649,1405762,5
5840,118,8647,1406547,1406665,5
2736,120,9085,1406181,1406301,5
8748,121,9053,1406287,1406408,5
7138,121,9215,1406200,1406321,5
6370,122,8875,1406615,1406737,5
2439,123,8461,1407105,1407228,5
8028,124,8904,1406739,1406863,5
3300,124,9113,1406608,1406732,5
5990,124,9261,1406538,1406662,5
8573,124,9394,1406483,1406607,5
2831,125,8883,1407072,1407197,5
2727,127,8150,1407884,1408011,5
2906,127,8716,1407399,1407526,5
2822,127,9876,1406320,1406447,5
2052,129,9343,1406934,1407063,5
2662,131,8959,1407401,1407532,5
2417,132,8392,1408053,1408185,5
660,142,810,1415721,1415863,5
345,173,990,1416624,1416797,5
484,180,698,1417137,1417317,5
292,187,105,1418099,1418286,5
8818,141,8637,1437394,1437535,5
6413,144,8494,1437585,1437729,5
1632,147,9525,1436605,1436752,5
9093,150,9615,1436569,1436719,5
8394,153,8879,1437362,1437515,5
8784,153,9604,1436697,1436850,5
7133,154,9556,1436805,1436959,5
8048,156,9614,1436808,1436964,5
8004,157,8957,1437528,1437685,5
2544,160,9640,1436909,1437069,5
2064,162,9787,1436829,1436991,5
6567,163,8860,1437825,1437988,5
3447,165,8017,1438738,1438903,5
3109,165,8991,1437836,1438001,5
7884,166,9509,1437390,1437556,5
7931,167,8590,1438382,1438549,5
5967,168,8056,1438990,1439158,5
7535,169,8312,1438809,1438978,5
8626,169,8767,1438430,1438599,5
6556,169,9691,1437582,1437751,5
2455,170,9966,1437383,1437553,5
5842,171,8269,1439157,1439328,5
4363,172,8066,1439438,1439610,5
2093,174,8974,1438609,1438783,5
8488,175,8509,1439155,1439330,5
8200,178,8196,1439550,1439728,5
5521,180,8300,1439531,1439711,5
6814,180,8303,1439615,1439795,5
6897,180,8988,1439017,1439197,5
4313,181,8151,1439941,1440122,5
5814,182,9745,1438435,1438617,5
3692,185,9530,1438739,1438924,5
420,201,291,1448550,1448751,5
711,202,920,1447981,1448183,5
511,221,560,1449122,1449343,5
6851,190,9096,1459280,1459470,5
4771,192,8754,1459671,1459863,5
8336,193,8438,1460038,1460231,5
9492,194,8688,1459840,1460034,5
9938,194,8925,1459656,1459850,5
8832,194,9360,1459274,1459468,5
5632,195,8717,1459970,1460165,5
6343,195,9140,1459601,1459796,5
6848,197,8054,1460741,1460938,5
3391,197,8633,1460218,1460415,5
7910,200,8022,1460885,1461085,5
3530,203,8335,1460631,1460834,5
5167,204,9091,1459937,1460141,5
8008,204,9886,1459205,1459409,5
5944,208,8368,1460786,1460994,5
9804,209,9678,1459543,1459752,5
9675,209,9714,1459575,1459784,5
2690,211,8868,1460489,1460700,5
2929,211,9508,1459919,1460130,5
7689,212,8500,1460997,1461209,5
9197,212,9615,1459953,1460165,5
5209,213,9278,1460361,1460574,5
6885,215,8192,1461519,1461734,5
3324,215,8309,1461476,1461691,5
3820,216,9327,1460532,1460748,5
8167,220,8313,1461621,1461841,5
6673,222,9322,1460691,1460913,5
6032,222,9345,1460749,1460971,5
6167,224,9240,1460935,1461159,5
8214,224,9291,1460967,1461191,5
3130,227,8640,1461701,1461928,5
8055,229,8162,1462265,1462494,5
4085,232,9117,1461398,1461630,5
5951,232,9586,1461020,1461252,5
6123,234,8425,1462272,1462506,5
7311,234,8512,1462278,1462512,5
406,246,780,1470201,1470447,5
641,251,311,1470873,1471124,5
318,287,492,1471880,1472167,5
2098,240,9897,1472067,1472307,5
2227,242,8544,1473470,1473712,5
8505,243,9085,1472981,1473224,5
7103,246,8192,1473927,1474173,5
9118,248,8287,1473888,1474136,5
4013,249,8799,1473434,1473683,5
2464,254,9102,1473190,1473444,5
5222,255,9483,1472873,1473128,5
7509,256,8447,1473974,1474230,5
1848,257,9916,1472571,1472828,5
4671,258,8401,1474153,1474411,5
7211,260,9679,1472943,1473203,5
9400,261,9642,1473050,1473311,5
9632,264,9126,1473637,1473901,5
7179,268,8874,1473963,1474231,5
5054,269,8930,1473985,1474254,5
5096,271,9456,1473538,1473809,5
4988,274,8089,1474986,1475260,5
6139,276,8404,1474755,1475031,5
9676,277,9085,1474160,1474437,5
4154,279,9309,1474023,1474302,5
5138,281,8162,1475259,1475540,5
9317,282,8269,1475243,1475525,5
8180,283,8169,1475435,1475718,5
6136,283,8257,1475440,1475723,5
4575,283,8284,1475506,1475789,5
2450,283,8901,1474982,1475265,5
7970,284,8923,1475053,1475337,5
9731,286,8261,1475809,1476095,5
3526,288,8878,1475288,1475576,5
3138,288,8931,1475333,1475621,5
8518,288,9894,1474468,1474756,5
4869,289,9729,1474731,1475020,5
6148,294,9860,1475161,1475455,5
9843,297,9826,1475249,1475546,5
6342,298,8932,1476200,1476498,5
5284,298,9442,1475748,1476046,5
435,8,109,10017,10025,6
954,19,451,9683,9702,6
877,26,366,9787,9813,6
366,32,658,9521,9553,6
523,38,111,10100,10138,6
535,46,177,10072,10118,6
166,61,930,9365,9426,6
155,64,301,10055,10119,6
396,68,141,10279,10347,6
731,101,196,10292,10393,6
425,152,795,9794,9946,6
388,186,157,10584,10770,6
242,202,383,10544,10746,6
306,224,130,10999,11223,6
467,231,763,10590,10821,6
571,247,467,11117,11364,6
445,255,266,11565,11820,6
152,280,574,11512,11792,6
7840,1,8073,164489,164490,6
4661,4,9318,163245,163249,6
2017,5,9797,162770,162775,6
8592,7,9472,163100,163107,6
2994,8,9516,163063,163071,6
9531,10,9267,163320,163330,6
6620,12,8503,164094,164106,6
7071,13,8560,164049,164062,6
7647,14,8392,164230,164244,6
2406,18,9578,163058,163076,6
4389,18,9817,162837,162855,6
8253,19,8660,164012,164031,6
7221,20,9170,163521,163541,6
3052,24,9687,163024,163048,6
8382,34,8920,163815,163849,6
1882,35,8049,164720,164755,6
8780,35,8812,163992,164027,6
6785,36,8807,164032,164068,6
7124,36,9461,163414,163450,6
1723,36,9684,163227,163263,6
2394,38,8682,164265,164303,6
4843,40,9793,163192,163232,6
5905,42,8188,164837,164879,6
5749,45,9411,163656,163701,6
4209,46,8027,165085,165131,6
2277,46,8043,165115,165161,6
1881,47,8725,164479,164526,6
8406,47,8965,164286,164333,6
9246,48,9344,163954,164002,6
8809,50,8449,164897,164947,6
1617,50,8861,164535,164585,6
7360,54,8157,165289,165343,6
3643,54,9482,164018,164072,6
8105,55,8314,165240,165295,6
1936,55,8921,164688,164743,6
6036,55,8978,164686,164741,6
8089,55,9998,163721,163776,6
4668,56,9700,164074,164130,6
5115,57,8016,165814,165871,6
2217,57,8674,165213,165270,6
7435,58,9231,164713,164771,6
3432,61,8661,165341,165402,6
2871,61,9384,164679,164740,6
9607,61,9746,164378,164439,6
1668,69,9637,164548,164617,6
3767,76,8237,166017,166093,6
7252,78,8210,166120,166198,6
7313,78,9729,164679,164757,6
6244,80,9810,164676,164756,6
1373,83,8588,165978,166061,6
2580,83,9076,165573,165656,6
1700,85,8239,166493,166578,6
7662,87,9506,165311,165398,6
4877,90,8410,166494,166584,6
2987,91,8022,166972,167063,6
7190,91,8344,166741,166832,6
2592,96,8429,166747,166843,6
1938,97,8916,166356,166453,6
8232,97,9307,166062,166159,6
4872,99,9812,165654,165753,6
8448,100,9166,166399,166499,6
9094,103,9331,166334,166437,6
6373,105,9052,166716,166821,6
8264,105,9656,166217,166322,6
8276,107,8048,167930,168037,6
7912,107,9349,166736,166843,6
4834,110,9029,167163,167273,6
8886,110,9839,166463,166573,6
1731,111,8266,168146,168257,6
6353,114,8421,168102,168216,6
3250,115,9109,167528,167643,6
2222,118,8403,168349,168467,6
8841,120,8241,168629,168749,6
9584,120,9767,167223,167343,6
7886,121,9341,167769,167890,6
3239,123,8980,168251,168374,6
7580,125,8340,169014,169139,6
6034,128,8460,169019,169147,6
4150,131,9824,167783,167914,6
8777,133,9044,168694,168827,6
1172,135,9278,168593,168728,6
8303,136,8801,169205,169341,6
4592,138,8440,169702,169840,6
2730,139,8107,170173,170312,6
5740,139,8109,170310,170449,6
2057,140,9921,168637,168777,6
7711,153,8633,170065,170218,6
3649,154,9196,169655,169809,6
1253,154,9621,169384,169538,6
5654,158,8069,171090,171248,6
6188,158,8554,170763,170921,6
6924,158,9423,170052,170210,6
9386,159,8486,171147,171306,6
9704,159,9000,170792,170951,6
4355,162,8574,171377,171539,6
1525,165,8915,171198,171363,6
2114,167,8455,171823,171990,6
2028,169,9934,170511,170680,6
7694,171,8094,172520,172691,6
9580,174,8725,172060,172234,6
9997,176,8308,172651,172827,6
9909,177,8141,172994,173171,6
5732,177,8181,173131,173308,6
2285,179,8304,173185,173364,6
3673,181,9237,172431,172612,6
2905,185,8108,173741,173926,6
9639,185,8471,173563,173748,6
3351,186,9622,172597,172783,6
2897,187,9727,172678,172865,6
4435,188,8417,174175,174363,6
3612,191,9949,172831,173022,6
1755,195,8039,174932,175127,6
4191,199,8734,174432,174631,6
4536,200,9445,173920,174120,6
5960,201,8786,174779,174980,6
7245,202,8279,175487,175689,6
8812,203,9731,174237,174440,6
7654,204,9876,174295,174499,6
8362,208,8109,176266,176474,6
6256,209,9772,174811,175020,6
7175,213,9252,175540,175753,6
4950,215,9199,175806,176021,6
8798,218,9886,175334,175552,6
1538,220,9594,175844,176064,6
5427,221,9683,175975,176196,6
1029,224,9945,175934,176158,6
4990,226,8516,177587,177813,6
7337,226,8601,177728,177954,6
3799,226,9135,177420,177646,6
7837,230,9636,177145,177375,6
2139,232,8981,178030,178262,6
5343,234,9103,178140,178374,6
5713,234,9622,177855,178089,6
5519,235,8158,179553,179788,6
5729,237,8305,179641,179878,6
9297,239,8346,179837,180076,6
9729,239,9603,178819,179058,6
9780,240,8572,180089,180329,6
4350,244,8324,180577,180821,6
8881,245,9499,179646,179891,6
7624,248,8920,180470,180718,6
5853,248,9316,180322,180570,6
6422,250,8160,181726,181976,6
5890,251,8124,182012,182263,6
8219,257,8709,181678,181935,6
9501,257,8905,181739,181996,6
6337,258,9651,181250,181508,6
7891,259,9722,181437,181696,6
7581,259,9827,181591,181850,6
2357,260,8455,183222,183482,6
3299,264,8583,183354,183618,6
8459,264,8925,183276,183540,6
7975,266,8863,183602,183868,6
5815,267,9644,183087,183354,6
2975,270,9594,183404,183674,6
1561,272,9729,183539,183811,6
4781,273,9534,184006,184279,6
1319,274,9763,184050,184324,6
2288,275,8258,185829,186104,6
4853,275,9132,185230,185505,6
9362,278,9013,185624,185902,6
7928,281,9237,185678,185959,6
4306,283,9228,185968,186251,6
8528,289,9712,185767,186056,6
1006,290,8038,187730,188020,6
6354,293,8583,187475,187768,6
8262,294,8831,187520,187814,6
6870,295,9771,186874,187169,6
8551,297,8896,188044,188341,6
3165,298,9053,188184,188482,6
2566,300,9861,187674,187974,6
436,37,993,11373,11410,7
814,46,429,11974,12020,7
221,56,317,12132,12188,7
841,62,103,12402,12464,7
307,68,884,11683,11751,7
177,114,257,12378,12492,7
329,116,386,12363,12479,7
343,130,797,12068,12198,7
580,134,476,12519,12653,7
355,169,709,12420,12589,7
685,174,613,12685,12859,7
574,194,530,12942,13136,7
493,204,749,12917,13121,7
728,222,435,13435,13657,7
990,247,447,13645,13892,7
457,299,748,13591,13890,7
9293,5,8609,189226,189231,7
2369,10,8118,189722,189732,7
5219,12,9292,188558,188570,7
8495,12,9520,188342,188354,7
9591,12,9597,188277,188289,7
9379,12,9731,188155,188167,7
3332,13,9548,188350,188363,7
1213,15,8132,189779,189794,7
5929,16,9334,188592,188608,7
1306,16,9756,188186,188202,7
1380,17,9185,188773,188790,7
6128,22,9983,187992,188014,7
8831,29,9031,188966,188995,7
9168,30,8970,189056,189086,7
1271,30,9372,188684,188714,7
2957,31,8858,189228,189259,7
8684,31,9706,188411,188442,7
3876,32,8096,190052,190084,7
8694,33,9787,188393,188426,7
7206,35,8565,189648,189683,7
6649,37,8764,189484,189521,7
6018,43,9204,189081,189124,7
5465,44,8152,190176,190220,7
7153,45,9500,188872,188917,7
6415,46,8870,189547,189593,7
8698,47,8530,189933,189980,7
2922,52,9201,189309,189361,7
5952,54,9212,189350,189404,7
6777,56,9273,189343,189399,7
9369,58,8863,189809,189867,7
3486,60,9921,188809,188869,7
7357,63,9715,189075,189138,7
7558,65,8764,190089,190154,7
9839,65,9169,189749,189814,7
8725,68,9411,189572,189640,7
2808,70,9274,189777,189847,7
5547,70,9342,189779,189849,7
4491,72,9552,189639,189711,7
5341,73,8467,190796,190869,7
5370,73,8807,190529,190602,7
5782,75,8824,190585,190660,7
4300,76,9316,190168,190244,7
4218,77,8566,190994,191071,7
9298,79,8806,190831,190910,7
9846,79,8933,190783,190862,7
7832,79,9897,189898,189977,7
2223,81,9867,190007,190088,7
9051,84,9184,190771,190855,7
8904,90,8525,191514,191604,7
5130,91,8656,191473,191564,7
7736,96,9867,190353,190449,7
9447,97,9208,191108,191205,7
3050,98,9032,191381,191479,7
4114,102,8285,192226,192328,7
4212,102,9518,191095,191197,7
2934,103,9407,191308,191411,7
2268,106,9722,191096,191202,7
6949,108,8202,192722,192830,7
4535,108,9077,191955,192063,7
4119,108,9386,191754,191862,7
5893,110,8666,192582,192692,7
6450,111,9472,191886,191997,7
2320,113,8155,193314,193427,7
5834,113,9323,192259,192372,7
4659,116,8134,193561,193677,7
2769,118,9469,192342,192460,7
9416,119,9693,192236,192355,7
5317,121,8110,193938,194059,7
8372,121,8810,193359,193480,7
6849,124,8351,193939,194063,7
4564,129,9717,192697,192826,7
2526,131,9211,193332,193463,7
1240,131,9373,193301,193432,7
2366,132,8312,194493,194625,7
9401,132,9862,193075,193207,7
8979,134,8510,194559,194693,7
3700,134,8834,194369,194503,7
8320,137,8579,194758,194895,7
6173,138,9192,194282,194420,7
9847,139,9945,193667,193806,7
9773,140,8464,195287,195427,7
7830,140,9723,194168,194308,7
8364,142,8042,195989,196131,7
8847,142,8321,195852,195994,7
4077,144,8457,195858,196002,7
5321,145,9494,194965,195110,7
9981,146,9817,194787,194933,7
5653,147,8055,196695,196842,7
1788,147,8416,196481,196628,7
4126,148,8325,196719,196867,7
4879,149,8175,197017,197166,7
3748,151,8008,197333,197484,7
7213,153,9749,195743,195896,7
2691,154,9122,196523,196677,7
9555,154,9315,196484,196638,7
9750,157,8126,197827,197984,7
7238,159,9339,196771,196930,7
9918,161,8315,197954,198115,7
5467,164,9158,197272,197436,7
2448,165,9368,197226,197391,7
5424,166,8808,197951,198117,7
1005,166,9708,197217,197383,7
8919,171,8474,198617,198788,7
8111,171,9025,198237,198408,7
7804,172,8665,198768,198940,7
1664,173,9471,198134,198307,7
3543,174,9582,198196,198370,7
5046,177,8867,199085,199262,7
1020,178,8045,200084,200262,7
3091,178,9773,198534,198712,7
9140,180,9260,199225,199405,7
4179,180,9775,198890,199070,7
3258,180,9900,198945,199125,7
2503,181,9568,199457,199638,7
8371,181,9863,199343,199524,7
3678,185,8295,201092,201277,7
8084,191,8033,201539,201730,7
1254,192,8293,201470,201662,7
7501,192,9123,200832,201024,7
8193,192,9331,200816,201008,7
5796,194,8618,201721,201915,7
7649,194,9174,201359,201553,7
1428,198,8001,202726,202924,7
1828,200,9702,201223,201423,7
5753,200,9769,201356,201556,7
7595,201,8092,203233,203434,7
1451,205,8198,203328,203533,7
1390,205,8741,202990,203195,7
1868,211,8422,203514,203725,7
2080,217,9817,202330,202547,7
1857,218,8971,203393,203611,7
6530,219,9063,203519,203738,7
5449,219,9856,202945,203164,7
8129,223,9299,203721,203944,7
3846,224,8168,205075,205299,7
1578,227,8703,204764,204991,7
1501,229,8284,205410,205639,7
6526,236,9426,204497,204733,7
2656,237,8262,205897,206134,7
9106,238,8663,205733,205971,7
4537,238,8837,205797,206035,7
4359,239,8235,206637,206876,7
8912,239,9587,205524,205763,7
9319,241,8045,207305,207546,7
6507,242,9843,205748,205990,7
2441,250,9877,205956,206206,7
8072,251,9363,206720,206971,7
5699,252,9747,206587,206839,7
7820,253,8630,207956,208209,7
2961,255,8963,207876,208131,7
8153,256,9860,207234,207490,7
7839,257,9799,207551,207808,7
4898,260,9137,208470,208730,7
1737,261,9888,207979,208240,7
2365,262,9866,208262,208524,7
9904,264,9425,208965,209229,7
5957,266,9568,209086,209352,7
4539,269,8829,210091,210360,7
6449,269,9675,209514,209783,7
4205,270,8620,210838,211108,7
2055,271,9067,210661,210932,7
4234,272,8492,211507,211779,7
3084,275,8498,211773,212048,7
7361,275,8845,211701,211976,7
4038,276,8715,212106,212382,7
3110,278,8551,212546,212824,7
1680,278,9978,211397,211675,7
9772,283,9111,212542,212825,7
2101,288,9617,212319,212607,7
1695,289,8339,213885,214174,7
5509,291,8050,214463,214754,7
7348,294,8667,214137,214431,7
5594,297,8311,214787,215084,7
6186,298,8714,214681,214979,7
9314,298,9516,214177,214475,7
121,143,72,2592,2735,8
230,4,424,14214,14218,8
896,25,389,14253,14278,8
426,36,91,14576,14612,8
816,61,470,14233,14294,8
500,61,595,14169,14230,8
762,73,325,14500,14573,8
568,79,301,14597,14676,8
943,88,344,14633,14721,8
129,103,317,14748,14851,8
392,104,331,14837,14941,8
858,108,849,14423,14531,8
674,130,280,15100,15230,8
123,137,999,14511,14648,8
562,146,117,15530,15676,8
758,163,125,15668,15831,8
175,165,208,15748,15913,8
987,185,437,15684,15869,8
483,224,520,15786,16010,8
764,229,605,15925,16154,8
334,244,658,16101,16345,8
8119,2,8027,215964,215966,8
7495,2,8844,215149,215151,8
7398,3,8356,215639,215642,8
7027,4,8102,215896,215900,8
8076,6,8082,215920,215926,8
8874,7,8357,215651,215658,8
2786,9,8086,215929,215938,8
9275,9,9890,214134,214143,8
6053,14,9434,214599,214613,8
2731,17,9174,214873,214890,8
3438,18,9192,214872,214890,8
9583,20,9044,215038,215058,8
8176,21,8634,215468,215489,8
9630,26,8835,215288,215314,8
8404,26,9509,214640,214666,8
1597,29,8553,215622,215651,8
5126,29,9253,214951,214980,8
5724,33,9287,214946,214979,8
3571,33,9375,214891,214924,8
2014,35,8162,216137,216172,8
1400,35,8309,216025,216060,8
1455,35,9738,214631,214666,8
2391,36,8754,215650,215686,8
1997,36,8769,215671,215707,8
2530,37,9186,215290,215327,8
2075,38,8749,215764,215802,8
2005,39,8973,215578,215617,8
1215,40,8950,215640,215680,8
5976,41,9264,215366,215407,8
1165,52,8362,216309,216361,8
1768,52,9879,214844,214896,8
8256,52,9995,214780,214832,8
5706,54,8082,216745,216799,8
9907,54,9501,215380,215434,8
3842,54,9867,215068,215122,8
3736,55,9472,215517,215572,8
5562,59,8027,217017,217076,8
3015,59,9968,215135,215194,8
1608,61,9998,215164,215225,8
5189,62,9110,216113,216175,8
9983,63,8352,216933,216996,8
5344,64,9912,215436,215500,8
4137,65,8487,216925,216990,8
9004,65,9586,215891,215956,8
6109,67,8133,217409,217476,8
6035,68,8977,216632,216700,8
7614,69,8077,217600,217669,8
5102,70,8444,217302,217372,8
5393,70,8687,217129,217199,8
7812,70,9673,216213,216283,8
9631,71,8247,217709,217780,8
7637,73,9931,216096,216169,8
9239,74,9212,216888,216962,8
6030,79,8472,217702,217781,8
6604,81,8823,217430,217511,8
8436,81,9981,216353,216434,8
6284,82,9271,217144,217226,8
7418,83,8135,218362,218445,8
8828,86,9275,217305,217391,8
1480,94,8751,217915,218009,8
8314,95,8167,218593,218688,8
8937,95,8820,218035,218130,8
1150,96,8501,218449,218545,8
9016,98,9751,217295,217393,8
9122,99,9194,217950,218049,8
8670,100,8247,218996,219096,8
3784,100,9668,217675,217775,8
9889,104,9761,217682,217786,8
2608,106,8833,218714,218820,8
9822,108,8485,219168,219276,8
8324,113,9405,218356,218469,8
2850,120,9138,218736,218856,8
5081,125,8102,219892,220017,8
3218,127,9002,219117,219244,8
6095,132,9988,218258,218390,8
5767,134,8420,219958,220092,8
3189,134,9975,218537,218671,8
6470,136,9188,219458,219594,8
2572,137,8948,219834,219971,8
7646,138,8733,220186,220324,8
6058,138,9542,219515,219653,8
8056,143,9690,219505,219648,8
4298,145,9090,220248,220393,8
8985,146,9452,220031,220177,8
2208,148,8355,221274,221422,8
1508,149,8482,221295,221444,8
9921,150,8321,221605,221755,8
9148,152,9046,221030,221182,8
5895,154,8344,221884,222038,8
4370,156,8508,221874,222030,8
3702,156,9241,221297,221453,8
7112,156,9776,220918,221074,8
9670,161,8367,222483,222644,8
9067,162,8271,222740,222902,8
4261,163,8139,223034,223197,8
2330,163,8750,222586,222749,8
7463,163,9095,222404,222567,8
8112,165,8031,223631,223796,8
1103,168,9673,222154,222322,8
3237,175,9261,222734,222909,8
9234,175,9614,222556,222731,8
9851,176,9642,222703,222879,8
8802,180,9144,223377,223557,8
8041,180,9445,223256,223436,8
7944,181,8993,223888,224069,8
1665,189,8210,224852,225041,8
1369,189,8883,224368,224557,8
6703,190,8559,224881,225071,8
3634,190,9309,224321,224511,8
6031,192,9984,223836,224028,8
6125,193,9671,224341,224534,8
8543,195,8324,225881,226076,8
7570,196,8268,226132,226328,8
2309,196,8725,225871,226067,8
7285,196,9821,224971,225167,8
9141,198,9185,225803,226001,8
1613,199,8805,226381,226580,8
5117,200,8573,226812,227012,8
9415,206,9052,226533,226739,8
9236,207,8520,227271,227478,8
2655,209,8221,227777,227986,8
3947,209,9435,226772,226981,8
5481,212,9019,227397,227609,8
2230,212,9494,227134,227346,8
2382,213,8774,228066,228279,8
6971,213,8905,228148,228361,8
5188,214,9253,228013,228227,8
9953,214,9892,227588,227802,8
1874,218,8743,228951,229169,8
2770,219,9684,228228,228447,8
5827,224,9456,228675,228899,8
1486,226,8255,230100,230326,8
1080,226,8316,230265,230491,8
4773,231,9976,228831,229062,8
2368,232,8588,230450,230682,8
6952,234,8239,231031,231265,8
5278,234,9473,230031,230265,8
2289,239,8864,230874,231113,8
7551,246,9030,230947,231193,8
6976,247,9004,231219,231466,8
2089,248,8473,231997,232245,8
5271,250,8944,231774,232024,8
6340,253,9939,231029,231282,8
4236,257,8318,232903,233160,8
4235,264,9792,231686,231950,8
9544,265,8472,233270,233535,8
2081,265,9529,232478,232743,8
7042,269,9877,232395,232664,8
6921,270,8151,234390,234660,8
1094,275,9445,233366,233641,8
1462,276,8661,234425,234701,8
1363,281,9047,234315,234596,8
5518,282,9856,233787,234069,8
8718,285,9028,234897,235182,8
5603,286,8010,236200,236486,8
3016,288,8973,235523,235811,8
4549,289,8468,236316,236605,8
3997,291,9401,235672,235963,8
6038,293,8539,236825,237118,8
7162,294,8949,236708,237002,8
6968,295,9769,236182,236477,8
7965,297,8766,237480,237777,8
7588,297,9421,237122,237419,8
839,5,532,16471,16476,9
132,20,332,16676,16696,9
703,34,245,16783,16817,9
933,80,106,16956,17036,9
968,81,354,16788,16869,9
719,166,454,16769,16935,9
683,177,711,16678,16855,9
633,180,353,17213,17393,9
114,202,892,16854,17056,9
901,207,520,17428,17635,9
233,211,272,17883,18094,9
391,241,229,18137,18378,9
193,253,556,18051,18304,9
101,277,265,18595,18872,9
463,282,496,18641,18923,9
2703,1,8180,238660,238661,9
3971,1,8458,238383,238384,9
1972,3,8810,238032,238035,9
2927,5,8345,238500,238505,9
6440,7,8464,238386,238393,9
6869,8,8033,238824,238832,9
2196,9,9138,237727,237736,9
9403,11,8389,238485,238496,9
7691,15,9576,237309,237324,9
6339,15,9961,236939,236954,9
6610,18,9443,237472,237490,9
9600,19,8149,238784,238803,9
9860,22,8275,238677,238699,9
9015,23,8290,238684,238707,9
1605,29,8736,238261,238290,9
1034,30,9515,237511,237541,9
3768,32,8281,238775,238807,9
4331,33,8228,238860,238893,9
1313,36,9368,237753,237789,9
1123,37,8364,238793,238830,9
9410,41,8405,238789,238830,9
2091,41,9651,237584,237625,9
5719,43,8884,238392,238435,9
2371,46,8562,238757,238803,9
4769,46,9136,238229,238275,9
9982,48,8003,239408,239456,9
1919,48,8604,238855,238903,9
1810,49,9584,237923,237972,9
4842,51,8119,239437,239488,9
5968,51,9557,238050,238101,9
5184,53,9287,238371,238424,9
7222,53,9425,238286,238339,9
6872,59,8949,238815,238874,9
6210,59,9136,238687,238746,9
8300,61,9476,238406,238467,9
1915,65,8550,239393,239458,9
1611,67,8730,239278,239345,9
8165,67,9264,238811,238878,9
5590,67,9890,238252,238319,9
5192,69,9736,238473,238542,9
5754,70,8623,239655,239725,9
5602,71,9905,238443,238514,9
7541,72,9017,239402,239474,9
8961,73,8087,240404,240477,9
9116,73,9352,239212,239285,9
9331,73,9648,238989,239062,9
7407,74,8412,240298,240372,9
2463,76,9431,239353,239429,9
1205,77,9351,239509,239586,9
1116,77,9374,239563,239640,9
9810,78,9495,239519,239597,9
4591,79,9985,239107,239186,9
6698,82,8438,240733,240815,9
6037,85,8193,241060,241145,9
7308,85,9601,239737,239822,9
8059,85,9674,239749,239834,9
9838,85,9951,239557,239642,9
2956,87,9177,240416,240503,9
8890,88,9058,240622,240710,9
5745,91,8562,241206,241297,9
3937,93,9131,240728,240821,9
9338,96,8436,241516,241612,9
7821,96,8578,241470,241566,9
5066,99,9367,240777,240876,9
3083,105,8145,242098,242203,9
6153,106,9723,240625,240731,9
8819,111,8314,242140,242251,9
5886,112,8937,241628,241740,9
1795,113,8677,242000,242113,9
5450,115,9280,241510,241625,9
3685,116,8327,242578,242694,9
3028,119,8617,242404,242523,9
1699,119,9843,241297,241416,9
5604,122,9577,241682,241804,9
4657,125,8662,242719,242844,9
8035,127,8108,243398,243525,9
9884,128,9467,242166,242294,9
5876,129,8899,242862,242991,9
1099,136,9270,242620,242756,9
1943,136,9954,242072,242208,9
4391,140,8955,243207,243347,9
3230,142,8169,244133,244275,9
2181,142,9884,242560,242702,9
8758,143,8916,243670,243813,9
5447,145,8246,244483,244628,9
4784,145,8850,244024,244169,9
3251,146,8760,244259,244405,9
6476,149,9794,243371,243520,9
7770,150,8934,244380,244530,9
5051,152,9598,243866,244018,9
3498,154,8190,245426,245580,9
6177,154,8594,245176,245330,9
3241,157,9198,244726,244883,9
1206,158,8936,245145,245303,9
8456,159,9708,244531,244690,9
2903,160,9824,244574,244734,9
8073,161,9625,244933,245094,9
4868,162,8740,245979,246141,9
3707,163,8016,246865,247028,9
5111,163,9456,245588,245751,9
3742,163,9591,245616,245779,9
9940,169,9170,246200,246369,9
9624,170,9633,245906,246076,9
3760,174,9947,245762,245936,9
9984,177,8251,247632,247809,9
5668,179,8458,247602,247781,9
2832,179,9092,247147,247326,9
5428,180,9691,246727,246907,9
9866,181,8489,248109,248290,9
5919,183,8280,248499,248682,9
1375,183,9497,247465,247648,9
2760,185,8245,248900,249085,9
8368,191,9587,247743,247934,9
8083,192,9242,248279,248471,9
6789,193,9342,248371,248564,9
8218,202,9878,248028,248230,9
5676,202,9978,248130,248332,9
2487,203,9041,249269,249472,9
2638,205,8420,250093,250298,9
9510,206,9524,249194,249400,9
2325,207,8571,250353,250560,9
8410,208,9075,250056,250264,9
5483,209,8635,250704,250913,9
1283,212,9639,249909,250121,9
6807,213,8551,251209,251422,9
8282,216,8778,251195,251411,9
4670,219,8909,251280,251499,9
4242,221,8932,251476,251697,9
4221,223,9700,250929,251152,9
7177,224,8739,252113,252337,9
7920,224,9645,251431,251655,9
9377,224,9911,251389,251613,9
1442,227,9756,251768,251995,9
7865,228,8573,253178,253406,9
8754,228,9984,251995,252223,9
5508,232,8710,253497,253729,9
7468,232,9615,252824,253056,9
1293,232,9674,252997,253229,9
5540,233,9023,253880,254113,9
4976,235,9857,253279,253514,9
1618,236,8632,254739,254975,9
5240,242,9230,254377,254619,9
1013,246,9988,253861,254107,9
5801,247,9008,255087,255334,9
4192,248,9297,255045,255293,9
8271,250,8260,256330,256580,9
4301,256,9182,255658,255914,9
9423,259,8516,256580,256839,9
8474,259,9205,256150,256409,9
1693,259,9798,255816,256075,9
1762,263,8217,257656,257919,9
9002,263,8595,257541,257804,9
7043,266,9117,257282,257548,9
5223,268,9631,257034,257302,9
1949,273,9658,257275,257548,9
6659,276,8989,258217,258493,9
1257,279,9850,257632,257911,9
3753,282,8200,259561,259843,9
2341,283,9914,258129,258412,9
3676,287,8951,259375,259662,9
8581,289,9300,259313,259602,9
5739,291,9117,259785,260076,9
7727,292,8243,260950,261242,9
2338,294,9584,259901,260195,9
5367,298,8494,261285,261583,9
9035,298,9898,260179,260477,9
444,4,960,18459,18463,10
275,31,576,18847,18878,10
525,33,139,19315,19348,10
604,66,227,19260,19326,10
699,92,999,18554,18646,10
328,98,994,18651,18749,10
460,116,124,19619,19735,10
244,133,453,19406,19539,10
969,157,684,19308,19465,10
906,159,788,19361,19520,10
228,170,971,19337,19507,10
386,173,272,20206,20379,10
401,248,521,20130,20378,10
586,275,381,20518,20793,10
831,297,523,20651,20948,10
675,299,109,21362,21661,10
479,300,809,20961,21261,10
6452,2,8022,262353,262355,10
2918,2,8438,261939,261941,10
7358,11,8851,261528,261539,10
1822,11,9580,260810,260821,10
9832,13,8606,261795,261808,10
6182,14,9556,260858,260872,10
3171,14,9574,260854,260868,10
7220,14,9969,260473,260487,10
7218,22,9712,260744,260766,10
8834,25,9763,260715,260740,10
3729,30,9089,261414,261444,10
9778,30,9511,261022,261052,10
7304,31,9047,261516,261547,10
8837,32,8843,261751,261783,10
1956,32,8956,261670,261702,10
3945,34,8928,261730,261764,10
1686,35,8127,262565,262600,10
1705,35,8306,262421,262456,10
4617,36,8623,262139,262175,10
4424,37,9923,260875,260912,10
4897,38,8678,262157,262195,10
9417,38,8829,262044,262082,10
9534,39,9377,261534,261573,10
4060,43,8549,262401,262444,10
8749,43,8740,262253,262296,10
4204,44,8927,262109,262153,10
3881,46,8057,263023,263069,10
1377,46,8366,262760,262806,10
7030,48,8627,262545,262593,10
4927,52,8623,262597,262649,10
9808,53,8855,262417,262470,10
8921,53,9341,261984,262037,10
7136,57,8455,262923,262980,10
8668,59,9059,262376,262435,10
7807,60,9821,261673,261733,10
6724,63,8995,262559,262622,10
3598,64,8696,262921,262985,10
8392,64,8724,262957,263021,10
8310,64,9222,262523,262587,10
9327,65,9320,262489,262554,10
2198,66,8466,263408,263474,10
6792,66,8969,262971,263037,10
9861,66,9921,262085,262151,10
5470,72,8349,263723,263795,10
7608,87,8290,263854,263941,10
9726,88,8177,264054,264142,10
2773,89,8612,263707,263796,10
7012,90,8189,264219,264309,10
1086,93,8658,263840,263933,10
3781,95,8466,264125,264220,10
2612,100,9707,262979,263079,10
9811,101,9054,263732,263833,10
2241,104,8836,264051,264155,10
7669,107,9206,263785,263892,10
3370,121,8269,264829,264950,10
5523,121,8376,264843,264964,10
8673,121,9011,264329,264450,10
1927,122,8908,264553,264675,10
4159,123,9287,264296,264419,10
2880,124,8161,265545,265669,10
9966,124,9420,264410,264534,10
7016,125,9094,264860,264985,10
1146,125,9146,264933,265058,10
4371,125,9560,264644,264769,10
4890,127,9284,265045,265172,10
1961,128,9139,265317,265445,10
2825,129,8826,265758,265887,10
5578,129,9845,264868,264997,10
5206,131,9947,264895,265026,10
8293,133,9433,265540,265673,10
3079,133,9912,265194,265327,10
4704,134,8501,266738,266872,10
2842,134,9924,265449,265583,10
3424,138,8101,267406,267544,10
1703,138,8167,267478,267616,10
7514,139,8743,267040,267179,10
2667,140,9125,266797,266937,10
3468,141,9402,266660,266801,10
7449,141,9584,266619,266760,10
8869,142,9492,266852,266994,10
5704,143,9064,267422,267565,10
1485,144,9753,266876,267020,10
9609,145,9822,266951,267096,10
2597,147,8338,268580,268727,10
4356,150,8596,268469,268619,10
4633,151,8369,268846,268997,10
5730,163,9988,267378,267541,10
5366,165,8653,268876,269041,10
4691,167,9237,268457,268624,10
3125,168,8586,269275,269443,10
9995,168,8805,269224,269392,10
3043,169,9825,268372,268541,10
7683,172,8593,269773,269945,10
1979,173,8379,270159,270332,10
6608,174,9327,269384,269558,10
9340,174,9749,269136,269310,10
9793,175,8511,270548,270723,10
7748,180,8561,270673,270853,10
4069,182,8731,270683,270865,10
2264,184,8352,271244,271428,10
8763,185,9817,269963,270148,10
5191,186,8200,271765,271951,10
6164,187,9040,271111,271298,10
7275,190,8200,272138,272328,10
9488,191,9433,271095,271286,10
2515,192,8495,272224,272416,10
1861,192,8542,272369,272561,10
3554,196,9718,271385,271581,10
7769,200,9167,272132,272332,10
1096,204,8645,272854,273058,10
5986,204,9344,272359,272563,10
2083,206,8133,273774,273980,10
1678,206,9260,272853,273059,10
9389,209,9827,272492,272701,10
7278,213,8557,273971,274184,10
9034,214,9034,273707,273921,10
8486,216,9821,273134,273350,10
3049,218,8010,275161,275379,10
5350,220,8558,274831,275051,10
8895,220,9295,274314,274534,10
1930,221,9017,274812,275033,10
5418,227,9270,274780,275007,10
7565,227,9317,274960,275187,10
3592,229,8765,275739,275968,10
4756,230,8104,276629,276859,10
4567,230,9498,275465,275695,10
5583,232,9194,275999,276231,10
7204,233,8738,276687,276920,10
3786,234,9373,276285,276519,10
1049,235,8416,277476,277711,10
2039,235,8551,277576,277811,10
1242,240,9576,276786,277026,10
3249,241,8211,278391,278632,10
6444,242,8722,278121,278363,10
5554,242,9417,277668,277910,10
2780,242,9470,277857,278099,10
6627,243,8118,279451,279694,10
5434,243,8874,278938,279181,10
9669,246,8058,279997,280243,10
4656,246,9894,278407,278653,10
1228,247,8575,279972,280219,10
6588,247,9653,279141,279388,10
3594,248,8201,280840,281088,10
4514,253,9572,279717,279970,10
1353,254,8929,280613,280867,10
1996,257,8678,281118,281375,10
5258,259,8946,281107,281366,10
8060,260,8384,281928,282188,10
4102,260,9247,281325,281585,10
3221,260,9297,281535,281795,10
1171,264,9324,281768,282032,10
5332,265,9238,282118,282383,10
3156,267,8804,282817,283084,10
1497,268,9988,281900,282168,10
8876,269,8986,283170,283439,10
6605,269,9070,283355,283624,10
1335,270,9505,283189,283459,10
9179,275,8424,284540,284815,10
3431,282,9587,283652,283934,10
5091,283,8977,284544,284827,10
4946,286,8390,285414,285700,10
5496,290,8123,285967,286257,10
4112,290,8581,285799,286089,10
3400,290,8661,286009,286299,10
1667,291,8368,286592,286883,10
4215,292,9496,285755,286047,10
6397,293,9245,286298,286591,10
6771,298,9071,286765,287063,10
621,2,599,21471,21473,11
127,15,994,21078,21093,11
516,15,998,21089,21104,11
930,36,497,21605,21641,11
232,55,940,21198,21253,11
917,56,746,21447,21503,11
409,68,466,21783,21851,11
701,70,348,21969,22039,11
735,93,429,21958,22051,11
585,97,319,22161,22258,11
746,123,418,22159,22282,11
507,143,654,22046,22189,11
365,145,382,22461,22606,11
737,145,742,22246,22391,11
301,164,290,22843,23007,11
209,180,183,23114,23294,11
258,224,373,23104,23328,11
980,229,788,22913,23142,11
860,235,85,23845,24080,11
434,237,680,23485,23722,11
768,267,903,23499,23766,11
448,285,425,24244,24529,11
911,294,752,24202,24496,11
1546,3,9138,286996,286999,11
6055,5,9486,286651,286656,11
5742,8,9797,286345,286353,11
5210,14,8918,287232,287246,11
6203,15,9952,286212,286227,11
2387,17,8555,287624,287641,11
8609,17,8611,287585,287602,11
5214,17,8769,287444,287461,11
1230,19,8044,288186,288205,11
2024,20,8436,287813,287833,11
2231,20,8988,287281,287301,11
9205,22,8446,287843,287865,11
8548,22,8466,287845,287867,11
6743,22,9400,286933,286955,11
4627,23,8520,287835,287858,11
5429,23,9529,286849,286872,11
4124,24,9241,287160,287184,11
6478,24,9555,286870,286894,11
8688,29,9643,286806,286835,11
2053,31,8914,287564,287595,11
8115,36,8632,287877,287913,11
4824,37,9724,286821,286858,11
7579,39,8571,288011,288050,11
3184,40,9002,287619,287659,11
9273,42,8257,288404,288446,11
2348,43,8011,288692,288735,11
9204,45,9632,287114,287159,11
2240,47,8673,288118,288165,11
2314,49,9806,287032,287081,11
8580,54,8630,288257,288311,11
5325,56,9494,287447,287503,11
1308,61,9319,287678,287739,11
3629,65,8427,288631,288696,11
9023,65,8973,288150,288215,11
7675,68,9200,287988,288056,11
5597,69,8451,288805,288874,11
2044,71,8204,289121,289192,11
6122,71,8381,289015,289086,11
9605,71,9475,287992,288063,11
1574,71,9850,287688,287759,11
4184,78,8810,288799,288877,11
8920,80,8848,288839,288919,11
9733,81,8699,289068,289149,11
9521,82,8376,289472,289554,11
5560,84,9671,288259,288343,11
1075,88,8899,289115,289203,11
4377,88,9730,288372,288460,11
6094,91,9633,288557,288648,11
4896,91,9872,288409,288500,11
2373,92,8633,289739,289831,11
4569,93,8302,290162,290255,11
5600,93,9749,288808,288901,11
7863,94,9274,289376,289470,11
6803,94,9774,288970,289064,11
4958,95,9946,288892,288987,11
8381,95,9964,288969,289064,11
9076,96,8983,290045,290141,11
9667,96,9952,289172,289268,11
6045,98,8536,290684,290782,11
5965,99,9019,290299,290398,11
7464,101,8131,291286,291387,11
4384,102,8357,291161,291263,11
4225,108,9590,290030,290138,11
1922,108,9994,289734,289842,11
6739,109,8194,291642,291751,11
2128,111,8714,291231,291342,11
7480,114,9885,290171,290285,11
5441,117,8720,291450,291567,11
4731,120,8490,291797,291917,11
9629,121,8471,291936,292057,11
7269,121,9458,291070,291191,11
1124,127,8180,292469,292596,11
2767,128,9986,290790,290918,11
1689,134,8996,291908,292042,11
8564,135,8365,292673,292808,11
2329,135,9098,292075,292210,11
3739,135,9603,291705,291840,11
9665,137,8991,292452,292589,11
5769,140,9489,292091,292231,11
9231,140,9884,291836,291976,11
2689,142,9614,292246,292388,11
6841,143,8742,293260,293403,11
9226,144,9180,292965,293109,11
6028,144,9198,293091,293235,11
7434,146,9753,292680,292826,11
6041,147,9500,293079,293226,11
3095,149,8942,293784,293933,11
7656,150,9355,293520,293670,11
1247,150,9404,293621,293771,11
4864,152,8276,294899,295051,11
3663,152,8431,294896,295048,11
2734,155,8984,294495,294650,11
9191,157,8008,295626,295783,11
5658,157,9641,294150,294307,11
1388,158,8964,294984,295142,11
3207,160,8430,295676,295836,11
7723,161,8486,295780,295941,11
2913,161,8969,295458,295619,11
5151,163,9742,294846,295009,11
6215,164,8616,296135,296299,11
6535,167,9988,294927,295094,11
9383,170,8596,296486,296656,11
2720,171,9870,295382,295553,11
6428,175,8941,296482,296657,11
6222,177,8187,297411,297588,11
8006,177,8738,297037,297214,11
7801,179,8609,297343,297522,11
5880,179,9787,296344,296523,11
1378,184,8052,298258,298442,11
7502,185,9814,296680,296865,11
3758,187,8560,298119,298306,11
1772,189,9590,297276,297465,11
3401,189,9812,297243,297432,11
7582,190,8187,299057,299247,11
8787,191,8880,298554,298745,11
5030,192,8303,299322,299514,11
1433,197,9044,298773,298970,11
6742,198,8947,299067,299265,11
4755,198,9986,298226,298424,11
6643,201,9444,298966,299167,11
1167,203,8484,300127,300330,11
1884,207,9753,299061,299268,11
6039,209,8808,300213,300422,11
9428,211,9434,299796,300007,11
2649,213,9040,300401,300614,11
2269,214,8954,300700,300914,11
8680,215,8305,301563,301778,11
6697,216,9862,300221,300437,11
4037,217,8074,302225,302442,11
4783,217,8851,301665,301882,11
6024,218,8114,302619,302837,11
3100,218,8811,302140,302358,11
9175,218,9567,301602,301820,11
5041,218,9975,301412,301630,11
9684,219,9418,302187,302406,11
6818,223,9575,302249,302472,11
3556,224,9363,302684,302908,11
6596,226,8412,303859,304085,11
4823,227,9211,303286,303513,11
2562,228,8908,303816,304044,11
4660,228,9243,303709,303937,11
7282,233,9064,304116,304349,11
2574,233,9896,303517,303750,11
2599,234,8316,305330,305564,11
3524,234,9972,303908,304142,11
5079,234,9990,304124,304358,11
4461,237,9910,304438,304675,11
1426,238,8133,306452,306690,11
4285,239,9420,305403,305642,11
2776,242,8453,306609,306851,11
8651,242,8738,306566,306808,11
4337,243,8943,306603,306846,11
7223,245,8327,307462,307707,11
2471,245,8842,307192,307437,11
1629,245,9512,306767,307012,11
4738,245,9883,306641,306886,11
8998,246,9611,307158,307404,11
7524,247,9370,307645,307892,11
3149,255,9607,307655,307910,11
1918,258,8360,309157,309415,11
5980,262,9274,308501,308763,11
4516,263,8814,309223,309486,11
3581,264,8294,310006,310270,11
7437,266,9856,308708,308974,11
1523,271,8525,310305,310576,11
4129,272,8757,310344,310616,11
7366,272,9153,310220,310492,11
6913,279,9722,309923,310202,11
6351,280,8418,311506,311786,11
3116,280,8456,311748,312028,11
7716,280,9941,310543,310823,11
9194,281,8154,312610,312891,11
7967,281,8830,312215,312496,11
7712,282,8380,312946,313228,11
4610,283,9424,312184,312467,11
3955,285,9749,312142,312427,11
7229,290,9322,312854,313144,11
8889,292,9608,312858,313150,11
5077,298,9302,313456,313754,11
1970,300,9528,313528,313828,11
823,14,77,2730,2744,12
447,29,637,24611,24640,12
895,42,951,24326,24368,12
638,45,651,24668,24713,12
347,58,524,24840,24898,12
949,64,275,25147,25211,12
745,82,996,24490,24572,12
927,92,341,25227,25319,12
705,98,375,25285,25383,12
973,115,419,25339,25454,12
176,160,376,25497,25657,12
996,162,225,25808,25970,12
825,162,957,25238,25400,12
308,164,140,26217,26381,12
710,194,831,25690,25884,12
521,233,177,26538,26771,12
171,233,379,26569,26802,12
940,237,406,26775,27012,12
189,279,260,27158,27437,12
9003,2,9283,314073,314075,12
2542,4,9509,313849,313853,12
1697,5,8730,314632,314637,12
5945,5,9278,314089,314094,12
7086,9,9625,313747,313756,12
7798,11,9715,313666,313677,12
6655,13,9264,314128,314141,12
7253,19,9938,313467,313486,12
9109,20,8705,314719,314739,12
4263,23,8881,314563,314586,12
7259,26,9939,313528,313554,12
2876,33,9577,313916,313949,12
8438,34,8226,315300,315334,12
6315,34,9906,313654,313688,12
1812,35,9833,313761,313796,12
5351,37,8565,315064,315101,12
6536,40,9295,314371,314411,12
2085,41,8876,314830,314871,12
9801,45,9039,314708,314753,12
4132,46,8999,314793,314839,12
3551,47,8871,314967,315014,12
5511,48,8965,314920,314968,12
4753,50,9235,314698,314748,12
2109,54,8410,315573,315627,12
5480,54,8732,315305,315359,12
5625,54,8945,315146,315200,12
7556,55,8196,315949,316004,12
9117,56,8411,315789,315845,12
3103,60,9677,314579,314639,12
5362,61,8160,316156,316217,12
7532,61,9596,314781,314842,12
6603,62,8185,316253,316315,12
8722,62,8571,315929,315991,12
7097,63,8468,316094,316157,12
9378,64,9701,314924,314988,12
4222,67,8683,316006,316073,12
2959,67,8733,316023,316090,12
1443,67,8740,316083,316150,12
9097,67,9562,315328,315395,12
1631,69,9375,315582,315651,12
8854,70,9836,315190,315260,12
4573,72,9805,315291,315363,12
3482,73,9005,316163,316236,12
4507,76,9377,315864,315940,12
7783,76,9381,315936,316012,12
4703,77,9849,315544,315621,12
4245,80,8433,317037,317117,12
9166,82,9219,316331,316413,12
2292,83,8584,317048,317131,12
1481,86,8354,317361,317447,12
5662,87,9902,315899,315986,12
1302,88,8088,317800,317888,12
8923,89,9300,316676,316765,12
8045,98,8250,317815,317913,12
3007,98,8306,317857,317955,12
2163,102,8497,317764,317866,12
3071,107,9041,317322,317429,12
1715,107,9514,316956,317063,12
2969,109,8814,317763,317872,12
5014,113,8576,318110,318223,12
7354,116,8958,317841,317957,12
7756,117,8167,318748,318865,12
8302,117,9422,317610,317727,12
7918,118,9176,317973,318091,12
3025,122,8320,318947,319069,12
5445,124,9938,317451,317575,12
7277,128,8843,318670,318798,12
9216,130,9182,318459,318589,12
3235,131,8536,319235,319366,12
4687,135,8318,319584,319719,12
4016,138,8478,319559,319697,12
8223,138,9337,318838,318976,12
6212,138,9577,318736,318874,12
8666,139,8493,319958,320097,12
6611,139,8941,319649,319788,12
3920,142,9042,319687,319829,12
5174,145,9931,318940,319085,12
8408,148,9945,319071,319219,12
9627,149,9329,319835,319984,12
5778,151,8285,321028,321179,12
3440,153,8233,321231,321384,12
4726,153,8403,321214,321367,12
6982,153,8871,320899,321052,12
8318,153,9431,320492,320645,12
1301,155,9252,320824,320979,12
3190,156,8552,321679,321835,12
1607,156,9196,321191,321347,12
5187,160,9094,321449,321609,12
9759,162,8151,322552,322714,12
7930,162,9990,320875,321037,12
9840,163,8574,322453,322616,12
5773,167,8653,322537,322704,12
3952,169,8130,323227,323396,12
4194,169,8641,322885,323054,12
2178,170,8708,322987,323157,12
4779,170,9362,322503,322673,12
3375,172,9291,322744,322916,12
3780,175,9383,322824,322999,12
6753,176,9396,322986,323162,12
4640,182,8893,323665,323847,12
7298,193,9657,323083,323276,12
5474,201,9136,323797,323998,12
5484,201,9549,323585,323786,12
5183,202,9051,324284,324486,12
9496,202,9063,324474,324676,12
9241,203,9510,324229,324432,12
1042,203,9736,324206,324409,12
4500,204,9484,324661,324865,12
5056,204,9983,324366,324570,12
3705,205,8529,326024,326229,12
7547,206,9607,325151,325357,12
4354,206,9946,325018,325224,12
4669,207,8706,326464,326671,12
7347,209,8199,327178,327387,12
5738,209,8907,326679,326888,12
7810,211,8343,327452,327663,12
8704,211,9544,326462,326673,12
6966,214,9093,327124,327338,12
4532,215,8605,327826,328041,12
5736,218,8304,328342,328560,12
5261,218,9954,326910,327128,12
5756,220,8743,328339,328559,12
1027,221,9105,328197,328418,12
8541,221,9873,327650,327871,12
8337,222,9706,328038,328260,12
9769,225,8144,329822,330047,12
6667,230,9716,328475,328705,12
7392,235,9567,328854,329089,12
4274,236,8082,330574,330810,12
6292,240,8784,330108,330348,12
1500,240,8953,330179,330419,12
6472,243,8271,331101,331344,12
5387,244,8912,330703,330947,12
3961,244,9631,330228,330472,12
7966,245,9842,330261,330506,12
6539,251,8321,332027,332278,12
1811,253,8963,331636,331889,12
6615,253,9212,331640,331893,12
8025,254,9294,331811,332065,12
3832,258,8308,333051,333309,12
9896,258,9217,332400,332658,12
9180,259,8904,332971,333230,12
7525,263,9656,332478,332741,12
9373,266,8619,333778,334044,12
4003,266,9634,333029,333295,12
9131,271,8802,334127,334398,12
4720,275,8349,334851,335126,12
2671,277,9849,333626,333903,12
8898,280,9766,333986,334266,12
5276,281,8747,335285,335566,12
7599,282,8230,336083,336365,12
8739,283,8206,336389,336672,12
2247,283,8905,335973,336256,12
3682,283,9273,335888,336171,12
2173,285,8667,336777,337062,12
7508,288,8979,336750,337038,12
4568,290,9770,336247,336537,12
4011,292,9139,337168,337460,12
1750,296,8069,338530,338826,12
5018,298,8847,338048,338346,12
3789,299,8985,338208,338507,12
9136,300,8899,338593,338893,12
611,9,614,27083,27092,13
812,12,236,27470,27482,13
610,17,604,27114,27131,13
868,26,807,26928,26954,13
594,34,249,27512,27546,13
848,76,775,27020,27096,13
486,92,544,27327,27419,13
362,93,357,27606,27699,13
117,93,861,27195,27288,13
978,134,785,27364,27498,13
690,151,693,27590,27741,13
828,163,654,27780,27943,13
662,177,523,28074,28251,13
187,177,969,27805,27982,13
544,195,829,28122,28317,13
167,217,332,28814,29031,13
824,245,595,28768,29013,13
997,246,195,29413,29659,13
255,258,578,29276,29534,13
466,260,772,29340,29600,13
220,299,921,29451,29750,13
4062,2,9579,338213,338215,13
3105,7,8710,339084,339091,13
7323,10,8401,339400,339410,13
4043,11,8854,338957,338968,13
3642,11,8863,338959,338970,13
7859,11,9701,338132,338143,13
6766,14,8905,338939,338953,13
4804,16,8903,338955,338971,13
5688,18,8020,339854,339872,13
7512,22,8825,339067,339089,13
3284,26,8293,339621,339647,13
2031,27,8585,339355,339382,13
8594,30,8902,339065,339095,13
4994,30,9594,338403,338433,13
4776,34,8973,339054,339088,13
3726,35,9905,338156,338191,13
6074,39,8915,339181,339220,13
2615,42,8241,339894,339936,13
8521,43,9797,338380,338423,13
1957,44,8693,339527,339571,13
6576,45,9736,338528,338573,13
9154,48,9191,339118,339166,13
9146,49,8870,339487,339536,13
9672,49,9154,339252,339301,13
6303,50,8836,339619,339669,13
7902,57,8106,340399,340456,13
8397,58,9258,339304,339362,13
4075,61,9458,339162,339223,13
1420,69,8144,340537,340606,13
9974,70,8117,340633,340703,13
7914,71,8183,340637,340708,13
5999,72,9230,339661,339733,13
1180,73,9151,339812,339885,13
1698,74,8467,340569,340643,13
7260,79,8793,340317,340396,13
4367,87,8076,341113,341200,13
6495,88,8115,341161,341249,13
2950,89,8442,340922,341011,13
1288,89,9767,339686,339775,13
1329,90,8584,340958,341048,13
3930,90,8982,340650,340740,13
2792,91,8343,341379,341470,13
2700,92,8550,341263,341355,13
1177,93,8573,341332,341425,13
7065,96,8667,341331,341427,13
2063,98,8065,342029,342127,13
9660,100,8048,342144,342244,13
1465,101,9420,340872,340973,13
4841,105,8078,342315,342420,13
1521,105,9736,340762,340867,13
4639,108,9946,340657,340765,13
5419,112,8422,342289,342401,13
1256,115,8819,342004,342119,13
5133,118,9012,341926,342044,13
1156,118,9231,341825,341943,13
7936,120,8717,342457,342577,13
7983,121,8759,342535,342656,13
6003,123,9567,341848,341971,13
6497,126,8291,343247,343373,13
9648,128,8925,342739,342867,13
6071,128,9573,342219,342347,13
3567,130,9922,341998,342128,13
3412,131,8188,343862,343993,13
6490,131,9729,342452,342583,13
8734,132,9841,342471,342603,13
8887,133,8002,344442,344575,13
3659,136,8603,343974,344110,13
6987,136,9017,343696,343832,13
2557,136,9973,342876,343012,13
8655,140,9007,343978,344118,13
4745,142,9340,343785,343927,13
1991,145,8084,345183,345328,13
7401,146,8751,344661,344807,13
4258,152,9053,344505,344657,13
1620,152,9268,344442,344594,13
7679,153,8468,345394,345547,13
7180,158,8525,345490,345648,13
1933,160,9013,345160,345320,13
6994,160,9150,345183,345343,13
5347,165,8660,345833,345998,13
6455,166,9574,345084,345250,13
2276,167,9701,345123,345290,13
1189,170,8050,346941,347111,13
7702,172,9741,345420,345592,13
4932,175,8606,346727,346902,13
4794,178,9546,345962,346140,13
9830,179,8148,347538,347717,13
1018,179,9740,346125,346304,13
5959,184,8741,347303,347487,13
5471,190,8073,348155,348345,13
9749,191,9663,346755,346946,13
8823,194,9357,347252,347446,13
3908,200,8788,348015,348215,13
3212,201,8328,348675,348876,13
9195,201,9774,347430,347631,13
9063,202,9810,347595,347797,13
6143,203,8011,349596,349799,13
6451,203,9078,348732,348935,13
8630,203,9714,348299,348502,13
1553,205,8438,349778,349983,13
1724,205,9987,348434,348639,13
6990,206,8777,349849,350055,13
2110,206,9253,349579,349785,13
5033,210,9058,349980,350190,13
6089,211,9643,349605,349816,13
5856,212,8512,350947,351159,13
2965,214,9066,350605,350819,13
1224,215,9555,350330,350545,13
3094,217,8469,351631,351848,13
2443,217,9900,350417,350634,13
4956,219,8316,352218,352437,13
7236,219,9202,351551,351770,13
5674,223,9398,351574,351797,13
5848,226,8784,352411,352637,13
9217,232,9361,352060,352292,13
3374,233,9753,351900,352133,13
7696,235,8095,353791,354026,13
2543,235,9823,352298,352533,13
7192,236,9987,352369,352605,13
1529,237,9153,353439,353676,13
1458,237,9538,353291,353528,13
3734,238,8690,354376,354614,13
7379,239,8486,354818,355057,13
2354,239,8524,355019,355258,13
5584,239,9320,354462,354701,13
3054,239,9456,354565,354804,13
7603,242,8584,355676,355918,13
8783,242,9138,355364,355606,13
5973,245,8891,355853,356098,13
1284,247,8725,356264,356511,13
5322,248,8342,356894,357142,13
6623,248,8644,356840,357088,13
6801,253,8091,357641,357894,13
3795,254,8357,357628,357882,13
4477,257,8022,358217,358474,13
8106,257,8076,358420,358677,13
1969,258,8700,358053,358311,13
1047,258,8935,358076,358334,13
9661,258,9465,357804,358062,13
1602,259,9806,357721,357980,13
3330,260,8326,359460,359720,13
2404,265,8086,359960,360225,13
4963,267,8759,359552,359819,13
1645,273,9432,359146,359419,13
3731,275,8694,360157,360432,13
5748,277,9221,359905,360182,13
8789,279,9170,360233,360512,13
1786,281,9848,359834,360115,13
2661,284,8305,361658,361942,13
2764,284,9387,360860,361144,13
8471,285,8988,361543,361828,13
2353,285,9917,360899,361184,13
9422,289,9804,361297,361586,13
1002,290,8039,363351,363641,13
9242,293,8262,363418,363711,13
1880,294,8736,363237,363531,13
2620,295,9052,363215,363510,13
2220,295,9129,363433,363728,13
9573,295,9251,363606,363901,13
2482,299,8412,364740,365039,13
659,1,187,30484,30485,14
926,1,274,30398,30399,14
665,3,773,29900,29903,14
128,6,815,29861,29867,14
880,12,235,30447,30459,14
698,48,944,29750,29798,14
1000,80,671,30071,30151,14
656,94,412,30410,30504,14
248,121,903,30013,30134,14
913,146,911,30126,30272,14
235,166,742,30441,30607,14
162,209,174,31175,31384,14
8851,1,9042,364409,364410,14
9831,2,8633,364819,364821,14
2812,2,8936,364518,364520,14
5770,2,9894,363562,363564,14
6557,3,8804,364654,364657,14
7872,3,9769,363692,363695,14
9070,4,9657,363807,363811,14
1351,7,8868,364600,364607,14
5950,8,9322,364153,364161,14
2707,11,9074,364409,364420,14
4113,12,8848,364646,364658,14
5376,14,9259,364247,364261,14
7105,18,8580,364940,364958,14
3337,18,9599,363939,363957,14
6016,23,9723,363833,363856,14
7104,24,9719,363860,363884,14
2134,26,8663,364940,364966,14
9186,26,8787,364842,364868,14
3254,26,9449,364206,364232,14
1340,26,9944,363737,363763,14
2361,29,8995,364712,364741,14
6243,34,8291,365445,365479,14
7183,36,8940,364830,364866,14
9856,40,8850,364956,364996,14
6866,44,8436,365410,365454,14
8586,45,8093,365797,365842,14
9346,47,8524,365411,365458,14
2857,47,8812,365170,365217,14
5860,50,9241,364788,364838,14
7527,51,8470,365609,365660,14
3873,51,8785,365345,365396,14
8547,51,8801,365380,365431,14
3613,53,9423,364809,364862,14
2613,53,9433,364852,364905,14
4380,54,8438,365900,365954,14
6140,54,8990,365402,365456,14
6618,55,9964,364482,364537,14
7730,56,9563,364938,364994,14
3656,58,8766,365791,365849,14
5383,64,8618,365997,366061,14
7741,65,9269,365410,365475,14
2624,68,8130,366614,366682,14
6822,69,8055,366757,366826,14
2678,70,8628,366253,366323,14
6664,72,9026,365925,365997,14
9393,73,8640,366383,366456,14
4891,74,9751,365345,365419,14
7946,79,8512,366658,366737,14
6002,80,8268,366981,367061,14
7375,80,8474,366855,366935,14
6381,82,8109,367300,367382,14
1599,82,9376,366115,366197,14
4911,83,8473,367100,367183,14
4099,84,8219,367437,367521,14
3355,86,9744,365996,366082,14
9114,87,8636,367190,367277,14
5019,89,9994,365919,366008,14
3993,92,9336,366666,366758,14
5728,92,9837,366257,366349,14
5601,96,9844,366342,366438,14
2725,97,9738,366544,366641,14
7274,98,8579,367800,367898,14
8862,98,9812,366665,366763,14
2669,101,9317,367258,367359,14
4096,104,8572,368104,368208,14
3665,112,8272,368508,368620,14
1087,116,9224,367668,367784,14
3288,119,8396,368612,368731,14
9442,125,8607,368520,368645,14
4821,125,8790,368462,368587,14
2500,126,8316,369061,369187,14
3423,126,9003,368500,368626,14
7759,126,9007,368622,368748,14
9088,129,9426,368329,368458,14
8207,130,9034,368850,368980,14
5462,130,9777,368237,368367,14
6427,133,8946,369198,369331,14
4012,140,8540,369737,369877,14
1359,141,9516,368901,369042,14
4224,144,9001,369557,369701,14
3223,145,8505,370197,370342,14
9209,147,9393,369454,369601,14
1702,149,9950,369044,369193,14
6156,152,9122,370021,370173,14
9612,153,8250,371045,371198,14
9222,154,8669,370779,370933,14
1785,155,8059,371543,371698,14
9320,155,8655,371102,371257,14
9967,157,9758,370154,370311,14
1543,159,9570,370499,370658,14
5342,163,9143,371085,371248,14
2310,164,8855,371536,371700,14
3376,165,8981,371574,371739,14
9305,165,9993,370727,370892,14
8422,167,8141,372744,372911,14
5472,167,9632,371420,371587,14
9577,170,8166,373053,373223,14
2748,170,8369,373020,373190,14
3730,171,9130,372429,372600,14
2573,173,8630,373100,373273,14
2898,174,9305,372598,372772,14
9128,175,8775,373302,373477,14
9143,176,8767,373485,373661,14
4940,182,8226,374202,374384,14
8816,182,9873,372737,372919,14
5679,183,9187,373605,373788,14
7990,183,9222,373753,373936,14
3815,186,8621,374537,374723,14
2958,189,8810,374534,374723,14
8050,190,8551,374982,375172,14
9948,190,9774,373949,374139,14
6184,191,8301,375612,375803,14
8610,195,8270,375834,376029,14
4566,195,9278,375021,375216,14
8068,197,9766,374728,374925,14
5758,198,8945,375746,375944,14
4108,199,9616,375273,375472,14
3275,200,8324,376764,376964,14
9256,201,8070,377218,377419,14
1544,202,9069,376420,376622,14
9553,202,9099,376592,376794,14
1743,202,9744,376149,376351,14
6599,204,8660,377435,377639,14
4151,204,8722,377577,377781,14
6221,204,9541,376962,377166,14
6414,207,8744,377963,378170,14
4348,209,8145,378769,378978,14
2099,210,9334,377789,377999,14
3723,211,8843,378490,378701,14
2538,212,8565,378979,379191,14
9193,214,8661,379095,379309,14
9515,215,8916,379054,379269,14
9398,217,9967,378218,378435,14
6297,219,9321,379081,379300,14
4855,220,9559,379062,379282,14
4844,220,9850,378991,379211,14
5803,221,8153,380908,381129,14
8546,222,8911,380371,380593,14
1202,222,8937,380567,380789,14
1784,225,9072,380654,380879,14
7249,228,9341,380610,380838,14
7018,229,9016,381163,381392,14
4878,230,8456,381952,382182,14
5493,230,9001,381637,381867,14
1068,231,9975,380893,381124,14
1604,233,9002,382097,382330,14
5711,240,8964,382368,382608,14
2165,240,9443,382129,382369,14
6934,242,9359,382453,382695,14
1338,245,8989,383065,383310,14
8311,248,9118,383181,383429,14
8248,249,9014,383533,383782,14
1759,249,9451,383345,383594,14
9615,250,9804,383241,383491,14
6904,251,8048,385247,385498,14
6133,254,8958,384588,384842,14
1243,256,8619,385181,385437,14
3709,257,8183,385873,386130,14
1853,265,9770,384543,384808,14
8632,266,8787,385791,386057,14
3880,267,9909,384935,385202,14
7099,268,9156,385955,386223,14
4739,270,8864,386515,386785,14
7677,274,9434,386215,386489,14
6392,278,9225,386698,386976,14
4226,280,9551,386650,386930,14
9343,282,9624,386857,387139,14
2964,284,8771,387992,388276,14
6593,284,9257,387790,388074,14
7280,285,8172,389159,389444,14
7291,285,8329,389287,389572,14
3792,285,8859,389042,389327,14
4561,289,9587,388599,388888,14
9912,290,9025,389450,389740,14
5871,291,8470,390295,390586,14
1685,291,9144,389912,390203,14
8482,296,8455,390892,391188,14
8442,296,9157,390486,390782,14
9468,296,9936,390003,390299,14
5759,297,8512,391723,392020,14
2702,297,8558,391974,392271,14
1498,299,8712,392117,392416,14
7720,299,9128,392000,392299,14
7587,299,9858,391569,391868,14
1518,300,9335,392391,392691,14
691,23,830,30728,30751,15
852,34,425,31156,31190,15
124,41,993,30622,30663,15
112,68,225,31431,31499,15
137,70,866,30858,30928,15
190,74,190,31604,31678,15
780,79,855,31013,31092,15
294,104,950,30997,31101,15
627,134,492,31559,31693,15
754,147,849,31336,31483,15
160,156,924,31408,31564,15
239,164,699,31789,31953,15
214,199,607,32045,32244,15
820,214,952,31899,32113,15
755,218,233,32832,33050,15
918,228,381,32902,33130,15
681,236,317,33194,33430,15
967,244,639,33108,33352,15
505,244,881,33110,33354,15
862,255,149,34086,34341,15
333,292,288,34202,34494,15
9575,2,8133,393893,393895,15
4480,2,9462,392566,392568,15
4849,3,8473,393557,393560,15
9409,3,9800,392233,392236,15
9964,5,8911,393125,393130,15
9367,6,8781,393260,393266,15
7873,6,9233,392814,392820,15
9103,7,8261,393792,393799,15
5403,11,8786,393274,393285,15
8352,11,9443,392628,392639,15
1663,12,9555,392527,392539,15
5364,13,8291,393803,393816,15
6891,13,9865,392242,392255,15
6462,15,8157,393963,393978,15
1866,15,9716,392419,392434,15
9497,15,9827,392323,392338,15
3126,17,9201,392964,392981,15
8925,18,8120,394062,394080,15
7372,20,8169,394031,394051,15
8540,22,8998,393222,393244,15
2977,24,8292,393950,393974,15
5641,28,9504,392762,392790,15
5823,31,9237,393057,393088,15
7632,32,8878,393447,393479,15
8333,34,9783,392574,392608,15
2862,38,8093,394298,394336,15
3333,43,8699,393730,393773,15
3044,44,8921,393551,393595,15
1470,44,9396,393120,393164,15
3463,44,9786,392774,392818,15
1807,45,8337,394267,394312,15
3609,46,8073,394576,394622,15
2635,46,9617,393078,393124,15
2188,47,9693,393048,393095,15
3646,48,8214,394574,394622,15
8896,50,8702,394134,394184,15
2483,53,9160,393726,393779,15
5723,56,9075,393864,393920,15
4982,57,8398,394597,394654,15
2954,57,9885,393167,393224,15
6311,58,9890,393219,393277,15
1041,59,9935,393232,393291,15
4021,62,8183,395043,395105,15
8755,62,8354,394934,394996,15
6323,62,9064,394286,394348,15
9012,63,9875,393537,393600,15
7210,66,9592,393883,393949,15
6831,67,8692,394849,394916,15
2853,69,9743,393865,393934,15
4971,70,8966,394711,394781,15
4777,73,9325,394422,394495,15
5656,74,9219,394601,394675,15
6946,74,9937,393957,394031,15
7963,75,9442,394526,394601,15
7919,80,8181,395862,395942,15
3113,81,8883,395240,395321,15
4638,81,9689,394515,394596,15
4836,81,9872,394413,394494,15
4267,82,8407,395959,396041,15
8250,84,8628,395820,395904,15
1330,84,8820,395712,395796,15
4601,84,9017,395599,395683,15
3538,84,9361,395339,395423,15
1711,86,9308,395476,395562,15
2061,87,8439,396431,396518,15
9276,88,9491,395466,395554,15
1016,90,9161,395884,395974,15
3686,90,9693,395442,395532,15
1119,93,9543,395682,395775,15
6443,95,8989,396329,396424,15
5924,95,9714,395699,395794,15
7411,96,8561,396947,397043,15
1325,101,9153,396451,396552,15
4489,101,9647,396058,396159,15
6487,104,9256,396550,396654,15
2153,110,9915,395995,396105,15
2555,111,9871,396149,396260,15
7079,112,9496,396635,396747,15
9313,113,8107,398136,398249,15
2251,113,8468,397888,398001,15
9900,113,8689,397780,397893,15
7549,120,9333,397249,397369,15
6506,122,9711,396991,397113,15
2643,125,9016,397808,397933,15
5680,127,9308,397641,397768,15
3193,128,8310,398766,398894,15
6661,131,9030,398174,398305,15
8650,131,9919,397416,397547,15
2374,132,9344,398122,398254,15
5624,133,8365,399233,399366,15
3658,140,9167,398564,398704,15
1466,140,9613,398258,398398,15
3601,143,8730,399281,399424,15
7271,143,9998,398156,398299,15
5413,146,9107,399190,399336,15
6959,148,8007,400436,400584,15
5087,151,9005,399586,399737,15
8164,151,9717,399025,399176,15
3280,152,8209,400684,400836,15
2507,152,9997,399048,399200,15
4588,156,9905,399292,399448,15
5557,157,9555,399798,399955,15
4076,160,8697,400813,400973,15
1530,160,8972,400698,400858,15
7164,162,8637,401193,401355,15
5504,163,8709,401283,401446,15
7023,164,9470,400685,400849,15
5752,165,9856,400463,400628,15
3950,166,9760,400724,400890,15
9787,167,9640,401010,401177,15
7321,168,8696,402121,402289,15
8927,170,8345,402640,402810,15
8529,171,9995,401160,401331,15
7500,172,9071,402255,402427,15
7242,172,9308,402190,402362,15
2650,181,8277,403393,403574,15
6665,181,8464,403387,403568,15
4933,185,9103,402929,403114,15
9823,185,9192,403025,403210,15
7655,185,9361,403041,403226,15
2311,186,8583,404004,404190,15
1331,186,9708,403065,403251,15
9962,189,8739,404220,404409,15
7477,191,8438,404710,404901,15
6081,192,9739,403600,403792,15
4307,193,8870,404661,404854,15
6859,193,9681,404043,404236,15
6436,195,8520,405397,405592,15
3298,198,8794,405318,405516,15
2331,200,9599,404711,404911,15
3837,201,9520,404990,405191,15
1562,205,9907,404804,405009,15
5177,207,8893,406023,406230,15
4378,209,8254,406869,407078,15
6461,209,8344,406988,407197,15
9766,211,8516,407025,407236,15
5791,214,8523,407229,407443,15
7888,216,9107,406859,407075,15
7576,218,8932,407250,407468,15
5488,220,8828,407572,407792,15
9130,224,8882,407738,407962,15
9092,224,9294,407550,407774,15
4173,225,9798,407270,407495,15
1072,226,9810,407483,407709,15
1877,227,8330,409189,409416,15
3918,227,9596,408150,408377,15
4438,228,8932,409041,409269,15
1203,228,9988,408213,408441,15
3912,229,8419,410010,410239,15
3259,230,8798,409860,410090,15
4390,232,8913,409975,410207,15
1677,234,8295,410825,411059,15
8181,236,8206,411148,411384,15
7101,237,9365,410225,410462,15
2226,237,9431,410396,410633,15
5966,241,8086,411978,412219,15
4227,241,8816,411489,411730,15
5534,243,9777,410769,411012,15
2283,252,8266,412523,412775,15
8376,255,9919,411122,411377,15
2910,256,9319,411977,412233,15
2522,256,9356,412196,412452,15
4198,258,8461,413347,413605,15
6336,261,8025,414041,414302,15
2699,261,9228,413099,413360,15
2096,261,9501,413087,413348,15
3426,263,9941,412908,413171,15
1252,265,8151,414961,415226,15
6079,266,8645,414732,414998,15
8706,266,9438,414205,414471,15
1637,267,8683,415226,415493,15
7658,270,8568,415608,415878,15
6019,271,9228,415218,415489,15
4208,272,9312,415405,415677,15
7144,274,9312,415677,415951,15
5971,274,9576,415687,415961,15
4342,274,9894,415643,415917,15
9247,276,8002,417809,418085,15
9968,276,9992,416095,416371,15
1454,279,9698,416665,416944,15
7166,280,9239,417403,417683,15
6945,280,9997,416925,417205,15
3158,281,8395,418807,419088,15
2552,285,9889,417594,417879,15
8731,286,8503,419265,419551,15
2094,289,9586,418468,418757,15
4326,291,8530,419813,420104,15
1164,293,8258,420376,420669,15
6790,293,9478,419449,419742,15
4672,300,9264,419956,420256,15
169,2,130,34652,34654,16
807,9,189,34595,34604,16
236,13,507,34286,34299,16
932,54,524,34282,34336,16
963,166,730,34130,34296,16
143,172,917,34109,34281,16
407,188,519,34679,34867,16
890,207,388,34998,35205,16
859,223,538,35055,35278,16
750,233,968,34848,35081,16
504,239,283,35766,36005,16
267,245,370,35918,36163,16
3812,1,8597,420923,420924,16
6087,2,9717,419804,419806,16
6715,3,8548,420975,420978,16
9944,4,8561,420965,420969,16
1816,7,8145,421385,421392,16
1517,9,9348,420189,420198,16
1043,10,9463,420083,420093,16
4032,14,9958,419598,419612,16
7827,15,8968,420602,420617,16
9712,16,9162,420423,420439,16
9155,17,8730,420871,420888,16
2765,23,9852,419766,419789,16
1248,23,9995,419646,419669,16
5660,27,8552,421112,421139,16
3582,27,9000,420691,420718,16
9542,28,8637,421081,421109,16
8682,28,8899,420847,420875,16
2807,28,9592,420182,420210,16
1169,29,9958,419844,419873,16
4497,31,9890,419941,419972,16
2151,34,8879,420983,421017,16
9549,34,9979,419917,419951,16
7984,35,8054,421876,421911,16
6669,35,9353,420612,420647,16
6259,37,8164,421836,421873,16
1658,39,8495,421542,421581,16
1909,41,8606,421470,421511,16
5718,42,8601,421516,421558,16
7517,43,9848,420311,420354,16
1050,43,9962,420240,420283,16
7868,45,8261,421984,422029,16
2445,46,8248,422042,422088,16
8420,46,9518,420818,420864,16
4751,47,8970,421412,421459,16
4171,49,9080,421349,421398,16
1808,50,9492,420986,421036,16
8433,53,8633,421895,421948,16
3547,57,8043,422538,422595,16
7851,57,8216,422422,422479,16
5645,58,8031,422664,422722,16
3485,58,8237,422516,422574,16
6020,59,9150,421661,421720,16
5833,61,9798,421072,421133,16
8388,64,9341,421590,421654,16
8707,70,9088,421907,421977,16
3433,71,8545,422520,422591,16
5034,77,8094,423042,423119,16
7652,79,8110,423103,423182,16
6540,79,8990,422302,422381,16
3637,80,8466,422905,422985,16
1926,81,8055,423396,423477,16
9699,84,9738,421794,421878,16
3809,84,9783,421833,421917,16
6780,88,8232,423468,423556,16
4903,93,9724,422064,422157,16
7553,94,8429,423452,423546,16
9259,94,9473,422502,422596,16
8767,96,8073,423996,424092,16
7182,96,8537,423628,423724,16
2810,98,8142,424119,424217,16
3674,101,9120,423239,423340,16
7312,103,8889,423571,423674,16
7597,106,9464,423099,423205,16
9486,106,9710,422959,423065,16
6255,107,9161,423614,423721,16
9150,107,9198,423684,423791,16
8598,107,9658,423331,423438,16
8790,108,8580,424516,424624,16
6758,111,9458,423746,423857,16
5267,111,9529,423786,423897,16
6687,112,9013,424413,424525,16
5774,114,9432,424106,424220,16
7719,115,8250,425402,425517,16
7923,116,9695,424072,424188,16
5535,118,8236,425647,425765,16
4201,120,9540,424461,424581,16
2195,122,9327,424794,424916,16
3782,122,9736,424507,424629,16
1954,123,9672,424693,424816,16
8765,124,9197,425291,425415,16
2125,126,8552,426060,426186,16
6712,128,9242,425496,425624,16
7088,131,9267,425599,425730,16
3182,131,9312,425685,425816,16
8800,132,9503,425625,425757,16
5359,132,9741,425519,425651,16
9065,134,9028,426364,426498,16
5015,136,9492,426034,426170,16
2275,138,9785,425877,426015,16
8329,145,9201,426599,426744,16
7217,145,9397,426548,426693,16
6134,145,9400,426690,426835,16
9240,147,8880,427355,427502,16
6187,148,8082,428300,428448,16
4109,154,9678,426852,427006,16
1183,155,9067,427617,427772,16
8123,156,8512,428327,428483,16
9027,156,9191,427804,427960,16
7052,157,9700,427451,427608,16
9975,157,9794,427514,427671,16
7763,161,9799,427666,427827,16
3994,165,9941,427685,427850,16
1417,166,9300,428491,428657,16
9436,168,9046,428911,429079,16
7082,169,8041,430084,430253,16
3053,169,9904,428390,428559,16
9694,170,8798,429665,429835,16
1237,171,8847,429786,429957,16
3631,172,8371,430433,430605,16
9046,172,8637,430339,430511,16
3430,172,8957,430191,430363,16
9407,175,8103,431217,431392,16
7186,176,9032,430463,430639,16
4320,177,9555,430116,430293,16
5588,180,9279,430569,430749,16
1592,180,9465,430563,430743,16
7955,181,8311,431897,432078,16
6473,181,9993,430396,430577,16
4524,182,8694,431876,432058,16
1776,185,8577,432175,432360,16
9614,187,8254,432683,432870,16
4155,188,8230,432894,433082,16
6754,188,8859,432453,432641,16
5291,189,9365,432135,432324,16
2891,191,9643,432046,432237,16
7132,192,8838,433042,433234,16
9683,192,9211,432861,433053,16
4106,193,8597,433667,433860,16
9126,194,9072,433385,433579,16
9855,195,8448,434203,434398,16
8160,197,8809,434037,434234,16
6006,197,9137,433906,434103,16
1736,201,9060,434180,434381,16
7342,201,9967,433474,433675,16
4837,202,9558,434084,434286,16
3152,203,8622,435222,435425,16
5909,205,9125,434922,435127,16
1628,206,8781,435471,435677,16
3878,206,9104,435354,435560,16
3343,207,9719,434945,435152,16
8419,208,9910,434961,435169,16
4010,210,9194,435885,436095,16
7906,210,9473,435816,436026,16
4462,211,9543,435956,436167,16
8191,213,8745,436965,437178,16
2390,213,8910,437013,437226,16
3362,214,8677,437459,437673,16
1603,214,9302,437048,437262,16
8285,215,9015,437549,437764,16
3211,215,9901,436878,437093,16
8032,217,9133,437861,438078,16
5310,218,8232,438979,439197,16
5194,219,8575,438854,439073,16
6892,219,9593,438055,438274,16
1489,220,8134,439733,439953,16
2308,221,8706,439381,439602,16
2280,222,9136,439172,439394,16
4019,223,9793,438737,438960,16
3085,224,8716,440037,440261,16
4147,226,8077,440900,441126,16
6281,227,9765,439438,439665,16
9621,228,9189,440241,440469,16
2359,230,8180,441478,441708,16
9761,230,8954,440934,441164,16
2160,231,8333,441785,442016,16
4175,231,9255,441094,441325,16
3462,231,9560,441020,441251,16
3727,233,8033,442778,443011,16
4801,234,8209,442835,443069,16
8145,234,8880,442398,442632,16
5529,236,9161,442351,442587,16
7991,237,8398,443350,443587,16
3810,239,8362,443623,443862,16
7852,240,9988,442236,442476,16
4694,243,9482,442982,443225,16
8437,246,8454,444253,444499,16
3628,247,8278,444675,444922,16
7425,247,8366,444834,445081,16
5838,247,8682,444765,445012,16
3267,247,9804,443890,444137,16
6709,248,8099,445842,446090,16
5638,248,8337,445852,446100,16
8043,248,9475,444962,445210,16
8289,250,9448,445237,445487,16
8512,253,8153,446782,447035,16
9411,255,9704,445484,445739,16
6073,256,8155,447288,447544,16
9420,256,9081,446618,446874,16
4538,257,8026,447929,448186,16
5134,257,9322,446890,447147,16
6404,260,8285,448184,448444,16
5495,263,8628,448101,448364,16
2785,264,9206,447786,448050,16
7430,264,9625,447631,447895,16
3397,266,8248,449272,449538,16
5784,267,9716,448070,448337,16
9490,268,9201,448852,449120,16
9487,271,9509,448812,449083,16
7364,272,9064,449528,449800,16
3363,273,8326,450538,450811,16
7882,276,8831,450306,450582,16
2771,277,8833,450580,450857,16
3677,277,8984,450706,450983,16
4690,279,9660,450307,450586,16
7465,282,8292,451954,452236,16
5799,282,9852,450676,450958,16
8328,284,9215,451595,451879,16
1392,287,8896,452198,452485,16
5227,287,9753,451628,451915,16
7710,289,8122,453546,453835,16
1652,290,8821,453136,453426,16
3875,295,8740,453507,453802,16
4253,296,8650,453892,454188,16
7773,299,8489,454349,454648,16
811,241,60,2761,3002,17
316,293,78,2984,3277,17
310,2,370,36163,36165,17
468,26,297,36238,36264,17
118,57,672,35889,35946,17
380,59,377,36241,36300,17
103,69,767,35910,35979,17
998,84,906,35840,35924,17
596,98,716,36114,36212,17
360,106,481,36447,36553,17
740,134,839,36195,36329,17
393,162,797,36371,36533,17
661,163,449,36881,37044,17
617,175,994,36499,36674,17
208,196,810,36858,37054,17
530,205,485,37379,37584,17
499,214,728,37341,37555,17
976,217,247,38036,38253,17
260,235,792,37708,37943,17
441,259,812,37923,38182,17
259,286,278,38716,39002,17
6220,2,9719,453418,453420,17
7522,4,9666,453473,453477,17
4270,16,8734,454409,454425,17
4086,18,8915,454244,454262,17
9844,21,8141,455036,455057,17
4665,21,9843,453355,453376,17
7960,22,9134,454085,454107,17
5776,22,9282,453959,453981,17
4528,25,8626,454637,454662,17
8349,26,8244,455044,455070,17
2686,26,9994,453320,453346,17
3461,27,9702,453638,453665,17
4791,28,9496,453871,453899,17
6806,31,8557,454838,454869,17
9390,33,9679,453747,453780,17
5442,36,9778,453681,453717,17
7559,38,9609,453886,453924,17
2046,39,9302,454231,454270,17
4861,42,8651,454921,454963,17
8860,45,8426,455188,455233,17
6835,45,9695,453964,454009,17
9924,46,9179,454525,454571,17
8469,52,8134,455616,455668,17
6272,52,8916,454886,454938,17
8795,56,9149,454705,454761,17
8813,57,9099,454811,454868,17
2540,58,8245,455722,455780,17
6115,59,9368,454657,454716,17
7039,62,9494,454590,454652,17
5582,66,8951,455195,455261,17
8069,70,8987,455225,455295,17
9663,71,8255,456027,456098,17
3030,71,9695,454658,454729,17
8885,73,8567,455857,455930,17
6917,74,9352,455145,455219,17
4408,75,8826,455745,455820,17
3773,77,8515,456131,456208,17
9263,78,9821,454902,454980,17
9315,79,8864,455937,456016,17
5762,84,8599,456281,456365,17
7571,89,8572,456392,456481,17
9653,89,9119,455934,456023,17
8873,91,8876,456266,456357,17
4993,91,9976,455257,455348,17
8617,92,8414,456910,457002,17
2149,93,8419,456997,457090,17
4926,93,8477,457032,457125,17
9610,93,9142,456460,456553,17
1892,94,8731,456964,457058,17
2324,95,8799,456990,457085,17
2393,98,9186,456698,456796,17
6894,98,9255,456727,456825,17
2221,106,8707,457373,457479,17
9337,108,9363,456823,456931,17
8012,109,8786,457508,457617,17
8576,109,8866,457537,457646,17
5248,109,9739,456773,456882,17
8746,112,8024,458597,458709,17
3703,115,8710,458023,458138,17
4283,116,8475,458373,458489,17
5486,121,8533,458431,458552,17
2095,122,9139,457946,458068,17
1591,125,8903,458304,458429,17
3615,126,9722,457610,457736,17
5168,127,9041,458417,458544,17
8418,129,8190,459395,459524,17
4594,129,8617,459097,459226,17
6070,129,8761,459082,459211,17
2778,132,9042,458930,459062,17
2604,132,9814,458290,458422,17
1299,134,9005,459231,459365,17
6600,142,9168,459202,459344,17
6923,142,9661,458851,458993,17
6135,143,8951,459703,459846,17
5866,148,8881,459916,460064,17
6242,150,8975,459970,460120,17
5107,150,9401,459694,459844,17
7768,150,9695,459550,459700,17
7895,151,9400,459995,460146,17
9806,154,8971,460575,460729,17
3513,154,9978,459722,459876,17
2152,155,8013,461841,461996,17
7811,155,9440,460569,460724,17
1063,155,9747,460417,460572,17
3667,156,8420,461899,462055,17
2793,157,8470,462005,462162,17
8206,157,9384,461248,461405,17
2396,159,8797,461992,462151,17
9685,165,8203,462745,462910,17
2854,166,8462,462651,462817,17
3173,166,8867,462412,462578,17
8710,167,8675,462770,462937,17
7373,167,8679,462933,463100,17
7142,167,9855,461924,462091,17
5226,168,9629,462317,462485,17
9576,169,8132,463982,464151,17
5313,178,9871,462412,462590,17
5533,179,9354,463107,463286,17
4641,180,9236,463404,463584,17
9932,180,9563,463257,463437,17
4624,183,8124,464876,465059,17
1251,184,8910,464273,464457,17
1113,184,9603,463764,463948,17
9790,185,8799,464752,464937,17
7272,186,8032,465704,465890,17
3199,187,8838,465084,465271,17
3657,188,8672,465437,465625,17
2639,190,9571,464726,464916,17
4813,196,8245,466242,466438,17
5692,196,9550,465133,465329,17
8186,198,9827,465052,465250,17
7371,200,8475,466602,466802,17
2753,202,8536,466741,466943,17
8308,206,9877,465602,465808,17
5568,207,9369,466316,466523,17
3415,209,8318,467574,467783,17
1162,209,9298,466803,467012,17
6232,209,9676,466634,466843,17
2677,221,8128,468391,468612,17
8866,222,8004,468736,468958,17
8299,227,8551,468411,468638,17
6429,231,8567,468622,468853,17
5173,232,8183,469237,469469,17
8125,235,8850,468802,469037,17
8850,237,9604,468283,468520,17
8363,237,9617,468507,468744,17
7387,240,8253,470108,470348,17
4922,240,9738,468863,469103,17
8259,242,9149,469692,469934,17
5011,242,9725,469358,469600,17
3975,251,8268,471057,471308,17
5328,252,9364,470212,470464,17
4969,253,8507,471321,471574,17
9825,254,9292,470789,471043,17
3067,254,9799,470536,470790,17
1275,256,8665,471924,472180,17
5363,256,8811,472034,472290,17
9649,256,9763,471338,471594,17
1551,257,8703,472654,472911,17
3038,259,9250,472364,472623,17
1128,259,9784,472089,472348,17
4101,263,9487,472645,472908,17
9915,264,9927,472468,472732,17
8267,267,8171,474488,474755,17
6169,272,8220,474706,474978,17
7120,272,8332,474866,475138,17
3992,274,9354,474116,474390,17
4768,276,9750,473994,474270,17
1920,277,8576,475444,475721,17
6161,279,8186,476111,476390,17
7844,287,8446,476130,476417,17
8152,288,8745,476118,476406,17
6023,289,9630,475521,475810,17
6752,289,9653,475787,476076,17
5414,289,9920,475809,476098,17
6189,291,8865,477153,477444,17
5901,291,9418,476891,477182,17
7519,293,8408,478192,478485,17
2721,296,9118,477775,478071,17
8730,300,9095,478094,478394,17
1770,300,9976,477513,477813,17
964,8,365,38915,38923,18
666,9,965,38323,38332,18
404,25,293,39004,39029,18
922,40,489,38833,38873,18
609,80,975,38387,38467,18
616,90,431,39011,39101,18
161,135,964,38568,38703,18
838,159,464,39203,39362,18
732,161,257,39569,39730,18
787,164,103,39884,40048,18
587,166,243,39908,40074,18
146,169,320,39997,40166,18
273,183,358,40128,40311,18
339,190,132,40537,40727,18
462,190,983,39876,40066,18
875,196,440,40609,40805,18
835,222,490,40755,40977,18
438,243,593,40874,41117,18
331,266,176,41534,41800,18
806,280,486,41490,41770,18
472,287,712,41544,41831,18
784,287,900,41643,41930,18
287,300,690,42140,42440,18
8545,2,9734,478055,478057,18
4414,4,8050,479741,479745,18
7681,8,8612,479183,479191,18
9448,9,8616,479187,479196,18
4935,10,8549,479263,479273,18
1311,13,8331,479491,479504,18
2383,15,8035,479800,479815,18
7276,15,8734,479116,479131,18
1051,16,9390,478475,478491,18
4983,17,9681,478200,478217,18
9658,19,9056,478842,478861,18
6636,22,8460,479457,479479,18
3917,28,8080,479859,479887,18
1459,28,8524,479443,479471,18
1140,28,9881,478114,478142,18
9309,30,9496,478527,478557,18
9013,31,8273,479780,479811,18
8696,32,8124,479960,479992,18
9472,32,8285,479831,479863,18
3368,35,8809,479339,479374,18
7227,38,8399,479784,479822,18
5207,38,9492,478729,478767,18
4499,39,8824,479435,479474,18
7606,41,9624,478674,478715,18
5750,42,8103,480236,480278,18
6881,42,8905,479476,479518,18
6512,47,8707,479716,479763,18
2245,50,9330,479140,479190,18
9554,52,8454,480066,480118,18
7438,59,8237,480335,480394,18
9328,59,9905,478726,478785,18
5286,63,8086,480604,480667,18
4607,64,8735,480018,480082,18
7384,65,9312,479505,479570,18
8735,66,8412,480470,480536,18
6416,66,9007,479941,480007,18
3606,70,8650,480364,480434,18
8724,71,8127,480957,481028,18
7676,71,8202,480953,481024,18
3737,72,8956,480270,480342,18
8642,72,9222,480076,480148,18
1295,75,8429,480941,481016,18
9089,80,8487,480958,481038,18
4141,81,9089,480436,480517,18
1477,81,9363,480243,480324,18
6751,81,9550,480137,480218,18
2265,82,8689,481079,481161,18
8071,83,8021,481829,481912,18
9703,84,8363,481570,481654,18
7026,89,9253,480764,480853,18
4296,89,9864,480242,480331,18
5623,92,9112,481083,481175,18
4328,94,9844,480443,480537,18
6248,95,9835,480546,480641,18
7609,96,9731,480745,480841,18
9318,98,9891,480681,480779,18
4616,101,9936,480734,480835,18
9029,102,8044,482727,482829,18
2253,102,9560,481313,481415,18
9828,105,8698,482277,482382,18
9125,105,9304,481776,481881,18
3914,106,9112,482073,482179,18
8950,107,8750,482541,482648,18
4407,108,9151,482247,482355,18
7100,109,9090,482416,482525,18
7843,113,8509,483106,483219,18
3039,116,8057,483671,483787,18
4163,117,9479,482365,482482,18
1575,118,9295,482666,482784,18
8074,119,9650,482429,482548,18
9207,122,9394,482804,482926,18
1218,128,8413,483907,484035,18
8390,129,8111,484337,484466,18
1495,130,9647,482930,483060,18
3202,135,8629,484078,484213,18
5392,139,8698,484144,484283,18
2424,142,8165,484816,484958,18
1026,142,8738,484385,484527,18
8715,143,8827,484438,484581,18
5850,143,9835,483573,483716,18
4571,145,9560,483991,484136,18
3014,146,8386,485310,485456,18
2054,148,9704,484138,484286,18
5491,150,9051,484939,485089,18
8939,150,9552,484588,484738,18
5307,152,8767,485523,485675,18
8236,153,8329,486113,486266,18
1296,153,8787,485808,485961,18
1282,156,8969,485779,485935,18
4368,159,8796,486108,486267,18
2976,162,9047,486016,486178,18
3511,164,9331,485894,486058,18
8882,165,8821,486568,486733,18
3959,166,8415,487139,487305,18
9473,168,8739,486981,487149,18
7078,171,8336,487552,487723,18
1307,172,8032,488027,488199,18
9888,172,9162,487069,487241,18
3510,173,8624,487779,487952,18
9000,175,9646,486930,487105,18
5013,177,8984,487767,487944,18
8638,179,9025,487903,488082,18
2243,182,8615,488492,488674,18
4486,183,8982,488307,488490,18
7667,186,9998,487474,487660,18
1774,188,8510,489148,489336,18
1773,188,9591,488255,488443,18
4042,192,9223,488811,489003,18
7951,196,8620,489606,489802,18
7777,197,9798,488624,488821,18
7209,200,8366,490253,490453,18
1070,202,8711,490108,490310,18
1948,203,8917,490104,490307,18
3779,204,8014,491210,491414,18
8037,204,9683,489745,489949,18
6501,205,9731,489901,490106,18
7856,206,8292,491545,491751,18
6111,206,9082,490961,491167,18
3954,206,9555,490694,490900,18
9271,208,8807,491648,491856,18
4600,210,9552,491111,491321,18
2398,211,9543,491330,491541,18
6061,213,8390,492694,492907,18
3514,214,8886,492411,492625,18
2708,214,9803,491708,491922,18
4135,218,9880,491845,492063,18
9812,223,8356,493587,493810,18
5516,226,9489,492677,492903,18
4353,226,9872,492520,492746,18
7643,228,8269,494349,494577,18
1867,232,8696,494150,494382,18
5765,233,9528,493550,493783,18
8246,234,8858,494453,494687,18
2531,236,9780,493765,494001,18
4056,238,8730,495051,495289,18
5613,240,9796,494223,494463,18
3118,244,8082,496177,496421,18
2302,245,8867,495636,495881,18
4427,247,8981,495767,496014,18
2519,250,8298,496697,496947,18
1673,251,9395,495850,496101,18
2345,253,8609,496887,497140,18
2630,254,9252,496497,496751,18
3990,257,8155,497848,498105,18
6326,257,9745,496515,496772,18
8751,258,8871,497646,497904,18
5279,259,8358,498417,498676,18
4742,261,8374,498660,498921,18
4981,272,9478,497817,498089,18
8355,276,8807,498760,499036,18
6927,278,8219,499624,499902,18
4658,278,8565,499556,499834,18
7846,278,9743,498656,498934,18
7428,280,8486,500191,500471,18
9516,280,9941,499016,499296,18
7420,283,8451,500786,501069,18
2317,283,8885,500635,500918,18
1352,283,9187,500616,500899,18
1192,288,8881,501205,501493,18
1139,290,8122,502252,502542,18
8170,295,8176,502488,502783,18
8515,297,9801,501158,501455,18
7794,298,8369,502887,503185,18
6425,300,8350,503204,503504,18
381,4,454,42676,42680,19
370,21,255,42879,42900,19
179,30,852,42303,42333,19
988,43,866,42319,42362,19
299,77,699,42529,42606,19
942,78,155,43150,43228,19
904,102,311,43072,43174,19
663,104,211,43274,43378,19
592,162,587,43002,43164,19
697,163,974,42777,42940,19
277,203,571,43343,43546,19
8984,1,9166,502688,502689,19
9018,4,8676,503179,503183,19
1982,4,9808,502051,502055,19
5879,4,9853,502010,502014,19
5640,5,9566,502301,502306,19
9429,6,8084,503788,503794,19
4680,6,8488,503390,503396,19
2623,8,8360,503524,503532,19
5565,9,8291,503601,503610,19
9351,9,9676,502225,502234,19
1186,10,9389,502521,502531,19
2409,11,9316,502604,502615,19
2111,12,9276,502655,502667,19
9824,13,9809,502134,502147,19
6565,14,9258,502698,502712,19
4310,16,8998,502972,502988,19
5636,17,8248,503738,503755,19
8659,18,8274,503729,503747,19
6538,18,9119,502902,502920,19
7056,19,8568,503471,503490,19
7952,19,9038,503020,503039,19
3345,20,9151,502926,502946,19
4065,20,9979,502118,502138,19
3794,21,8963,503154,503175,19
6273,22,9327,502811,502833,19
7331,25,8243,503917,503942,19
9009,25,8601,503584,503609,19
1914,25,9988,502222,502247,19
9479,26,9411,502824,502850,19
3870,27,8198,504063,504090,19
3402,34,8481,503807,503841,19
2009,34,9482,502840,502874,19
9601,35,8606,503750,503785,19
7897,36,8273,504118,504154,19
8127,38,9456,502971,503009,19
5453,39,8104,504361,504400,19
2729,41,8804,503700,503741,19
1368,42,9361,503184,503226,19
2941,43,9359,503228,503271,19
5381,44,9878,502752,502796,19
8508,46,9997,502677,502723,19
9183,47,9028,503692,503739,19
5891,48,9402,503365,503413,19
7835,48,9601,503214,503262,19
6640,48,9663,503200,503248,19
1031,53,8595,504316,504369,19
5050,54,8871,504093,504147,19
2704,56,9233,503785,503841,19
4925,56,9792,503282,503338,19
3305,57,8248,504882,504939,19
6433,57,9922,503265,503322,19
9010,60,8344,504900,504960,19
7548,60,8495,504809,504869,19
4558,63,9527,503837,503900,19
1221,65,8657,504770,504835,19
3970,66,8339,505153,505219,19
8360,67,8303,505255,505322,19
7455,67,8366,505259,505326,19
6287,67,9289,504403,504470,19
1212,69,8816,504943,505012,19
7159,70,8585,505243,505313,19
8120,70,8630,505268,505338,19
5726,71,8461,505507,505578,19
7338,71,9044,504995,505066,19
6646,73,8411,505699,505772,19
4792,73,9760,504423,504496,19
3539,74,9720,504536,504610,19
3796,75,8709,505621,505696,19
3720,75,9926,504479,504554,19
7184,76,8709,505771,505847,19
4440,84,8484,506072,506156,19
4145,86,9051,505589,505675,19
3548,88,9186,505540,505628,19
7875,89,9623,505191,505280,19
4213,93,8093,506810,506903,19
3266,94,9236,505760,505854,19
9339,94,9368,505722,505816,19
2848,95,8782,506402,506497,19
7828,95,9843,505436,505531,19
8599,101,8346,507028,507129,19
1522,102,9677,505798,505900,19
8294,107,8185,507392,507499,19
3717,107,9065,506619,506726,19
1712,108,8902,506889,506997,19
3835,111,8127,507772,507883,19
6349,113,8528,507482,507595,19
2168,116,8058,508065,508181,19
7518,116,9094,507145,507261,19
9495,117,8914,507441,507558,19
3715,118,8259,508213,508331,19
8712,120,9705,506885,507005,19
7127,121,9641,507069,507190,19
5163,123,8428,508403,508526,19
9249,125,8662,508292,508417,19
5548,125,8878,508201,508326,19
3301,129,9134,508070,508199,19
2606,129,9406,507927,508056,19
6564,130,9773,507689,507819,19
2071,131,8411,509181,509312,19
3304,132,8345,509378,509510,19
5352,133,8782,509073,509206,19
8740,135,8616,509372,509507,19
6170,135,9926,508197,508332,19
4858,138,8065,510193,510331,19
9354,143,8780,509616,509759,19
6304,144,9252,509287,509431,19
7215,146,8538,510145,510291,19
8621,147,8167,510662,510809,19
9171,147,8808,510168,510315,19
3621,149,8226,510897,511046,19
1342,153,8254,511018,511171,19
5244,153,9577,509848,510001,19
9296,153,9795,509783,509936,19
2517,157,8128,511603,511760,19
4978,159,9274,510614,510773,19
4734,162,8470,511577,511739,19
7979,166,9388,510821,510987,19
8526,169,8765,511610,511779,19
7339,176,9380,511164,511340,19
3032,178,8352,512368,512546,19
8527,186,9256,511642,511828,19
4457,186,9532,511552,511738,19
3141,186,9873,511397,511583,19
6705,190,9423,512033,512223,19
8577,191,9350,512296,512487,19
5970,192,8923,512914,513106,19
8339,193,8732,513297,513490,19
8689,195,8922,513300,513495,19
9025,197,8447,513970,514167,19
6975,197,8626,513988,514185,19
2395,201,8662,514149,514350,19
9182,207,8298,514714,514921,19
5025,207,9589,513630,513837,19
6008,208,9642,513784,513992,19
7167,210,8723,514911,515121,19
3260,213,8019,515825,516038,19
5524,214,8388,515669,515883,19
2295,219,9110,515161,515380,19
9381,223,8072,516418,516641,19
4051,223,9029,515684,515907,19
8584,228,8438,516498,516726,19
4758,229,8614,516550,516779,19
2202,230,9204,516189,516419,19
2077,231,8845,516778,517009,19
6796,232,9422,516432,516664,19
1294,238,8029,518057,518295,19
4793,238,9416,516908,517146,19
4232,238,9723,516839,517077,19
2177,240,9197,517603,517843,19
7388,242,8205,518835,519077,19
4710,242,9104,518178,518420,19
4888,242,9694,517830,518072,19
6357,243,8837,518929,519172,19
2116,245,8557,519452,519697,19
5564,245,8832,519422,519667,19
8559,248,8610,519889,520137,19
3979,249,8331,520416,520665,19
9620,249,8678,520318,520567,19
1819,249,8818,520427,520676,19
8554,252,9421,520073,520325,19
7645,256,9492,520254,520510,19
3747,259,8532,521470,521729,19
9707,260,8463,521798,522058,19
3804,264,8082,522439,522703,19
9930,264,9614,521171,521435,19
6193,265,8048,523001,523266,19
9781,265,8883,522431,522696,19
7419,266,9453,522126,522392,19
6312,267,8525,523320,523587,19
6407,267,9221,522891,523158,19
5898,269,9794,522585,522854,19
1701,272,9935,522713,522985,19
2696,275,9103,523817,524092,19
8166,275,9398,523797,524072,19
3057,276,8773,524697,524973,19
6398,277,9061,524685,524962,19
7499,277,9735,524288,524565,19
1824,278,8642,525658,525936,19
4986,279,8376,526202,526481,19
5416,282,8319,526538,526820,19
3910,287,8637,526502,526789,19
7404,290,9076,526350,526640,19
9058,295,8163,527553,527848,19
8432,295,8785,527226,527521,19
3296,300,9590,526716,527016,19
590,33,613,43504,43537,20
879,46,550,43600,43646,20
684,46,934,43262,43308,20
999,77,223,44019,44096,20
502,111,106,44213,44324,20
975,112,599,43831,43943,20
243,134,597,43945,44079,20
582,140,945,43731,43871,20
262,148,346,44470,44618,20
133,182,540,44424,44606,20
715,192,879,44267,44459,20
613,197,592,44746,44943,20
250,197,780,44755,44952,20
350,202,764,44968,45170,20
104,203,616,45318,45521,20
519,205,604,45533,45738,20
194,249,112,46230,46479,20
785,249,891,45700,45949,20
130,252,845,45995,46247,20
548,266,332,46760,47026,20
111,271,425,46933,47204,20
9763,2,9683,526923,526925,20
3157,4,8639,527969,527973,20
9451,4,9457,527155,527159,20
7240,6,8902,527714,527720,20
4752,7,9356,527266,527273,20
9848,9,8736,527893,527902,20
4089,11,9714,526924,526935,20
9545,12,8531,528118,528130,20
4148,12,9055,527606,527618,20
4186,15,9880,526793,526808,20
6692,18,8503,528185,528203,20
6511,21,9978,526728,526749,20
9059,22,9745,526982,527004,20
9956,23,8839,527910,527933,20
6802,25,8903,527869,527894,20
2683,26,8538,528259,528285,20
4747,27,8081,528742,528769,20
5122,28,8885,527965,527993,20
4093,28,9103,527775,527803,20
2378,29,9522,527384,527413,20
4578,30,8262,528673,528703,20
3713,31,9893,527072,527103,20
7685,32,9696,527300,527332,20
7265,37,9956,527072,527109,20
6236,38,8477,528588,528626,20
9739,39,9803,527300,527339,20
1552,41,8549,528593,528634,20
6706,41,9592,527591,527632,20
8254,42,8000,529224,529266,20
5513,44,8191,529075,529119,20
3434,44,8743,528567,528611,20
3465,46,9950,527404,527450,20
6302,47,9551,527849,527896,20
6098,50,9820,527627,527677,20
8524,51,8054,529443,529494,20
3569,51,8473,529075,529126,20
8648,53,8046,529553,529606,20
2337,53,8155,529497,529550,20
8399,58,8198,529507,529565,20
4826,58,8739,529024,529082,20
1655,62,9517,528304,528366,20
4177,63,8221,529662,529725,20
3519,63,9288,528658,528721,20
5918,66,8735,529274,529340,20
1469,66,9252,528823,528889,20
3195,68,8999,529142,529210,20
5685,68,9210,528999,529067,20
8227,71,8796,529481,529552,20
8465,75,8482,529866,529941,20
6962,78,8868,529555,529633,20
2494,79,9871,528630,528709,20
2533,87,8884,529696,529783,20
4061,88,9107,529560,529648,20
2865,89,8955,529800,529889,20
8217,94,8785,530059,530153,20
9214,95,8119,530819,530914,20
8623,95,9811,529222,529317,20
4962,96,8950,530178,530274,20
4822,96,9013,530211,530307,20
1789,98,9279,530041,530139,20
2675,101,8057,531361,531462,20
4996,102,8888,530631,530733,20
2668,102,9202,530419,530521,20
8563,103,8225,531498,531601,20
1879,106,9623,530203,530309,20
5094,112,8858,531074,531186,20
3939,117,8127,531917,532034,20
7789,117,8321,531840,531957,20
1905,120,9479,530799,530919,20
8234,125,8612,531786,531911,20
9139,126,8327,532196,532322,20
3313,129,9004,531645,531774,20
6528,129,9165,531613,531742,20
8700,130,8598,532309,532439,20
6091,131,8257,532780,532911,20
5098,131,8667,532501,532632,20
3738,132,8367,532932,533064,20
9414,133,8192,533239,533372,20
5152,133,9994,531570,531703,20
1506,135,8650,533047,533182,20
7737,136,8367,533465,533601,20
1571,136,9383,532585,532721,20
4395,137,8696,533408,533545,20
4847,137,9704,532537,532674,20
5768,138,9697,532681,532819,20
3453,140,9886,532630,532770,20
1614,142,8216,534440,534582,20
2622,143,9599,533199,533342,20
7853,150,9673,533268,533418,20
1650,150,9873,533218,533368,20
4673,155,8522,534719,534874,20
3553,157,8454,534942,535099,20
1683,157,9209,534344,534501,20
3108,157,9952,533758,533915,20
3639,159,8732,535135,535294,20
8747,159,9052,534974,535133,20
2688,160,8009,536176,536336,20
9294,160,9835,534510,534670,20
1337,163,9586,534919,535082,20
8457,163,9664,535004,535167,20
9654,164,8291,536540,536704,20
5824,164,9293,535702,535866,20
2875,165,9072,536087,536252,20
9347,166,8223,537101,537267,20
4882,168,9673,535817,535985,20
1473,169,8155,537503,537672,20
8500,169,8499,537328,537497,20
5620,169,9179,536817,536986,20
5475,170,9391,536774,536944,20
7169,172,9493,536842,537014,20
8835,174,8256,538251,538425,20
6320,174,8626,538055,538229,20
7641,184,9753,537102,537286,20
9149,190,9727,537312,537502,20
5372,192,9231,537998,538190,20
5253,192,9577,537844,538036,20
2826,193,8010,539603,539796,20
1740,193,9169,538637,538830,20
8565,195,9123,538876,539071,20
5536,200,8852,539342,539542,20
1404,200,8945,539449,539649,20
4419,203,9565,539029,539232,20
5790,204,9187,539610,539814,20
1111,205,8668,540333,540538,20
6880,205,9313,539893,540098,20
4249,205,9945,539466,539671,20
5225,206,9358,540258,540464,20
4606,206,9665,540157,540363,20
7119,206,9711,540317,540523,20
4913,207,8517,541717,541924,20
7521,208,9399,541042,541250,20
1438,210,8667,541982,542192,20
3752,211,8499,542360,542571,20
5761,212,8800,542270,542482,20
6151,213,8012,543270,543483,20
7450,214,8193,543302,543516,20
1398,214,9849,541860,542074,20
6662,216,8692,543231,543447,20
6993,217,8818,543321,543538,20
3693,217,8921,543435,543652,20
6799,220,8888,543685,543905,20
4910,221,8151,544642,544863,20
6410,223,9408,543606,543829,20
8772,223,9719,543518,543741,20
5935,224,8556,544904,545128,20
6162,226,9151,544533,544759,20
3675,228,9443,544467,544695,20
3279,229,9394,544744,544973,20
1471,231,8743,545624,545855,20
6960,231,9661,544937,545168,20
6251,234,8488,546341,546575,20
1272,235,8350,546713,546948,20
1410,240,9682,545616,545856,20
8117,243,8089,547449,547692,20
1548,244,9649,546132,546376,20
4323,245,9943,546082,546327,20
2982,246,9377,546893,547139,20
6853,249,8831,547685,547934,20
5478,250,8031,548734,548984,20
9066,250,8094,548921,549171,20
5452,250,9085,548180,548430,20
3371,252,9483,548032,548284,20
6102,253,8932,548835,549088,20
1649,257,8170,549850,550107,20
9698,257,9211,549066,549323,20
7877,260,9348,549186,549446,20
5162,260,9357,549437,549697,20
9397,262,9077,549977,550239,20
3860,262,9250,550066,550328,20
7389,262,9293,550285,550547,20
3633,263,9753,550087,550350,20
4471,269,9860,550243,550512,20
8953,273,8213,552159,552432,20
1502,274,9527,551118,551392,20
6985,275,9946,550973,551248,20
5277,278,8861,552333,552611,20
6747,278,9149,552323,552601,20
2381,279,8929,552821,553100,20
4458,280,8836,553193,553473,20
2497,280,9696,552613,552893,20
1389,281,8695,553894,554175,20
3922,281,9300,553570,553851,20
7674,283,8671,554480,554763,20
4838,284,9690,553744,554028,20
4203,285,8914,554804,555089,20
3188,285,9716,554287,554572,20
6750,288,8005,556283,556571,20
3216,291,8200,556376,556667,20
4346,292,9392,555475,555767,20
1779,293,8061,557098,557391,20
7205,293,8313,557139,557432,20
7131,294,9419,556326,556620,20
5290,295,9131,556908,557203,20
7659,296,9351,556983,557279,20
2546,297,8393,558237,558534,20
8532,299,8041,558886,559185,20
3004,300,8608,558618,558918,20
707,47,879,46750,46797,21
687,56,140,47536,47592,21
178,75,639,47093,47168,21
970,86,813,46994,47080,21
559,98,965,46928,47026,21
958,149,330,47661,47810,21
291,151,907,47233,47384,21
506,170,713,47578,47748,21
977,183,738,47723,47906,21
418,189,367,48277,48466,21
369,200,510,48323,48523,21
905,202,757,48276,48478,21
218,206,147,49088,49294,21
317,258,462,48979,49237,21
658,289,698,49001,49290,21
490,297,733,49255,49552,21
9978,7,8226,559300,559307,21
9302,7,8773,558760,558767,21
9517,9,8044,559496,559505,21
6723,11,9192,558357,558368,21
5311,12,9810,557750,557762,21
7594,14,9390,558182,558196,21
9503,14,9517,558069,558083,21
7168,15,8928,558672,558687,21
6977,16,8023,559592,559608,21
1994,18,8083,559548,559566,21
5068,18,8488,559161,559179,21
8136,19,8520,559147,559166,21
2332,20,8545,559141,559161,21
1065,20,9139,558567,558587,21
9384,20,9735,557991,558011,21
1195,26,8769,558977,559003,21
5230,26,9598,558174,558200,21
6149,26,9954,557844,557870,21
4763,30,8415,559409,559439,21
5263,30,9385,558469,558499,21
5411,30,9972,557912,557942,21
7316,32,9151,558763,558795,21
7248,34,9373,558573,558607,21
2578,35,9834,558146,558181,21
7615,36,8767,559248,559284,21
1396,36,8798,559253,559289,21
7753,36,9225,558862,558898,21
3838,39,8919,559204,559243,21
6105,40,9248,558914,558954,21
7139,45,9200,559002,559047,21
9933,46,8413,559834,559880,21
5042,47,8902,559391,559438,21
2754,51,8276,560064,560115,21
3648,52,9077,559314,559366,21
1852,54,8621,559822,559876,21
1838,54,9550,558947,559001,21
7146,56,8155,560396,560452,21
2835,57,9385,559222,559279,21
5629,57,9718,558946,559003,21
3869,58,9633,559088,559146,21
5203,58,9649,559130,559188,21
5715,60,8691,560146,560206,21
7978,62,9177,559720,559782,21
6489,63,9271,559688,559751,21
4063,65,9787,559235,559300,21
6372,66,9576,559511,559577,21
5368,68,9183,559970,560038,21
3632,69,8070,561151,561220,21
8618,69,8703,560587,560656,21
8872,69,9865,559494,559563,21
3857,74,9705,559723,559797,21
4786,78,8074,561428,561506,21
6118,79,9742,559838,559917,21
1503,80,9347,560312,560392,21
6898,81,9479,560260,560341,21
7431,83,9042,560778,560861,21
2304,84,9832,560071,560155,21
1360,85,8624,561363,561448,21
4254,85,9965,560107,560192,21
5432,89,8709,561448,561537,21
3744,91,9995,560251,560342,21
2551,94,9551,560786,560880,21
7257,96,8606,561825,561921,21
8973,96,9182,561345,561441,21
9809,111,8069,562554,562665,21
8690,116,9149,561585,561701,21
2627,120,8760,562090,562210,21
8867,122,9616,561354,561476,21
6839,129,9013,562079,562208,21
8501,129,9148,562073,562202,21
9288,130,8139,563211,563341,21
1188,130,9997,561483,561613,21
2722,132,8727,562883,563015,21
2840,134,8367,563375,563509,21
2886,134,9777,562099,562233,21
3897,137,9677,562333,562470,21
8063,138,9546,562601,562739,21
6954,139,9365,562920,563059,21
7724,139,9867,562557,562696,21
5907,140,9827,562736,562876,21
7081,143,9586,563117,563260,21
9802,148,8187,564659,564807,21
9526,148,8532,564462,564610,21
1309,148,9639,563503,563651,21
1492,149,8459,564831,564980,21
8137,150,9017,564422,564572,21
3169,152,9748,563841,563993,21
8475,153,9515,564226,564379,21
8773,154,9542,564352,564506,21
8341,154,9851,564197,564351,21
1505,155,9284,564918,565073,21
1540,156,8918,565439,565595,21
4909,156,9258,565255,565411,21
6017,158,8529,566140,566298,21
2966,158,8728,566099,566257,21
1488,159,8292,566693,566852,21
9360,161,8291,566853,567014,21
8838,164,9124,566181,566345,21
1894,164,9844,565625,565789,21
4387,165,8897,566736,566901,21
3310,169,9056,566742,566911,21
2473,172,8372,567595,567767,21
3655,175,8541,567598,567773,21
1630,176,8184,568130,568306,21
1395,177,8771,567719,567896,21
8588,178,9269,567398,567576,21
1387,180,8389,568456,568636,21
1908,180,8602,568423,568603,21
1541,182,8707,568498,568680,21
6341,183,8140,569247,569430,21
2418,188,8593,568977,569165,21
5494,191,9247,568511,568702,21
8511,194,9655,568294,568488,21
1143,195,8771,569372,569567,21
2858,198,8142,570196,570394,21
4027,198,8786,569750,569948,21
8021,200,8249,570485,570685,21
5507,200,8387,570547,570747,21
5985,201,9229,569905,570106,21
1201,202,8580,570755,570957,21
8560,204,9855,569682,569886,21
8096,205,9563,570178,570383,21
4719,209,8147,571799,572008,21
8386,209,8205,571950,572159,21
1913,210,8385,571979,572189,21
9350,214,8421,572153,572367,21
3517,214,9710,571078,571292,21
8110,219,8869,572133,572352,21
9976,219,9101,572120,572339,21
9513,223,8765,572675,572898,21
9795,229,9442,572221,572450,21
9049,232,8403,573489,573721,21
7869,233,9124,573000,573233,21
7921,234,8841,573516,573750,21
2558,236,9135,573456,573692,21
1154,239,8223,574604,574843,21
6201,239,9644,573422,573661,21
4604,243,8972,574333,574576,21
4961,243,9058,574490,574733,21
8203,244,8975,574816,575060,21
2803,245,9103,574932,575177,21
9882,247,8883,575397,575644,21
7048,248,8468,576059,576307,21
2960,249,9687,575088,575337,21
3850,249,9916,575108,575357,21
8582,253,8933,576340,576593,21
3877,255,8120,577406,577661,21
4311,257,8401,577380,577637,21
9990,262,8386,577652,577914,21
1803,264,8383,577917,578181,21
4349,265,8053,578511,578776,21
1713,265,9289,577540,577805,21
8091,266,9318,577776,578042,21
3806,267,8636,578724,578991,21
8769,267,9683,577944,578211,21
1234,270,8274,579620,579890,21
5063,273,9880,578284,578557,21
2150,274,8966,579471,579745,21
6895,275,9699,579012,579287,21
9229,278,9228,579758,580036,21
7474,279,9398,579866,580145,21
6333,281,8295,581248,581529,21
4939,281,8807,581017,581298,21
6827,281,9741,580364,580645,21
8989,285,9127,581259,581544,21
2779,286,8857,581814,582100,21
8138,288,8513,582444,582732,21
8858,289,9820,581425,581714,21
4774,289,9879,581655,581944,21
1564,290,9009,582814,583104,21
5023,291,9567,582546,582837,21
7145,292,9824,582580,582872,21
5073,294,8128,584568,584862,21
2758,295,8090,584900,585195,21
7109,296,9422,583863,584159,21
1833,299,8607,584974,585273,21
2174,300,9004,584876,585176,21
729,75,70,3285,3360,22
399,36,585,49700,49736,22
288,47,659,49662,49709,22
181,68,480,49888,49956,22
795,137,534,49902,50039,22
149,138,290,50283,50421,22
635,160,239,50472,50632,22
419,165,620,50251,50416,22
461,179,298,50738,50917,22
465,190,832,50383,50573,22
588,233,659,50746,50979,22
678,262,791,50847,51109,22
782,285,231,51669,51954,22
769,300,435,51750,52050,22
5675,1,8002,586178,586179,22
6713,3,8048,586133,586136,22
2698,5,8399,585785,585790,22
3865,5,9153,585036,585041,22
2015,6,8425,585769,585775,22
8027,7,9266,584934,584941,22
2801,7,9353,584854,584861,22
6817,7,9967,584247,584254,22
4623,8,8929,585292,585300,22
2049,9,8932,585297,585306,22
7692,9,9352,584886,584895,22
2687,13,9756,584491,584504,22
3213,16,9566,584694,584710,22
5103,17,8238,586038,586055,22
5458,17,9301,584992,585009,22
2084,18,8581,585729,585747,22
4811,18,9804,584524,584542,22
7626,19,8786,585560,585579,22
1761,21,8653,585712,585733,22
2249,21,8725,585661,585682,22
5546,22,8831,585576,585598,22
2790,22,8903,585526,585548,22
7861,22,9452,584999,585021,22
4525,24,9201,585272,585296,22
4188,25,8135,586362,586387,22
1078,25,8159,586363,586388,22
2465,25,9189,585358,585383,22
2931,26,9496,585076,585102,22
5395,28,8970,585628,585656,22
7394,29,8955,585671,585700,22
3145,31,8519,586136,586167,22
5308,31,9366,585320,585351,22
4586,31,9940,584777,584808,22
8348,33,8952,585796,585829,22
2430,34,9123,585658,585692,22
6760,36,8228,586587,586623,22
4088,36,9637,585214,585250,22
1200,37,8451,586436,586473,22
8036,37,8496,586428,586465,22
2108,38,9567,585394,585432,22
8443,40,8435,586564,586604,22
5382,42,9825,585214,585256,22
2816,45,8110,586971,587016,22
6483,46,9227,585899,585945,22
2307,48,9964,585208,585256,22
2058,49,9950,585270,585319,22
3495,51,8955,586314,586365,22
2466,53,8887,586433,586486,22
9963,54,9309,586064,586118,22
3583,55,9249,586178,586233,22
8192,57,8425,587057,587114,22
4028,57,8766,586773,586830,22
9132,58,9890,585706,585764,22
6477,59,9235,586419,586478,22
6316,60,8894,586819,586879,22
9529,61,8621,587152,587213,22
8130,63,9236,586598,586661,22
3499,64,8666,587231,587295,22
9512,68,9523,586438,586506,22
8980,70,8102,587927,587997,22
4943,70,9640,586459,586529,22
1869,73,9222,586947,587020,22
6907,73,9358,586884,586957,22
5705,74,9954,586361,586435,22
7510,75,9893,586496,586571,22
6997,76,8213,588251,588327,22
5401,77,8042,588498,588575,22
9478,77,9219,587398,587475,22
9845,79,8899,587795,587874,22
2716,79,8909,587864,587943,22
9353,80,9543,587309,587389,22
5793,82,8118,588814,588896,22
8538,82,8655,588359,588441,22
2229,86,9262,587834,587920,22
9706,86,9345,587837,587923,22
7533,88,8772,588496,588584,22
3617,88,8991,588365,588453,22
7137,90,8783,588661,588751,22
7797,90,9945,587589,587679,22
6837,92,8190,589434,589526,22
8467,92,9420,588296,588388,22
8414,94,9020,588788,588882,22
6931,97,8059,589843,589940,22
6185,97,8412,589587,589684,22
9864,102,8368,589728,589830,22
1865,104,9972,588226,588330,22
9261,105,9296,589006,589111,22
6043,108,9941,588466,588574,22
9082,110,8666,589849,589959,22
8487,111,8140,590485,590596,22
9348,113,9476,589260,589373,22
3770,114,8707,590142,590256,22
3248,114,8938,590025,590139,22
1197,114,9110,589967,590081,22
4603,115,8080,591111,591226,22
4989,115,9304,590002,590117,22
4214,117,8645,590776,590893,22
3890,119,8794,590744,590863,22
1708,121,8123,591534,591655,22
1446,123,9264,590514,590637,22
2122,126,8906,590995,591121,22
6127,131,8362,591665,591796,22
4090,131,9526,590632,590763,22
9253,132,8983,591306,591438,22
5216,135,8935,591486,591621,22
7443,135,9921,590635,590770,22
2524,136,9506,591185,591321,22
1088,136,9640,591187,591323,22
4160,137,8191,592772,592909,22
2739,138,8236,592864,593002,22
2258,139,8934,592304,592443,22
1210,141,8024,593353,593494,22
1118,141,8104,593414,593555,22
3745,141,8777,592882,593023,22
1841,141,9592,592208,592349,22
5649,147,9296,592645,592792,22
1110,149,9027,593061,593210,22
2326,150,8284,593953,594103,22
4916,156,8253,594134,594290,22
8711,160,8124,594419,594579,22
5300,165,9430,593273,593438,22
5505,165,9875,592993,593158,22
1720,167,8317,594716,594883,22
5930,167,8925,594275,594442,22
8297,169,8521,594846,595015,22
3092,170,9243,594293,594463,22
9266,171,8272,595434,595605,22
5123,171,8742,595135,595306,22
8305,172,8007,596041,596213,22
3596,174,8971,595249,595423,22
8173,174,9333,595061,595235,22
2695,174,9756,594812,594986,22
2069,179,9556,595186,595365,22
3602,179,9743,595178,595357,22
3704,183,9480,595620,595803,22
5610,185,8810,596473,596658,22
6268,185,9204,596264,596449,22
4445,185,9239,596414,596599,22
9461,186,8865,596973,597159,22
5306,188,8621,597403,597591,22
9283,195,8419,597793,597988,22
3018,195,8694,597713,597908,22
1756,199,8596,598006,598205,22
8034,199,9371,597430,597629,22
1163,200,8005,598995,599195,22
5992,201,9208,597992,598193,22
8088,203,8211,599190,599393,22
3233,203,8460,599144,599347,22
1277,203,9138,598669,598872,22
2755,205,8044,599966,600171,22
6007,205,9497,598718,598923,22
4157,212,8576,599844,600056,22
7069,212,8848,599784,599996,22
2944,212,9872,598972,599184,22
6634,216,8844,600212,600428,22
4999,217,8180,601092,601309,22
8078,219,8041,601448,601667,22
7426,220,9899,599809,600029,22
4800,221,9589,600339,600560,22
9754,222,8478,601671,601893,22
3532,222,9163,601208,601430,22
3587,226,9620,600973,601199,22
2811,226,9687,601132,601358,22
1813,228,8618,602427,602655,22
7165,231,8275,602998,603229,22
2102,233,8419,603085,603318,22
2485,234,9002,602735,602969,22
7824,236,9910,602061,602297,22
5874,239,9446,602761,603000,22
5961,239,9595,602851,603090,22
6549,241,8103,604582,604823,22
1083,241,8131,604795,605036,22
6794,241,8691,604476,604717,22
2560,241,9596,603812,604053,22
3042,242,9495,604154,604396,22
4952,243,9597,604294,604537,22
1061,244,8136,605998,606242,22
2839,244,8894,605484,605728,22
5683,245,9557,605065,605310,22
8283,245,9989,604878,605123,22
7001,250,8250,606862,607112,22
2644,250,8492,606870,607120,22
8572,252,9653,605959,606211,22
2042,255,9732,606132,606387,22
4260,257,8581,607538,607795,22
8801,257,8732,607644,607901,22
6879,259,8486,608147,608406,22
7390,261,8709,608183,608444,22
6980,261,8894,608259,608520,22
7992,262,9210,608204,608466,22
7352,267,9292,608384,608651,22
6631,274,9014,608929,609203,22
6286,278,8105,610112,610390,22
4344,278,8422,610073,610351,22
2351,279,8444,610329,610608,22
3863,281,9816,609236,609517,22
4559,282,9658,609675,609957,22
6628,283,8999,610616,610899,22
7091,284,9211,610687,610971,22
1537,286,8621,611561,611847,22
6274,288,9132,611336,611624,22
6289,289,9153,611603,611892,22
7024,289,9253,611792,612081,22
6430,291,8344,612990,613281,22
8383,296,8917,612708,613004,22
912,148,50,3380,3528,23
138,2,193,52292,52294,23
788,3,439,52048,52051,23
625,53,849,51641,51694,23
374,59,726,51817,51876,23
300,69,111,52491,52560,23
302,105,782,51889,51994,23
632,125,161,52615,52740,23
560,164,718,52183,52347,23
704,176,554,52511,52687,23
914,194,278,52963,53157,23
606,196,473,52962,53158,23
222,233,306,53325,53558,23
403,251,367,53497,53748,23
7203,1,8762,613159,613160,23
6119,1,8918,613004,613005,23
2570,3,8035,613888,613891,23
8196,4,8546,613380,613384,23
4991,5,9514,612416,612421,23
7121,8,9051,612884,612892,23
2166,8,9950,611993,612001,23
6571,10,8221,613730,613740,23
3209,11,9257,612704,612715,23
4995,15,8482,613490,613505,23
6384,18,8910,613077,613095,23
1754,21,8895,613110,613131,23
7651,23,9658,612368,612391,23
9558,25,9597,612452,612477,23
6496,28,8607,613467,613495,23
9265,36,9314,612788,612824,23
2270,36,9610,612528,612564,23
9507,40,9367,612807,612847,23
5398,41,9919,612295,612336,23
6441,42,8374,613881,613923,23
8958,45,9581,612716,612761,23
7114,45,9895,612447,612492,23
4707,47,8304,614083,614130,23
8291,47,8761,613673,613720,23
2916,47,8856,613625,613672,23
2120,48,8110,614418,614466,23
7135,62,9067,613509,613571,23
1952,63,8576,614062,614125,23
4362,64,9529,613172,613236,23
3124,66,8543,614222,614288,23
3823,66,8735,614096,614162,23
6423,67,8715,614182,614249,23
4420,71,9156,613808,613879,23
4544,71,9463,613572,613643,23
2588,73,8341,614765,614838,23
8957,75,8265,614914,614989,23
6330,75,9282,613972,614047,23
8982,76,8133,615196,615272,23
4506,76,8938,614467,614543,23
7698,77,8439,615042,615119,23
8794,77,8859,614699,614776,23
2459,80,8501,615134,615214,23
1821,80,8974,614741,614821,23
3429,80,9822,613973,614053,23
9735,81,8016,615859,615940,23
8864,81,8114,615842,615923,23
7013,82,8282,615755,615837,23
4654,87,8476,615643,615730,23
9107,89,9890,614316,614405,23
2981,93,8981,615314,615407,23
3565,93,9047,615341,615434,23
5312,95,8537,615944,616039,23
9528,96,8229,616347,616443,23
9152,98,9923,614749,614847,23
1225,100,8642,616128,616228,23
9682,100,9773,615097,615197,23
7273,100,9984,614986,615086,23
6830,103,9549,615521,615624,23
1160,104,8797,616376,616480,23
2436,108,8038,617239,617347,23
7860,108,8993,616392,616500,23
4732,109,9111,616382,616491,23
9585,112,9425,616177,616289,23
8607,112,9622,616092,616204,23
4735,113,9576,616250,616363,23
4765,114,8125,617814,617928,23
9324,121,9539,616514,616635,23
8323,123,8188,617986,618109,23
3777,124,8515,617782,617906,23
8894,125,9106,617315,617440,23
3458,127,8908,617638,617765,23
6612,129,9458,617215,617344,23
1610,130,8795,618007,618137,23
8517,130,9281,617651,617781,23
3142,130,9952,617110,617240,23
4049,131,9407,617785,617916,23
7569,134,8608,618715,618849,23
3874,134,9291,618166,618300,23
7826,136,8847,618744,618880,23
9548,136,9828,617899,618035,23
6906,140,8551,619312,619452,23
5190,141,8840,619163,619304,23
3765,142,8200,619944,620086,23
4930,144,8793,619493,619637,23
1659,145,9766,618664,618809,23
6944,149,8227,620348,620497,23
5285,151,9036,619688,619839,23
3502,152,9649,619226,619378,23
7836,153,8095,620932,621085,23
7010,155,8755,620425,620580,23
4772,156,8209,621126,621282,23
2590,156,9464,620027,620183,23
2925,157,9411,620236,620393,23
8892,158,9357,620447,620605,23
6793,159,8143,621819,621978,23
8845,161,8982,621139,621300,23
9031,162,9620,620662,620824,23
5235,165,8696,621748,621913,23
1790,166,8600,622009,622175,23
2847,166,9113,621662,621828,23
7574,170,9062,621879,622049,23
2159,172,8649,622462,622634,23
8506,172,9261,622022,622194,23
9817,173,9835,621620,621793,23
1040,174,8057,623571,623745,23
9862,176,9235,622567,622743,23
4631,178,9838,622140,622318,23
2805,181,8933,623223,623404,23
4949,181,9327,623010,623191,23
8046,183,8825,623693,623876,23
8016,183,9519,623182,623365,23
6482,183,9571,623313,623496,23
2616,186,9831,623236,623422,23
8947,188,8353,624900,625088,23
7857,188,8376,625065,625253,23
8959,189,9423,624206,624395,23
8116,189,9495,624323,624512,23
7155,190,9921,624086,624276,23
8275,191,9757,624440,624631,23
6124,192,9462,624926,625118,23
6972,193,9067,625513,625706,23
5375,194,8125,626648,626842,23
2293,196,8868,626099,626295,23
7561,196,9562,625601,625797,23
9943,196,9766,625593,625789,23
4123,198,8246,627309,627507,23
9432,199,8812,626941,627140,23
9755,200,8894,627058,627258,23
9849,201,8017,628135,628336,23
5576,202,8137,628216,628418,23
4743,202,9085,627470,627672,23
6791,202,9318,627439,627641,23
8450,203,8796,628163,628366,23
1887,207,8698,628464,628671,23
7545,208,8402,628967,629175,23
4280,208,9808,627769,627977,23
1014,212,8064,629721,629933,23
9664,212,8250,629747,629959,23
4778,212,9714,628495,628707,23
8942,215,8328,630093,630308,23
2970,215,9139,629497,629712,23
7185,218,8379,630472,630690,23
3845,220,9245,629824,630044,23
7534,220,9955,629334,629554,23
7102,223,8626,630883,631106,23
5109,226,8708,631024,631250,23
8423,230,9865,630093,630323,23
4972,231,8965,631223,631454,23
3978,231,9847,630572,630803,23
2866,232,9281,631369,631601,23
7516,232,9727,631155,631387,23
1022,234,8440,632674,632908,23
4602,237,8011,633337,633574,23
7879,237,8549,633036,633273,23
5339,242,9493,632329,632571,23
2877,246,9941,632123,632369,23
1917,251,8647,633663,633914,23
6308,252,9197,633364,633616,23
7400,252,9292,633521,633773,23
1019,257,9459,633606,633863,23
5544,259,8287,635035,635294,23
9532,260,9634,633947,634207,23
6757,262,9647,634194,634456,23
8135,264,9567,634536,634800,23
7021,266,9729,634638,634904,23
3544,267,9590,635043,635310,23
1058,270,9358,635542,635812,23
4195,270,9433,635737,636007,23
1298,270,9817,635623,635893,23
8965,276,8495,637215,637491,23
6930,277,8601,637385,637662,23
3689,277,8977,637286,637563,23
3119,279,9629,636911,637190,23
6658,279,9669,637150,637429,23
7090,281,8557,638541,638822,23
4396,283,9296,638083,638366,23
3586,285,9055,638607,638892,23
8821,287,8174,639773,640060,23
3121,288,9784,638450,638738,23
9449,290,8608,639914,640204,23
3965,292,8029,640783,641075,23
8558,294,8584,640520,640814,23
2388,295,8672,640726,641021,23
9879,299,9650,640043,640342,23
8231,300,9319,640673,640973,23
207,287,64,3514,3801,24
522,13,485,53630,53643,24
437,14,649,53479,53493,24
897,16,196,53946,53962,24
348,30,411,53747,53777,24
695,59,824,53364,53423,24
965,66,135,54112,54178,24
476,76,561,53752,53828,24
346,81,427,53962,54043,24
593,92,513,53957,54049,24
566,99,851,53711,53810,24
417,133,239,54422,54555,24
876,177,472,54322,54499,24
692,188,712,54259,54447,24
994,195,647,54512,54707,24
156,291,972,54382,54673,24
570,298,808,54837,55135,24
198,300,392,55551,55851,24
4711,1,9912,640380,640381,24
9057,2,9134,641159,641161,24
8562,3,9028,641267,641270,24
8884,5,8075,642223,642228,24
1895,5,8339,641964,641969,24
1222,6,8753,641555,641561,24
1323,7,8339,641975,641982,24
1229,7,9508,640813,640820,24
3347,10,8204,642124,642134,24
7007,10,8230,642108,642118,24
5264,12,8432,641916,641928,24
2191,12,9219,641141,641153,24
5319,12,9568,640804,640816,24
2796,14,8882,641502,641516,24
7041,19,8448,641950,641969,24
8943,21,8503,641914,641935,24
4454,21,9717,640721,640742,24
9954,24,8469,641990,642014,24
5088,25,9082,641401,641426,24
9481,26,9463,641045,641071,24
7513,26,9913,640621,640647,24
2305,29,8486,642074,642103,24
3147,29,9009,641580,641609,24
2008,32,8080,642538,642570,24
3570,34,9922,640728,640762,24
4892,36,9187,641497,641533,24
6230,37,8763,641957,641994,24
4000,38,8887,641870,641908,24
1572,39,8976,641819,641858,24
5835,39,9024,641810,641849,24
9799,40,9303,641570,641610,24
1394,43,8102,642811,642854,24
2407,44,8353,642603,642647,24
4428,45,9965,641035,641080,24
4875,46,9722,641323,641369,24
5696,47,9783,641308,641355,24
7564,48,8975,642163,642211,24
4686,50,9772,641414,641464,24
6967,52,8124,643112,643164,24
7228,52,9834,641454,641506,24
1845,53,9703,641637,641690,24
3200,53,9823,641570,641623,24
1117,54,9214,642232,642286,24
4200,55,9018,642482,642537,24
7123,59,9228,642327,642386,24
5029,61,8394,643220,643281,24
8964,62,8464,643211,643273,24
9611,62,8542,643195,643257,24
3597,65,9872,641927,641992,24
6500,66,9235,642629,642695,24
1144,68,8197,643733,643801,24
3154,68,9824,642174,642242,24
6239,70,9972,642094,642164,24
3273,72,8910,643226,643298,24
5464,72,9683,642525,642597,24
2800,74,8219,644061,644135,24
7195,78,8484,643870,643948,24
7927,78,8767,643665,643743,24
8189,78,8771,643739,643817,24
2596,80,8057,644531,644611,24
8613,82,8718,643950,644032,24
5795,83,8178,644572,644655,24
6633,93,8678,644155,644248,24
8338,94,9573,643353,643447,24
8870,98,9704,643316,643414,24
1434,103,8621,644497,644600,24
7889,103,9542,643679,643782,24
7745,103,9672,643652,643755,24
6666,104,9275,644152,644256,24
7163,108,9732,643799,643907,24
5552,109,8737,644902,645011,24
2563,115,8716,645032,645147,24
2344,116,8760,645103,645219,24
5421,116,8772,645207,645323,24
7899,118,9074,645021,645139,24
2490,119,9607,644606,644725,24
4418,122,9545,644787,644909,24
4613,122,9758,644696,644818,24
8766,123,8482,646094,646217,24
6214,123,8721,645978,646101,24
1437,125,8656,646166,646291,24
4733,126,8695,646252,646378,24
8627,128,9419,645654,645782,24
6117,130,8155,647046,647176,24
6051,130,8938,646393,646523,24
8877,130,9610,645851,645981,24
8464,135,8817,646774,646909,24
8490,136,9204,646522,646658,24
5026,136,9362,646500,646636,24
2411,137,8742,647256,647393,24
4501,138,8433,647702,647840,24
5593,138,8816,647457,647595,24
5687,140,8506,647905,648045,24
3387,140,8666,647885,648025,24
5822,141,9662,647029,647170,24
2296,142,9668,647164,647306,24
9042,143,8073,648901,649044,24
6078,144,8216,648901,649045,24
1986,144,9315,647946,648090,24
8949,148,9758,647647,647795,24
7572,150,8217,649336,649486,24
2256,152,9310,648393,648545,24
4246,153,9803,648052,648205,24
2895,154,8734,649274,649428,24
3985,155,8321,649841,649996,24
2440,156,8201,650116,650272,24
1056,157,9126,649347,649504,24
5763,158,9488,649142,649300,24
8458,160,9589,649199,649359,24
5327,161,8663,650285,650446,24
3262,168,8527,650582,650750,24
3636,169,8587,650690,650859,24
5241,172,8670,650776,650948,24
8535,178,9710,649908,650086,24
9730,179,9613,650183,650362,24
8531,182,9946,650029,650211,24
3716,186,8902,651255,651441,24
5247,186,9601,650742,650928,24
9285,187,9900,650629,650816,24
8366,191,9326,651390,651581,24
3640,194,9687,651220,651414,24
7466,195,9634,651467,651662,24
2529,195,9850,651446,651641,24
9091,196,9686,651805,652001,24
6537,197,9269,652418,652615,24
9633,201,9959,651925,652126,24
9077,202,9548,652537,652739,24
2935,202,9740,652547,652749,24
1126,205,8507,653982,654187,24
5964,205,9193,653501,653706,24
7819,209,8539,654360,654569,24
8093,215,8159,654949,655164,24
8131,215,9657,653666,653881,24
7493,216,8562,654976,655192,24
3560,218,9544,654210,654428,24
1940,222,8820,655152,655374,24
2930,228,8087,656107,656335,24
9537,229,8829,655593,655822,24
3191,229,9443,655208,655437,24
5633,230,9855,655025,655255,24
2536,231,9173,655937,656168,24
8162,235,9452,655889,656124,24
3494,236,8226,657350,657586,24
9803,237,9527,656285,656522,24
4006,240,9710,656339,656579,24
4589,242,9166,657123,657365,24
5287,242,9660,656871,657113,24
7761,246,8891,657882,658128,24
4789,247,9624,657395,657642,24
2347,250,8566,658700,658950,24
4675,251,8963,658553,658804,24
6748,252,9877,657890,658142,24
7578,253,8907,659112,659365,24
5061,254,8744,659528,659782,24
2506,257,8442,660084,660341,24
6447,258,8577,660206,660464,24
1122,259,8019,661022,661281,24
5166,260,9109,660191,660451,24
6084,264,8665,660895,661159,24
6076,265,8083,661741,662006,24
3856,265,9093,660996,661261,24
4736,268,8214,662140,662408,24
1422,269,8330,662292,662561,24
9743,270,8468,662423,662693,24
4767,274,8777,662384,662658,24
4219,280,8178,663257,663537,24
1921,280,8496,663219,663499,24
3962,284,9043,662952,663236,24
2879,285,8708,663571,663856,24
1327,286,8899,663665,663951,24
1963,286,9579,663271,663557,24
9123,289,9108,664028,664317,24
1129,289,9837,663588,663877,24
5771,291,8812,664902,665193,24
4152,291,9179,664826,665117,24
7506,295,8974,665322,665617,24
7981,296,8665,665926,666222,24
9747,297,8904,665983,666280,24
5076,297,9623,665561,665858,24
2252,298,8669,666812,667110,24
3159,299,8214,667565,667864,24
2908,299,9969,666109,666408,24
196,213,69,3796,4009,25
992,1,569,55674,55675,25
231,57,862,55382,55439,25
449,65,395,55906,55971,25
264,69,654,55712,55781,25
314,76,480,55955,56031,25
428,150,689,55822,55972,25
297,152,131,56530,56682,25
713,161,133,56680,56841,25
141,161,438,56536,56697,25
513,186,348,56787,56973,25
766,196,767,56554,56750,25
894,202,108,57409,57611,25
618,216,232,57487,57703,25
907,230,114,57821,58051,25
144,236,341,57824,58060,25
640,254,791,57610,57864,25
330,272,292,58363,58635,25
986,276,347,58580,58856,25
935,292,147,59056,59348,25
8643,2,8002,668375,668377,25
4812,4,8118,668261,668265,25
6648,4,8208,668175,668179,25
7488,4,8621,667766,667770,25
2434,6,8831,667560,667566,25
9311,6,9891,666506,666512,25
1959,7,9354,667049,667056,25
5093,8,8031,668379,668387,25
9372,8,8398,668020,668028,25
6577,11,8744,667682,667693,25
2278,12,9933,666504,666516,25
5337,16,9128,667321,667337,25
7055,17,8949,667516,667533,25
6459,19,8426,668056,668075,25
4248,19,9998,666503,666522,25
8369,20,8902,667618,667638,25
9680,20,9013,667527,667547,25
5693,23,8529,668031,668054,25
4071,23,8753,667830,667853,25
8652,23,9367,667239,667262,25
7161,24,9020,667609,667633,25
3001,25,9134,667519,667544,25
4134,25,9678,667000,667025,25
1601,29,9575,667128,667157,25
9213,30,8287,668445,668475,25
1775,31,8254,668508,668539,25
8561,31,9342,667451,667482,25
6810,32,8264,668560,668592,25
1414,35,9485,667371,667406,25
7538,37,8873,668018,668055,25
6602,40,9183,667745,667785,25
6896,40,9703,667265,667305,25
6178,41,8820,668188,668229,25
7093,42,8063,668986,669028,25
4985,43,9961,667130,667173,25
2568,47,8923,668211,668258,25
3771,47,9781,667400,667447,25
2446,47,9918,667310,667357,25
6779,52,8677,668598,668650,25
3503,54,9861,667466,667520,25
8601,54,9910,667471,667525,25
3976,55,8868,668567,668622,25
8489,58,8677,668813,668871,25
5095,58,9213,668335,668393,25
5996,59,8135,669471,669530,25
5062,62,9569,668096,668158,25
7575,63,9977,667750,667813,25
4942,65,8135,669655,669720,25
4860,65,8647,669208,669273,25
6590,70,9999,667921,667991,25
5055,72,9750,668240,668312,25
4835,75,8184,669878,669953,25
3584,76,8033,670104,670180,25
2719,80,8030,670183,670263,25
4316,82,8469,669824,669906,25
8100,87,8680,669695,669782,25
6809,88,9097,669365,669453,25
5070,90,8782,669768,669858,25
4394,91,8115,670525,670616,25
6144,92,8294,670437,670529,25
8321,95,9830,668993,669088,25
9438,98,8398,670520,670618,25
2984,100,8766,670250,670350,25
6022,101,8324,670792,670893,25
5611,102,9456,669761,669863,25
3291,103,8223,671096,671199,25
8307,106,8663,670759,670865,25
6570,107,9186,670342,670449,25
5775,108,8916,670719,670827,25
9594,108,9273,670470,670578,25
5813,112,8031,671820,671932,25
7070,112,8838,671125,671237,25
3496,112,9131,670944,671056,25
2933,113,8734,671453,671566,25
8723,119,8709,671591,671710,25
4828,120,8105,672314,672434,25
9886,120,9166,671373,671493,25
8354,123,9246,671413,671536,25
2943,125,8979,671803,671928,25
7244,127,9883,671024,671151,25
3325,128,8260,672774,672902,25
1507,129,8780,672382,672511,25
3289,132,9302,671989,672121,25
4531,134,9523,671900,672034,25
8373,138,8579,672978,673116,25
6731,147,9967,671728,671875,25
8431,148,9365,672477,672625,25
8108,148,9533,672457,672605,25
2127,149,9726,672412,672561,25
9885,149,9891,672396,672545,25
3696,151,8311,674125,674276,25
4430,151,9152,673435,673586,25
9037,154,8889,673849,674003,25
1412,155,9231,673661,673816,25
8024,156,8076,674971,675127,25
3471,156,9721,673482,673638,25
8017,159,9086,674273,674432,25
5175,159,9367,674151,674310,25
2062,160,8964,674713,674873,25
6583,161,8385,675452,675613,25
3272,161,9285,674713,674874,25
8691,162,8925,675234,675396,25
1622,166,8163,676158,676324,25
8280,169,8830,675657,675826,25
9951,169,9040,675616,675785,25
5288,174,9119,675706,675880,25
4521,178,8303,676696,676874,25
8991,178,8343,676834,677012,25
4319,179,8013,677342,677521,25
4448,181,8026,677508,677689,25
9100,182,8881,676834,677016,25
4914,184,9639,676258,676442,25
9418,185,9793,676288,676473,25
3073,186,8004,678262,678448,25
5431,187,9147,677305,677492,25
3416,190,8254,678385,678575,25
9189,190,9200,677629,677819,25
7762,194,9534,677485,677679,25
7336,195,8450,678763,678958,25
5164,195,8470,678938,679133,25
4330,195,8700,678903,679098,25
1073,198,8569,679229,679427,25
4697,198,9429,678567,678765,25
9048,199,9304,678890,679089,25
6172,200,9423,678970,679170,25
6586,203,9883,678710,678913,25
2528,208,8810,679986,680194,25
2248,211,8984,680020,680231,25
8498,213,9758,679457,679670,25
3369,215,9441,679987,680202,25
2924,217,9089,680554,680771,25
7540,219,9421,680439,680658,25
2218,220,8749,681330,681550,25
9061,222,8150,682149,682371,25
5249,222,8945,681576,681798,25
4881,231,8808,681935,682166,25
1717,235,9021,681953,682188,25
1260,239,8920,682289,682528,25
8768,240,9935,681513,681753,25
8692,241,8514,683174,683415,25
9215,241,9331,682598,682839,25
2419,244,8618,683552,683796,25
4685,246,9941,682473,682719,25
7403,248,9445,683215,683463,25
9693,249,9512,683396,683645,25
1692,250,8111,685046,685296,25
5707,252,8835,684572,684824,25
9606,253,9800,683859,684112,25
2789,256,8869,685043,685299,25
9224,258,9275,684893,685151,25
1159,259,9583,684843,685102,25
9622,271,8189,686496,686767,25
2076,273,9049,685907,686180,25
3967,274,8896,686333,686607,25
2818,274,9749,685754,686028,25
4287,277,8425,687352,687629,25
5772,277,8670,687384,687661,25
3843,279,8212,688119,688398,25
9644,279,9051,687559,687838,25
9556,284,8920,687969,688253,25
7243,286,8720,688453,688739,25
2938,286,9899,687560,687846,25
3531,289,9859,687886,688175,25
4479,291,8150,689884,690175,25
5153,292,8481,689844,690136,25
9668,293,8838,689779,690072,25
9440,294,8490,690420,690714,25
4131,294,8580,690624,690918,25
2136,295,8585,690913,691208,25
5129,295,9498,690295,690590,25
3888,295,9639,690449,690744,25
7900,298,8147,692236,692534,25
2782,298,9101,691580,691878,25
7329,298,9628,691351,691649,25
1461,299,9700,691577,691876,25
4317,299,9733,691843,692142,25
822,4,157,59338,59342,26
303,4,954,58545,58549,26
411,14,712,58791,58805,26
783,19,309,59208,59227,26
808,26,905,58631,58657,26
840,34,114,59448,59482,26
615,38,877,58719,58757,26
324,44,874,58760,58804,26
526,65,866,58812,58877,26
359,74,141,59602,59676,26
957,74,217,59600,59674,26
313,78,384,59507,59585,26
336,119,340,59629,59748,26
928,172,658,59430,59602,26
871,175,195,60065,60240,26
376,201,157,60278,60479,26
453,217,139,60497,60714,26
115,223,569,60284,60507,26
492,231,514,60562,60793,26
915,232,349,60958,61190,26
446,262,690,60849,61111,26
744,269,643,61158,61427,26
2458,4,8878,692997,693001,26
4517,5,8760,693119,693124,26
6360,6,8464,693420,693426,26
5846,9,9891,691999,692008,26
8216,10,9741,692158,692168,26
8600,10,9741,692168,692178,26
7198,11,8195,693724,693735,26
3757,11,9156,692774,692785,26
3373,11,9935,692006,692017,26
9199,12,8527,693425,693437,26
3336,12,9334,692630,692642,26
8315,13,9950,692026,692039,26
1292,14,8684,693305,693319,26
9692,18,8293,693710,693728,26
5021,19,8963,693058,693077,26
8058,21,8598,693442,693463,26
4441,23,8345,693716,693739,26
6264,24,8561,693523,693547,26
1669,26,9732,692376,692402,26
6558,30,8754,693380,693410,26
5394,31,8723,693441,693472,26
4895,32,8640,693555,693587,26
8415,32,9183,693044,693076,26
9732,33,8802,693457,693490,26
8092,33,9594,692698,692731,26
9289,36,9110,693215,693251,26
9406,36,9990,692371,692407,26
5334,37,9535,692862,692899,26
4833,39,8180,694254,694293,26
8922,40,8186,694287,694327,26
3449,40,8826,693687,693727,26
1804,42,9657,692896,692938,26
3555,44,9502,693093,693137,26
3522,44,9825,692814,692858,26
7847,47,9897,692786,692833,26
5106,48,8230,694500,694548,26
8913,51,9432,693346,693397,26
4741,52,8046,694783,694835,26
3568,54,8536,694345,694399,26
9599,54,8744,694191,694245,26
4293,57,9674,693315,693372,26
4139,59,8852,694194,694253,26
9980,60,9471,693634,693694,26
3385,61,9323,693842,693903,26
6838,61,9331,693895,693956,26
2844,64,8858,694429,694493,26
4309,64,9361,693990,694054,26
5146,64,9734,693681,693745,26
8179,65,8374,695105,695170,26
1586,66,9838,693706,693772,26
6197,68,8811,694799,694867,26
9336,69,9068,694610,694679,26
2539,70,8592,695155,695225,26
4144,71,8755,695062,695133,26
3417,75,9107,694781,694856,26
6778,77,8142,695821,695898,26
6033,86,8308,695732,695818,26
1382,86,8333,695793,695879,26
5479,87,9829,694383,694470,26
3542,87,9976,694323,694410,26
5550,88,8434,695952,696040,26
1556,91,9215,695259,695350,26
7391,93,8115,696450,696543,26
2056,93,8590,696068,696161,26
9391,95,8600,696151,696246,26
1291,98,8731,696115,696213,26
5916,98,9529,695415,695513,26
1746,101,9329,695713,695814,26
2610,102,8830,696313,696415,26
3409,106,9712,695533,695639,26
1196,108,8500,696851,696959,26
6823,109,8721,696738,696847,26
6761,112,9402,696166,696278,26
2882,113,9922,695758,695871,26
9043,117,8595,697198,697315,26
5415,118,8454,697456,697574,26
5678,119,8356,697672,697791,26
5320,124,8403,697744,697868,26
8491,124,9687,696584,696708,26
7197,125,8715,697680,697805,26
8478,126,8246,698274,698400,26
8779,130,8184,698462,698592,26
4128,135,9949,696827,696962,26
6545,139,8537,698374,698513,26
4230,139,9724,697326,697465,26
1862,141,8673,698516,698657,26
8400,141,9569,697761,697902,26
5004,142,9160,698311,698453,26
6126,142,9415,698198,698340,26
9776,147,8438,699317,699464,26
1208,147,9397,698505,698652,26
9081,148,8591,699458,699606,26
5612,154,9941,698256,698410,26
1130,159,8143,700208,700367,26
1742,160,8158,700352,700512,26
9323,160,9294,699376,699536,26
1076,161,9555,699275,699436,26
3710,161,9873,699118,699279,26
3238,166,8786,700366,700532,26
5619,167,9794,699524,699691,26
9021,172,9609,699876,700048,26
9711,172,9754,699903,700075,26
7014,175,8489,701340,701515,26
3136,175,8745,701259,701434,26
1232,180,9750,700429,700609,26
9272,181,9158,701201,701382,26
2641,181,9582,700958,701139,26
3021,183,8477,702244,702427,26
9557,183,8822,702082,702265,26
3328,184,9898,701189,701373,26
5074,185,8735,702536,702721,26
2968,187,8058,703398,703585,26
7063,188,9522,702121,702309,26
7353,189,8644,703187,703376,26
5542,191,8576,703444,703635,26
5572,195,8579,703632,703827,26
1179,195,8693,703713,703908,26
1207,196,9385,703216,703412,26
5008,199,9822,702975,703174,26
1580,200,9573,703423,703623,26
6101,202,8734,704462,704664,26
5043,204,9929,703469,703673,26
9270,206,9104,704498,704704,26
7849,214,9839,703969,704183,26
4034,216,8915,705107,705323,26
1560,220,9986,704252,704472,26
8391,223,9354,705104,705327,26
8855,227,8139,706542,706769,26
4110,228,9615,705293,705521,26
8416,229,8363,706773,707002,26
5469,229,9213,706152,706381,26
8764,230,9327,706267,706497,26
8003,231,8709,707115,707346,26
7805,231,9466,706589,706820,26
2749,232,8623,707663,707895,26
3160,232,8844,707674,707906,26
8079,233,9021,707729,707962,26
9551,234,9866,707117,707351,26
2026,236,8046,709171,709407,26
4092,237,8478,708975,709212,26
3197,238,8243,709447,709685,26
7448,239,9745,708183,708422,26
1326,240,8834,709333,709573,26
1797,240,9329,709078,709318,26
4565,241,8263,710384,710625,26
4153,241,8810,710078,710319,26
5677,242,9874,709255,709497,26
8978,243,8815,710556,710799,26
4698,247,9680,709934,710181,26
6093,248,9800,710061,710309,26
4953,251,9772,710337,710588,26
3455,251,9778,710582,710833,26
5121,252,9297,711314,711566,26
1924,255,9256,711607,711862,26
4998,256,9519,711599,711855,26
3066,257,8411,712963,713220,26
2537,257,9906,711725,711982,26
2234,258,9134,712754,713012,26
3872,258,9710,712436,712694,26
5904,260,9541,712863,713123,26
3866,263,8257,714407,714670,26
9467,264,9337,713590,713854,26
4689,266,8098,715093,715359,26
2315,268,9590,713867,714135,26
9587,268,9722,714003,714271,26
7295,269,9527,714466,714735,26
5984,274,8502,715760,716034,26
9086,275,8802,715734,716009,26
1057,276,9789,715022,715298,26
5492,279,9864,715223,715502,26
8421,280,8419,716947,717227,26
8429,281,8624,717022,717303,26
5514,282,8211,717716,717998,26
5802,283,8080,718129,718412,26
9695,284,9237,717255,717539,26
3824,286,9571,717205,717491,26
6321,287,9536,717526,717813,26
4683,289,9808,717541,717830,26
3344,291,8750,718888,719179,26
3630,294,9323,718606,718900,26
8013,296,9795,718428,718724,26
3497,296,9827,718692,718988,26
4415,297,9709,719106,719403,26
1176,298,9421,719691,719989,26
7489,300,9699,719711,720011,26
173,193,77,4001,4194,27
775,17,459,61611,61628,27
742,29,137,61950,61979,27
921,37,564,61552,61589,27
165,38,418,61735,61773,27
186,65,350,61841,61906,27
893,80,446,61810,61890,27
368,86,693,61643,61729,27
884,90,923,61499,61589,27
245,100,618,61894,61994,27
793,106,266,62346,62452,27
510,110,206,62512,62622,27
726,129,311,62517,62646,27
867,146,603,62354,62500,27
261,178,959,62144,62322,27
779,180,184,63097,63277,27
961,189,898,62563,62752,27
113,196,140,63510,63706,27
939,205,415,63431,63636,27
888,229,382,63669,63898,27
700,234,952,63328,63562,27
270,266,483,64031,64297,27
4920,2,8586,721124,721126,27
4508,3,9335,720377,720380,27
2740,3,9554,720161,720164,27
4754,5,8243,721475,721480,27
2545,13,8095,721628,721641,27
3490,16,8485,721251,721267,27
2762,17,8320,721432,721449,27
2783,19,9391,720378,720397,27
2431,21,9041,720747,720768,27
6638,23,9794,720015,720038,27
6319,25,9470,720362,720387,27
6235,26,9045,720812,720838,27
3051,29,8861,721022,721051,27
1447,29,9200,720712,720741,27
5858,31,8409,721532,721563,27
3619,32,8339,721633,721665,27
5884,35,9438,720566,720601,27
9111,37,9637,720402,720439,27
1558,38,9952,720124,720162,27
4084,40,9592,720522,720562,27
4699,41,9232,720922,720963,27
8537,42,8093,722102,722144,27
6179,46,8630,721607,721653,27
1290,49,8070,722213,722262,27
7693,50,9678,720654,720704,27
4095,51,8955,721427,721478,27
4899,51,9476,720957,721008,27
3694,53,8762,721722,721775,27
7933,53,9207,721330,721383,27
6901,53,9582,721008,721061,27
5531,55,8844,721799,721854,27
4288,62,9069,721629,721691,27
4519,65,9989,720771,720836,27
9705,66,9912,720913,720979,27
7813,67,9587,721304,721371,27
7207,68,8439,722519,722587,27
1710,68,9936,721090,721158,27
4220,72,8084,723010,723082,27
6732,72,8328,722838,722910,27
5142,75,8377,722861,722936,27
1217,78,8852,722461,722539,27
4746,81,8665,722726,722807,27
9719,83,8139,723333,723416,27
8875,86,9841,721714,721800,27
6225,87,9520,722121,722208,27
3475,87,9906,721822,721909,27
6978,88,9954,721861,721949,27
2402,90,9295,722608,722698,27
4487,92,8917,723076,723168,27
4338,96,8073,724012,724108,27
5878,97,8462,723719,723816,27
6042,97,9038,723240,723337,27
9945,100,8849,723526,723626,27
1035,101,8115,724360,724461,27
6183,103,8278,724298,724401,27
7247,106,9000,723679,723785,27
1148,108,9091,723694,723802,27
8661,109,9810,723083,723192,27
4830,111,8116,724886,724997,27
6606,117,9982,723131,723248,27
7302,118,8508,724722,724840,27
1514,119,8362,724986,725105,27
9697,119,9158,724309,724428,27
9751,121,8679,724907,725028,27
7586,122,8459,725248,725370,27
4382,122,8537,725292,725414,27
2735,122,9923,724028,724150,27
4228,123,8007,726066,726189,27
3761,124,9480,724716,724840,27
6402,125,9486,724834,724959,27
3194,125,9525,724920,725045,27
1235,125,9598,724972,725097,27
4459,126,9223,725472,725598,27
3894,128,8532,726289,726417,27
3817,128,9433,725516,725644,27
6531,129,9408,725669,725798,27
2123,131,9666,725540,725671,27
1962,133,8624,726713,726846,27
7767,133,8815,726655,726788,27
5178,136,8204,727399,727535,27
8201,144,8641,727098,727242,27
1383,146,9894,725989,726135,27
5396,147,8541,727488,727635,27
1947,147,9868,726308,726455,27
7613,148,8316,728007,728155,27
4785,149,9276,727195,727344,27
8049,156,9680,726940,727096,27
2672,160,9005,727771,727931,27
4664,167,9755,727181,727348,27
4618,172,9314,727789,727961,27
7309,173,9528,727747,727920,27
3672,175,9164,728284,728459,27
8169,176,9648,727975,728151,27
4469,179,9585,728214,728393,27
4190,180,8337,729641,729821,27
7956,182,9689,728469,728651,27
6541,183,9922,728418,728601,27
9363,185,8268,730255,730440,27
6300,185,9086,729622,729807,27
1511,185,9355,729538,729723,27
2141,186,8539,730539,730725,27
6417,193,9551,729713,729906,27
6546,193,9732,729725,729918,27
2499,195,8580,731070,731265,27
5315,196,8335,731510,731706,27
3830,197,8370,731671,731868,27
2828,199,8807,731431,731630,27
7686,204,8158,732279,732483,27
1281,204,8262,732379,732583,27
7583,205,9387,731458,731663,27
1839,207,8005,733045,733252,27
8425,207,9001,732256,732463,27
1032,208,9063,732401,732609,27
5526,210,9046,732626,732836,27
2469,210,9197,732685,732895,27
5928,211,9376,732716,732927,27
2327,212,8735,733568,733780,27
2823,213,9377,733138,733351,27
7157,218,8051,734677,734895,27
5242,219,9941,733005,733224,27
9499,222,9022,734143,734365,27
7305,224,9868,733519,733743,27
8699,225,9511,734100,734325,27
3354,227,9191,734645,734872,27
1830,228,8212,735851,736079,27
7544,228,9088,735203,735431,27
3307,228,9228,735291,735519,27
4866,233,9292,735455,735688,27
2679,235,8241,736739,736974,27
2575,235,8253,736962,737197,27
5958,235,9671,735779,736014,27
1883,236,9000,736685,736921,27
7961,236,9061,736860,737096,27
2775,238,8700,737457,737695,27
1017,239,8208,738187,738426,27
8378,242,9704,736930,737172,27
2869,243,9097,737779,738022,27
1145,245,9421,737698,737943,27
8669,246,9754,737610,737856,27
2741,248,9292,738318,738566,27
4156,250,8777,739081,739331,27
1289,255,8501,739607,739862,27
2346,258,9483,738880,739138,27
7543,259,8759,739862,740121,27
5733,261,9204,739676,739937,27
5436,261,9487,739654,739915,27
8859,266,8576,740826,741092,27
9893,271,9417,740251,740522,27
1220,274,9724,740215,740489,27
6219,276,9814,740399,740675,27
1718,277,9253,741236,741513,27
8453,278,8582,742184,742462,27
7993,278,9796,741248,741526,27
5702,282,8743,742579,742861,27
7077,284,9958,741646,741930,27
2549,285,8404,743484,743769,27
3436,286,8552,743621,743907,27
4871,289,8306,744153,744442,27
5766,290,8264,744484,744774,27
8603,290,9883,743155,743445,27
3680,293,8777,744551,744844,27
8625,295,8119,745502,745797,27
5155,300,8099,745817,746117,27
5829,300,8735,745481,745781,27
108,16,802,63978,63994,28
527,18,379,64417,64435,28
599,22,943,63871,63893,28
136,29,416,64420,64449,28
920,37,445,64420,64457,28
578,38,834,64068,64106,28
547,46,150,64790,64836,28
455,53,235,64751,64804,28
948,59,927,64112,64171,28
106,80,826,64272,64352,28
916,94,109,65069,65163,28
747,116,577,64695,64811,28
378,134,727,64661,64795,28
271,142,188,65334,65476,28
655,168,760,64904,65072,28
651,183,168,65664,65847,28
373,208,503,65512,65720,28
340,217,358,65865,66082,28
598,222,142,66298,66520,28
597,269,709,65953,66222,28
797,283,683,66248,66531,28
614,293,868,66346,66639,28
320,296,730,66777,67073,28
2518,1,8985,745531,745532,28
9740,3,8555,745962,745965,28
4865,4,8238,746282,746286,28
2659,5,9424,745100,745105,28
4621,8,9149,745380,745388,28
9489,9,9275,745262,745271,28
9834,9,9653,744893,744902,28
3855,10,8460,746095,746105,28
4846,10,9083,745482,745492,28
4628,16,9916,744659,744675,28
6690,17,8240,746351,746368,28
1858,17,8564,746044,746061,28
5262,17,8758,745867,745884,28
6516,17,8803,745839,745856,28
2193,26,9598,745061,745087,28
8709,28,8586,746099,746127,28
4651,28,9737,744976,745004,28
3164,29,8325,746416,746445,28
2561,31,8685,746085,746116,28
7858,31,9634,745167,745198,28
9764,33,9423,745409,745442,28
5208,34,8642,746223,746257,28
7038,35,8720,746179,746214,28
5956,35,9651,745283,745318,28
3913,36,8997,745972,746008,28
3352,36,9351,745654,745690,28
5385,37,8574,746467,746504,28
3671,37,8602,746476,746513,28
5100,37,9386,745729,745766,28
7233,37,9436,745716,745753,28
5037,41,8074,747115,747156,28
5268,44,8462,746768,746812,28
8604,46,9456,745818,745864,28
2319,47,8091,747229,747276,28
2974,47,8437,746930,746977,28
6052,49,9246,746168,746217,28
6947,49,9347,746116,746165,28
1623,50,8855,746657,746707,28
4662,50,9257,746305,746355,28
4688,53,9893,745719,745772,28
9120,60,8118,747547,747607,28
2541,60,9011,746714,746774,28
1733,61,8204,747581,747642,28
2066,62,8260,747586,747648,28
7322,63,8600,747308,747371,28
5329,64,9224,746747,746811,28
2143,66,9501,746534,746600,28
1590,68,9676,746425,746493,28
9267,70,9250,746919,746989,28
9816,70,9550,746689,746759,28
2936,71,9588,746721,746792,28
6645,72,8170,748210,748282,28
7722,72,8953,747499,747571,28
7395,72,9089,747435,747507,28
5648,75,9433,747163,747238,28
1688,76,8827,747844,747920,28
5156,78,9931,746816,746894,28
9833,79,8408,748417,748496,28
8156,81,8670,748234,748315,28
2843,81,9297,747688,747769,28
1946,81,9617,747449,747530,28
4744,82,8191,748956,749038,28
6846,85,8506,748723,748808,28
5197,86,8136,749178,749264,28
9625,87,9333,748067,748154,28
1053,88,8070,749417,749505,28
7892,92,8835,748740,748832,28
3151,93,9438,748229,748322,28
6704,94,8778,748982,749076,28
4001,94,9542,748312,748406,28
3900,95,8769,749179,749274,28
3236,96,8750,749293,749389,28
6065,97,9102,749037,749134,28
6067,97,9229,749007,749104,28
5299,100,8093,750240,750340,28
3896,100,8478,749955,750055,28
4325,100,8867,749666,749766,28
6408,101,9652,748981,749082,28
5836,102,9856,748878,748980,28
4630,103,9924,748912,749015,28
6086,107,8533,750406,750513,28
1815,111,9018,750028,750139,28
9536,112,9194,749963,750075,28
5233,113,8376,750893,751006,28
4467,115,9319,750063,750178,28
1516,117,8618,750879,750996,28
9722,117,9040,750574,750691,28
3329,119,8331,751400,751519,28
9679,120,8847,751003,751123,28
1682,122,8774,751196,751318,28
3460,123,8101,751991,752114,28
1931,124,8591,751624,751748,28
1679,125,8147,752192,752317,28
3924,126,8712,751752,751878,28
7566,126,9908,750682,750808,28
4050,128,8975,751741,751869,28
6601,128,9034,751810,751938,28
3389,128,9074,751898,752026,28
7460,132,8859,752241,752373,28
6850,134,9072,752160,752294,28
5165,134,9307,752059,752193,28
9929,138,8563,752937,753075,28
1250,146,9203,752435,752581,28
6383,146,9560,752224,752370,28
8330,146,9770,752160,752306,28
4432,148,8350,753726,753874,28
9858,148,8613,753611,753759,28
5538,149,9930,752442,752591,28
7029,150,8043,754478,754628,28
8085,150,9450,753221,753371,28
3714,151,8039,754782,754933,28
8159,151,9970,753002,753153,28
5650,152,9712,753411,753563,28
6619,156,9068,754207,754363,28
7755,156,9418,754013,754169,28
6922,156,9809,753778,753934,28
6563,157,8503,755240,755397,28
9405,158,9534,754366,754524,28
3245,159,8078,755980,756139,28
1694,160,8700,755517,755677,28
2589,162,8685,755692,755854,28
6905,164,8629,755910,756074,28
2100,164,9611,755092,755256,28
5200,168,8561,756306,756474,28
2179,170,9870,755165,755335,28
8407,174,8611,756594,756768,28
3750,176,9812,755567,755743,28
5231,177,8887,756668,756845,28
4550,177,9142,756590,756767,28
2176,177,9340,756569,756746,28
6819,181,8108,757978,758159,28
6345,181,9682,756585,756766,28
2914,189,8609,757839,758028,28
2584,191,9377,757260,757451,28
9387,194,9541,757287,757481,28
7619,195,8789,758233,758428,28
3068,197,9307,757910,758107,28
8622,200,9896,757518,757718,28
1357,202,9090,758524,758726,28
1371,204,8966,758850,759054,28
6774,206,9098,758922,759128,28
5913,206,9781,758445,758651,28
9590,208,9473,758959,759167,28
5179,213,9051,759589,759802,28
6391,214,9346,759507,759721,28
3203,218,8027,761040,761258,28
5566,218,9170,760115,760333,28
3911,218,9761,759742,759960,28
2428,221,9763,759958,760179,28
8578,228,8072,761870,762098,28
3681,228,8720,761450,761678,28
1654,229,9649,760749,760978,28
5274,230,9124,761503,761733,28
7987,230,9349,761508,761738,28
3012,240,9538,761549,761789,28
3253,241,8330,762997,763238,28
7451,241,8331,763237,763478,28
3728,244,8407,763402,763646,28
9160,244,9730,762323,762567,28
6672,247,9034,763263,763510,28
5443,251,9524,763020,763271,28
8737,253,9359,763436,763689,28
9714,254,9228,763820,764074,28
5910,257,8925,764377,764634,28
3909,258,8290,765269,765527,28
6929,258,9787,764030,764288,28
6488,260,9112,764963,765223,28
3791,261,9271,765064,765325,28
6142,263,8948,765648,765911,28
2595,264,8250,766609,766873,28
4692,268,9168,765955,766223,28
4375,275,9436,765955,766230,28
2682,276,8885,766781,767057,28
5932,278,9653,766289,766567,28
4968,279,9100,767120,767399,28
2554,279,9131,767368,767647,28
9852,279,9197,767581,767860,28
9044,279,9836,767221,767500,28
4277,283,8135,769201,769484,28
4292,283,8438,769181,769464,28
5048,283,9218,768684,768967,28
8255,283,9664,768521,768804,28
4018,284,9531,768937,769221,28
8901,285,8641,770111,770396,28
2342,285,9919,769118,769403,28
5186,288,8036,771286,771574,28
5865,288,8233,771377,771665,28
9274,291,9312,770586,770877,28
7842,292,8902,771287,771579,28
5989,292,9755,770726,771018,28
4041,293,8405,772368,772661,28
7117,295,9049,772017,772312,28
9421,298,9072,772289,772587,28
5053,299,8028,773631,773930,28
3133,299,8717,773241,773540,28
5943,300,8643,773614,773914,28
649,2,74,4197,4199,29
542,264,56,4217,4481,29
122,18,222,67581,67599,29
864,60,546,67275,67335,29
402,60,721,67160,67220,29
626,81,860,67081,67162,29
855,103,714,67308,67411,29
974,138,702,67423,67561,29
158,146,742,67521,67667,29
944,149,722,67687,67836,29
743,169,757,67801,67970,29
672,199,520,68207,68406,29
720,209,278,68648,68857,29
863,212,724,68411,68623,29
379,215,397,68950,69165,29
361,217,462,69100,69317,29
564,226,897,68882,69108,29
801,229,275,69730,69959,29
716,283,851,69383,69666,29
671,290,628,69889,70179,29
491,293,527,70280,70573,29
524,294,661,70439,70733,29
3651,2,9795,772762,772764,29
6876,3,8593,773966,773969,29
1062,4,8244,774318,774322,29
9079,5,8085,774481,774486,29
7075,8,9339,773232,773240,29
3112,10,9890,772689,772699,29
6937,11,8262,774327,774338,29
7648,12,8010,774590,774602,29
1409,15,8424,774188,774203,29
9376,15,9607,773020,773035,29
5020,16,8769,773873,773889,29
5543,17,9070,773588,773605,29
7128,19,8598,774077,774096,29
4335,19,8727,773967,773986,29
6903,19,9216,773497,773516,29
4278,20,8433,774299,774319,29
1676,20,9659,773093,773113,29
4366,22,8784,773988,774010,29
1263,23,8867,773927,773950,29
5069,24,8804,774013,774037,29
2567,24,9814,773027,773051,29
5260,26,8778,774087,774113,29
9836,27,8010,774881,774908,29
8830,27,8434,774484,774511,29
5112,27,8577,774368,774395,29
6369,27,9210,773762,773789,29
8157,29,9536,773463,773492,29
1806,29,9896,773132,773161,29
8918,30,9996,773061,773091,29
2999,32,8181,774906,774938,29
8539,32,8310,774809,774841,29
9096,34,8175,774976,775010,29
6432,34,9308,773877,773911,29
3320,37,9617,773602,773639,29
7031,37,9921,773335,773372,29
8568,39,9933,773360,773399,29
1091,41,8858,774474,774515,29
8140,44,9100,774273,774317,29
5940,46,8161,775256,775302,29
2670,47,8379,775084,775131,29
9019,47,8997,774513,774560,29
2658,47,9386,774171,774218,29
9655,49,9746,773858,773907,29
8272,51,8707,774946,774997,29
1463,52,9014,774690,774742,29
5032,55,9194,774562,774617,29
7246,55,9380,774431,774486,29
2065,56,9454,774412,774468,29
2298,61,8189,775733,775794,29
9880,61,9934,774049,774110,29
5859,62,8661,775383,775445,29
5807,63,8821,775285,775348,29
9511,63,9496,774673,774736,29
4512,64,9182,775050,775114,29
2164,64,9516,774780,774844,29
4676,66,9187,775173,775239,29
3006,67,8556,775870,775937,29
6847,67,8577,775916,775983,29
2261,67,9505,775055,775122,29
5757,71,9353,775274,775345,29
1656,72,9653,775045,775117,29
8357,73,8298,776472,776545,29
7397,73,9460,775383,775456,29
8589,77,8205,776711,776788,29
7526,81,9013,775980,776061,29
7567,84,8330,776744,776828,29
4740,84,9000,776158,776242,29
1616,84,9425,775817,775901,29
1896,86,8190,777136,777222,29
2802,87,8158,777254,777341,29
1719,88,9676,775823,775911,29
6957,91,8571,777016,777107,29
7562,91,9033,776645,776736,29
3446,91,9554,776215,776306,29
9523,94,8343,777517,777611,29
9561,95,8676,777278,777373,29
6689,101,8781,777268,777369,29
7199,106,9953,776197,776303,29
6387,112,8196,778060,778172,29
5229,113,8744,777624,777737,29
4829,114,9817,776664,776778,29
3533,117,9482,777113,777230,29
6765,119,8979,777733,777852,29
3886,121,9942,776889,777010,29
9184,123,9203,777749,777872,29
7799,127,8298,778777,778904,29
6580,127,9192,778010,778137,29
2571,130,9862,777467,777597,29
7511,132,8511,778948,779080,29
8222,134,9524,778067,778201,29
2694,135,8525,779200,779335,29
8298,135,8965,778895,779030,29
7862,135,9893,778102,778237,29
3244,138,9547,778583,778721,29
3309,139,8485,779783,779922,29
6358,140,8521,779886,780026,29
1097,140,8659,779888,780028,29
7473,141,8834,779853,779994,29
2511,143,8031,780797,780940,29
2349,149,9241,779730,779879,29
7721,149,9729,779391,779540,29
4047,149,9786,779483,779632,29
1509,150,8736,780682,780832,29
7864,150,9310,780258,780408,29
3132,153,8421,781297,781450,29
4410,154,8079,781792,781946,29
4393,154,9933,780092,780246,29
7452,155,9604,780575,780730,29
6380,156,9318,781016,781172,29
9250,156,9583,780907,781063,29
1286,159,8280,782366,782525,29
9721,161,8589,782216,782377,29
1407,163,8714,782252,782415,29
1744,164,8083,783046,783210,29
8849,166,9907,781386,781552,29
1427,168,9832,781627,781795,29
1901,171,8703,782924,783095,29
5326,175,9166,782632,782807,29
6675,177,8476,783497,783674,29
5468,177,9414,782736,782913,29
1944,178,8838,783489,783667,29
8741,179,8910,783595,783774,29
5962,181,9563,783121,783302,29
2743,182,8503,784362,784544,29
3679,186,9316,783731,783917,29
4667,187,8107,785126,785313,29
6475,187,8890,784530,784717,29
4518,189,8590,785017,785206,29
5709,189,9820,783976,784165,29
4080,190,9709,784276,784466,29
7470,191,9752,784423,784614,29
2182,195,8625,785741,785936,29
1850,195,9092,785469,785664,29
8198,195,9929,784827,785022,29
6431,197,9045,785906,786103,29
5503,199,9543,785605,785804,29
9927,200,9222,786125,786325,29
2138,201,9788,785759,785960,29
3399,205,8603,787145,787350,29
1423,205,9027,786926,787131,29
5743,205,9750,786408,786613,29
9370,206,9814,786549,786755,29
3885,207,8883,787686,787893,29
9441,214,8384,788392,788606,29
4859,214,9599,787391,787605,29
2813,215,8042,789162,789377,29
9504,216,9952,787467,787683,29
4431,218,8237,789398,789616,29
9841,218,9197,788656,788874,29
8770,224,9378,788693,788917,29
7251,229,9911,788384,788613,29
1515,231,8221,790303,790534,29
6261,232,8563,790192,790424,29
5857,233,9210,789777,790010,29
7410,234,8125,791095,791329,29
9939,234,9078,790376,790610,29
8756,236,9721,789967,790203,29
9445,236,9797,790127,790363,29
7823,237,8571,791589,791826,29
2873,244,9138,791259,791503,29
2535,247,9031,791610,791857,29
3906,248,8408,792480,792728,29
5007,248,9568,791568,791816,29
4574,250,8610,792774,793024,29
8007,251,8220,793414,793665,29
4058,251,8808,793077,793328,29
6744,254,8173,793963,794217,29
2837,254,9785,792605,792859,29
4046,255,9515,793129,793384,29
2477,258,9687,793212,793470,29
1978,260,9792,793365,793625,29
6525,261,8559,794858,795119,29
5599,263,9286,794392,794655,29
7634,263,9633,794308,794571,29
8485,269,9962,794242,794511,29
4729,272,8160,796313,796585,29
6821,272,8271,796474,796746,29
1871,272,8369,796648,796920,29
1198,272,9558,795731,796003,29
8924,272,9576,795985,796257,29
5490,272,9628,796205,796477,29
1900,283,8941,797164,797447,29
2884,290,9230,797158,797448,29
3483,292,8083,798595,798887,29
6502,294,8323,798647,798941,29
6285,295,8253,799011,799306,29
9498,295,9661,797898,798193,29
6374,296,8032,799822,800118,29
5405,296,9820,798330,798626,29
2856,299,8988,799458,799757,29
5211,300,8084,800661,800961,29
3117,300,8411,800634,800934,29
7196,300,8854,800491,800791,29
591,7,788,70606,70613,30
643,15,837,70564,70579,30
226,21,179,71237,71258,30
321,30,91,71346,71376,30
205,36,390,71077,71113,30
185,74,563,70940,71014,30
919,93,600,70977,71070,30
367,132,254,71416,71548,30
142,146,523,71279,71425,30
819,150,895,71053,71203,30
637,155,368,71730,71885,30
721,171,856,71397,71568,30
573,186,960,71464,71650,30
278,195,529,72081,72276,30
631,210,894,71911,72121,30
962,249,278,72737,72986,30
148,251,112,73152,73403,30
184,265,124,73391,73656,30
8286,8,9614,800031,800039,30
5635,9,8249,801404,801413,30
1903,10,8760,800902,800912,30
1328,10,9527,800145,800155,30
4619,12,8780,800902,800914,30
6578,17,9222,800472,800489,30
9505,19,8166,801545,801564,30
5373,20,8599,801131,801151,30
3088,20,9503,800247,800267,30
2851,20,9628,800142,800162,30
6048,21,9222,800568,800589,30
6961,22,9287,800524,800546,30
8907,23,8339,801494,801517,30
3652,23,8676,801180,801203,30
8893,24,8656,801223,801247,30
5384,27,8753,801150,801177,30
9056,27,8984,800946,800973,30
9563,29,8086,801871,801900,30
9105,30,8014,801972,802002,30
6437,30,8414,801602,801632,30
7412,31,8146,801900,801931,30
8757,34,8849,801228,801262,30
2747,35,9565,800546,800581,30
6614,37,8045,802101,802138,30
3166,38,8660,801523,801561,30
9578,40,9923,800298,800338,30
6812,41,9457,800804,800845,30
6238,43,9025,801277,801320,30
8974,47,9018,801327,801374,30
4161,47,9636,800756,800803,30
4485,48,8805,801634,801682,30
8411,50,9204,801283,801333,30
9151,51,8585,801952,802003,30
3521,51,8924,801664,801715,30
5016,52,8870,801769,801821,30
3257,54,8075,802616,802670,30
9033,54,8269,802476,802530,30
9993,57,9240,801559,801616,30
5567,58,8005,802851,802909,30
1615,58,9295,801619,801677,30
9006,59,8898,802074,802133,30
5979,60,9149,801882,801942,30
1269,62,8370,802721,802783,30
5977,63,8287,802866,802929,30
3557,63,8953,802263,802326,30
1343,66,8434,802845,802911,30
4799,67,9957,801388,801455,30
9867,70,9488,801924,801994,30
8061,73,8242,803240,803313,30
4540,79,8792,802763,802842,30
5808,83,8754,802880,802963,30
8396,87,8567,803150,803237,30
2386,87,9361,802443,802530,30
6231,90,8254,803637,803727,30
1528,90,9831,802150,802240,30
9752,91,8961,803110,803201,30
7774,93,9146,803016,803109,30
1898,94,8480,803775,803869,30
9987,94,9372,802977,803071,30
7602,95,8227,804216,804311,30
3311,95,8838,803700,803795,30
5137,97,9797,802836,802933,30
4238,99,9509,803221,803320,30
5922,102,9659,803170,803272,30
4442,103,8505,804426,804529,30
9857,108,9142,803892,804000,30
8504,108,9574,803568,803676,30
9430,108,9921,803329,803437,30
6355,110,9614,803744,803854,30
4924,110,9636,803832,803942,30
1440,113,8575,805003,805116,30
3635,124,9668,804023,804147,30
2513,126,8243,805572,805698,30
2479,126,8280,805661,805787,30
7176,126,9087,804980,805106,30
5725,129,8434,805759,805888,30
9916,129,8818,805504,805633,30
5873,131,9148,805303,805434,30
9910,132,8331,806251,806383,30
7701,132,8355,806359,806491,30
3008,133,9081,805765,805898,30
3887,139,9496,805483,805622,30
1258,140,9049,806069,806209,30
6395,143,9261,805997,806140,30
7822,146,8548,806853,806999,30
1639,147,9128,806419,806566,30
9892,151,8135,807559,807710,30
2870,151,9670,806175,806326,30
3205,151,9855,806141,806292,30
4036,157,8976,807171,807328,30
8242,157,9739,806565,806722,30
8726,158,8436,808025,808183,30
5195,158,8469,808150,808308,30
1642,159,8344,808433,808592,30
6485,161,8000,808936,809097,30
4820,163,9800,807297,807460,30
6409,165,9328,807932,808097,30
1891,167,9742,807683,807850,30
3361,172,9270,808322,808494,30
8031,177,9544,808220,808397,30
7441,177,9932,808009,808186,30
4553,178,8678,809440,809618,30
1633,184,8925,809371,809555,30
3690,185,9896,808584,808769,30
3500,189,9385,809280,809469,30
9147,190,9684,809170,809360,30
1860,191,8601,810443,810634,30
7053,191,8957,810278,810469,30
2514,192,8096,811330,811522,30
5027,192,8659,810959,811151,30
6579,197,9108,810702,810899,30
2901,202,8637,811370,811572,30
5786,202,8999,811210,811412,30
5086,202,9330,811081,811283,30
8439,203,8864,811749,811952,30
5608,204,8873,811943,812147,30
9753,205,9546,811474,811679,30
4079,208,8940,812285,812493,30
4797,215,8103,813330,813545,30
7988,215,8175,813473,813688,30
8806,215,8331,813532,813747,30
6152,215,8595,813483,813698,30
6460,215,9024,813269,813484,30
4632,215,9822,812686,812901,30
6004,216,8748,813975,814191,30
6816,224,9672,813267,813491,30
6158,225,9983,813180,813405,30
3627,226,8147,815241,815467,30
2004,228,8933,814681,814909,30
4247,228,9906,813936,814164,30
8228,230,9515,814555,814785,30
5355,238,8348,815952,816190,30
7831,240,8120,816418,816658,30
4446,243,8036,816742,816985,30
5506,244,9768,815253,815497,30
5997,245,9976,815289,815534,30
2460,249,9085,816425,816674,30
2421,250,8042,817717,817967,30
8243,250,9564,816445,816695,30
1450,251,8345,817914,818165,30
1324,251,9341,817169,817420,30
9412,252,8920,817841,818093,30
1133,253,8501,818512,818765,30
2824,253,8786,818480,818733,30
4465,253,9353,818166,818419,30
4250,253,9944,817828,818081,30
9814,254,8027,819998,820252,30
2867,254,9646,818633,818887,30
8968,256,8963,819570,819826,30
5551,256,9447,819342,819598,30
6154,257,9893,819152,819409,30
5154,258,8345,820957,821215,30
5637,259,8399,821161,821420,30
2213,260,8199,821620,821880,30
3541,260,9516,820563,820823,30
8296,263,8847,821492,821755,30
2236,264,9315,821287,821551,30
1716,266,9761,821105,821371,30
4070,267,8642,822490,822757,30
7310,267,9319,822080,822347,30
7664,268,8101,823565,823833,30
4857,268,9549,822385,822653,30
3093,269,9924,822278,822547,30
1089,272,9903,822568,822840,30
1836,272,9970,822773,823045,30
2355,274,9156,823859,824133,30
9176,276,8237,825052,825328,30
9281,276,8808,824757,825033,30
1675,279,8144,825697,825976,30
7505,279,8355,825765,826044,30
1439,279,8397,826002,826281,30
4678,279,8567,826111,826390,30
4713,279,9141,825816,826095,30
1569,280,8455,826781,827061,30
2183,281,9209,826307,826588,30
8929,282,9027,826770,827052,30
3487,284,8201,827878,828162,30
2228,285,8048,828315,828600,30
1362,286,8666,827982,828268,30
7901,290,9522,827412,827702,30
5877,291,9157,828067,828358,30
1355,293,8738,828777,829070,30
4360,293,8951,828857,829150,30
3983,294,9297,828804,829098,30
5817,297,8721,829674,829971,30
7406,297,8802,829890,830187,30
636,7,522,73258,73265,31
469,41,986,72801,72842,31
470,81,948,72880,72961,31
979,106,465,73444,73550,31
552,133,227,73788,73921,31
706,145,430,73718,73863,31
344,218,168,74125,74343,31
180,280,771,73740,74020,31
423,288,597,74194,74482,31
4411,9,9217,829772,829781,31
2013,11,8975,830023,830034,31
8452,13,8667,830342,830355,31
2945,13,9920,829102,829115,31
5664,16,9667,829368,829384,31
5631,18,8325,830726,830744,31
7440,19,8887,830182,830201,31
2453,19,9131,829957,829976,31
1010,23,9543,829564,829587,31
6332,25,8524,830606,830631,31
9307,25,9903,829252,829277,31
8260,27,8919,830261,830288,31
4094,27,9463,829744,829771,31
9798,29,8461,830773,830802,31
1661,29,9948,829315,829344,31
8230,30,9996,829296,829326,31
3901,32,8878,830444,830476,31
1030,32,9664,829690,829722,31
2846,32,9996,829390,829422,31
3076,33,8760,830658,830691,31
8995,34,9108,830343,830377,31
9826,36,8020,831465,831501,31
5498,36,9883,829638,829674,31
9121,43,8210,831347,831390,31
9988,43,8738,830862,830905,31
4429,46,9781,829862,829908,31
7456,47,8402,831287,831334,31
8900,49,9016,830720,830769,31
5044,53,9910,829875,829928,31
8750,56,8171,831667,831723,31
6371,59,8469,831425,831484,31
7550,61,9482,830471,830532,31
9211,63,9182,830832,830895,31
6075,66,8554,831523,831589,31
8727,76,8166,831977,832053,31
1317,77,8418,831801,831878,31
4945,78,8151,832145,832223,31
3683,78,9398,830976,831054,31
3222,79,8235,832217,832296,31
2609,79,8992,831539,831618,31
3315,81,8708,831902,831983,31
3469,86,8393,832298,832384,31
4265,87,8512,832265,832352,31
8134,89,8949,831915,832004,31
3265,90,9339,831614,831704,31
6063,95,9521,831522,831617,31
3654,99,8707,832431,832530,31
7051,99,8997,832240,832339,31
7929,103,9823,831513,831616,31
2432,104,9766,831673,831777,31
9161,105,8601,832942,833047,31
7011,105,8710,832938,833043,31
5314,106,8335,833418,833524,31
8702,106,9832,832027,832133,31
1582,107,8810,833155,833262,31
7370,114,8213,833859,833973,31
7642,115,8345,833841,833956,31
9101,118,8698,833603,833721,31
8051,118,8761,833658,833776,31
3508,120,8452,834085,834205,31
7172,120,8564,834093,834213,31
2752,120,9728,833049,833169,31
1974,121,9118,833779,833900,31
3322,122,9798,833220,833342,31
7542,123,9706,833434,833557,31
7125,127,8990,834273,834400,31
3473,131,8375,835015,835146,31
5463,132,8881,834640,834772,31
3476,135,9548,834105,834240,31
6296,136,9226,834562,834698,31
6160,136,9719,834205,834341,31
5136,139,8783,835277,835416,31
3946,140,8775,835424,835564,31
7885,142,9503,834836,834978,31
3395,143,8483,835998,836141,31
3314,146,8143,836481,836627,31
6213,147,9261,835509,835656,31
3168,148,9595,835322,835470,31
3256,149,8697,836368,836517,31
9595,149,9841,835373,835522,31
3605,149,9870,835493,835642,31
3127,151,8354,837158,837309,31
7772,151,8566,837097,837248,31
9174,152,9626,836188,836340,31
1625,154,8537,837429,837583,31
8808,155,8127,837993,838148,31
5818,155,8501,837774,837929,31
7605,155,9981,836449,836604,31
7284,156,9344,837241,837397,31
6069,159,9010,837731,837890,31
7935,165,8103,838797,838962,31
6782,168,9884,837181,837349,31
5150,174,8210,839023,839197,31
1402,176,8261,839146,839322,31
4695,180,8408,839175,839355,31
7224,182,9755,838008,838190,31
1704,183,8912,839033,839216,31
1567,185,8579,839549,839734,31
2939,185,9754,838559,838744,31
3418,190,9383,839115,839305,31
4987,191,9327,839361,839552,31
9163,192,8568,840311,840503,31
1367,193,8239,840832,841025,31
2625,193,9070,840194,840387,31
6519,193,9407,840050,840243,31
9550,194,8464,841186,841380,31
4714,195,9923,839921,840116,31
2889,196,8333,841706,841902,31
1643,199,8077,842158,842357,31
5722,202,8119,842315,842517,31
6088,202,8529,842107,842309,31
4026,205,8688,842150,842355,31
8269,207,8012,843031,843238,31
4562,209,9485,841765,841974,31
4444,211,9650,841809,842020,31
1496,214,8253,843417,843631,31
6176,214,8975,842909,843123,31
5420,215,8055,844043,844258,31
4679,215,8268,844045,844260,31
6925,216,9775,842753,842969,31
7002,217,8764,843980,844197,31
6481,218,8454,844507,844725,31
2666,219,8150,845029,845248,31
1322,220,9510,843888,844108,31
6677,227,9895,843723,843950,31
2470,230,9072,844773,845003,31
3319,231,8243,845832,846063,31
8113,231,8422,845884,846115,31
4554,232,8074,846463,846695,31
7611,234,8257,846512,846746,31
3372,237,8599,846404,846641,31
2130,237,8695,846545,846782,31
6882,238,8954,846523,846761,31
5132,241,9461,846254,846495,31
7019,243,8289,847667,847910,31
8273,245,9074,847125,847370,31
2907,246,8847,847597,847843,31
8856,249,9247,847443,847692,31
9588,249,9937,847002,847251,31
9434,250,8015,849173,849423,31
4295,251,9611,847827,848078,31
6920,252,9303,848386,848638,31
2121,253,8331,849610,849863,31
3192,255,9662,848532,848787,31
9020,258,8200,850249,850507,31
1536,260,8533,850174,850434,31
3687,260,8781,850186,850446,31
6445,263,9819,849408,849671,31
9104,264,9885,849605,849869,31
4039,265,8271,851483,851748,31
2045,265,8349,851670,851935,31
1801,265,9649,850635,850900,31
4541,266,8272,852277,852543,31
4057,266,8290,852525,852791,31
9392,268,8101,852980,853248,31
4361,268,9108,852241,852509,31
5273,273,8892,852725,852998,31
8215,276,9253,852637,852913,31
8975,277,9104,853062,853339,31
8829,280,9207,853236,853516,31
4426,281,8517,854206,854487,31
7790,284,8781,854223,854507,31
2255,285,8373,854915,855200,31
3410,286,9724,853849,854135,31
2360,292,9154,854705,854997,31
6621,293,8847,855304,855597,31
6498,294,8389,856055,856349,31
4693,295,9244,855494,855789,31
4233,296,9032,856001,856297,31
2732,296,9519,855810,856106,31
6442,297,8459,857166,857463,31
4867,297,8715,857207,857504,31
1151,297,8944,857275,857572,31
7020,299,8761,857755,858054,31
477,145,56,4481,4626,32
471,1,682,74397,74398,32
757,14,299,74781,74795,32
541,60,288,74806,74866,32
293,63,505,74649,74712,32
900,68,630,74587,74655,32
821,70,724,74561,74631,32
349,72,289,75066,75138,32
971,129,902,74525,74654,32
545,141,377,75179,75320,32
268,156,165,75532,75688,32
394,168,296,75557,75725,32
803,171,684,75337,75508,32
708,172,375,75817,75989,32
561,175,897,75467,75642,32
224,187,682,75857,76044,32
751,196,288,76438,76634,32
861,212,551,76371,76583,32
188,237,397,76737,76974,32
283,265,714,76657,76922,32
201,285,886,76750,77035,32
4425,2,9474,857341,857343,32
6745,4,9669,857148,857152,32
3390,7,8203,858618,858625,32
9960,8,8691,858137,858145,32
7666,9,8417,858419,858428,32
7833,11,9179,857666,857677,32
2029,12,8782,858074,858086,32
1557,14,8706,858162,858176,32
4576,15,8084,858798,858813,32
1587,15,8510,858387,858402,32
2040,24,9631,857281,857305,32
2367,24,9967,856969,856993,32
8641,25,8821,858139,858164,32
6862,27,8025,858960,858987,32
4022,27,9749,857263,857290,32
8905,28,8166,858873,858901,32
3000,31,8815,858252,858283,32
1482,32,8717,858381,858413,32
2629,36,8575,858555,858591,32
3540,39,8666,858500,858539,32
3269,40,9355,857850,857890,32
4547,41,9821,857424,857465,32
1152,42,8871,858415,858457,32
7148,43,9207,858121,858164,32
6130,44,8675,858696,858740,32
6950,45,9525,857890,857935,32
9935,45,9574,857886,857931,32
7237,46,9287,858218,858264,32
3574,52,8460,859091,859143,32
1101,54,9663,857940,857994,32
8803,55,8602,859055,859110,32
1105,56,8848,858864,858920,32
9028,57,9415,858353,858410,32
4493,58,8038,859787,859845,32
8843,58,9682,858201,858259,32
4870,59,8367,859574,859633,32
3932,59,9283,858717,858776,32
4975,64,8921,859138,859202,32
3020,64,9782,858341,858405,32
7631,67,8201,859986,860053,32
2041,67,9250,859004,859071,32
3660,72,8161,860160,860232,32
3827,74,9670,858723,858797,32
3226,75,8081,860386,860461,32
5423,76,8127,860415,860491,32
5917,76,8971,859647,859723,32
4880,76,9481,859213,859289,32
9522,77,8509,860261,860338,32
4944,79,9708,859139,859218,32
2709,81,8103,860823,860904,32
4164,85,8634,860373,860458,32
3443,86,8291,860801,860887,32
5005,87,8902,860276,860363,32
1985,88,9612,859653,859741,32
1741,89,9596,859757,859846,32
1794,91,8291,861151,861242,32
7303,93,9752,859781,859874,32
9821,94,8226,861400,861494,32
8345,98,9763,859957,860055,32
9344,100,9695,860123,860223,32
1226,103,9443,860475,860578,32
9282,105,9098,860923,861028,32
6379,106,9859,860267,860373,32
9914,108,9684,860548,860656,32
4504,109,9216,861124,861233,32
4402,110,9271,861178,861288,32
3444,110,9565,860994,861104,32
5040,111,8615,862054,862165,32
9673,111,9235,861545,861656,32
3270,113,8343,862548,862661,32
9713,113,8376,862628,862741,32
7216,113,9838,861279,861392,32
4262,114,9291,861939,862053,32
5755,114,9652,861692,861806,32
1721,116,9717,861741,861857,32
2131,117,8189,863385,863502,32
7141,123,8906,862785,862908,32
9475,123,9413,862401,862524,32
5575,125,8772,863165,863290,32
9254,126,8510,863552,863678,32
3537,131,8117,864071,864202,32
1421,132,9068,863251,863383,32
9208,135,9037,863414,863549,32
4133,135,9204,863382,863517,32
3891,139,8826,863895,864034,32
2376,139,9046,863814,863953,32
5172,139,9820,863179,863318,32
3437,142,8251,864887,865029,32
1246,148,8772,864508,864656,32
6708,148,9474,863954,864102,32
8178,148,9777,863799,863947,32
4902,154,8481,865243,865397,32
3562,155,8295,865583,865738,32
3323,160,8762,865271,865431,32
8304,161,8167,866026,866187,32
9039,162,9199,865155,865317,32
7782,164,8767,865749,865913,32
7622,165,9934,864746,864911,32
1739,169,8770,866075,866244,32
5438,169,9598,865416,865585,32
9895,170,8015,867168,867338,32
8395,170,8031,867322,867492,32
2841,171,9362,866161,866332,32
2586,172,9091,866603,866775,32
1332,175,9261,866605,866780,32
8566,177,8332,867709,867886,32
9905,178,9129,867089,867267,32
4439,178,9637,866759,866937,32
4273,183,8519,868055,868238,32
6572,185,8394,868363,868548,32
3005,186,9857,867085,867271,32
3096,187,9272,867856,868043,32
3074,189,9946,867369,867558,32
2971,191,9497,868007,868198,32
1851,192,9316,868379,868571,32
8081,194,9208,868679,868873,32
4405,195,9592,868489,868684,32
4937,199,8618,869658,869857,32
5585,199,9893,868582,868781,32
1460,202,8650,870024,870226,32
1155,203,9396,869480,869683,32
6598,206,9200,869879,870085,32
9906,206,9576,869709,869915,32
8553,207,9795,869696,869903,32
2148,210,9182,870516,870726,32
8359,213,8652,871256,871469,32
9571,214,8568,871553,871767,32
2878,215,8012,872323,872538,32
3271,215,9938,870612,870827,32
7476,219,8250,872515,872734,32
2996,219,9529,871455,871674,32
6755,221,9841,871362,871583,32
9689,222,9743,871681,871903,32
9426,223,8217,873429,873652,32
9947,224,9488,872381,872605,32
6767,225,9883,872210,872435,32
1484,227,8780,873538,873765,32
5969,227,9748,872797,873024,32
7324,228,9642,873130,873358,32
2413,228,9855,873145,873373,32
9424,230,8811,874417,874647,32
7834,235,9008,874450,874685,32
5141,236,8015,875678,875914,32
3060,236,8519,875410,875646,32
6376,237,9233,874932,875169,32
8150,239,9311,875091,875330,32
2169,239,9761,874880,875119,32
3342,243,9315,875565,875808,32
1876,245,9217,875906,876151,32
9382,246,8740,876628,876874,32
5974,252,8824,876790,877042,32
6919,254,8143,877723,877977,32
6247,254,9681,876439,876693,32
6314,256,8955,877419,877675,32
3593,260,9132,877498,877758,32
8292,265,9292,877598,877863,32
8902,265,9775,877380,877645,32
9071,265,9845,877575,877840,32
1987,269,9055,878630,878899,32
4059,283,8133,879821,880104,32
1989,283,9393,878844,879127,32
8639,284,8583,879937,880221,32
9321,285,8042,880762,881047,32
1690,286,8406,880683,880969,32
3718,286,8812,880563,880849,32
3303,290,9303,880358,880648,32
9603,291,8357,881594,881885,32
4551,292,9535,880707,880999,32
5006,294,8519,882015,882309,32
6555,294,8830,881998,882292,32
7171,296,9922,881200,881496,32
7032,300,9278,882140,882440,32
688,58,151,77770,77828,33
555,102,624,77355,77457,33
383,149,770,77311,77460,33
234,152,644,77586,77738,33
654,222,951,77431,77653,33
767,291,122,78482,78773,33
722,298,532,78363,78661,33
2281,1,8539,883179,883180,33
5681,3,9538,882181,882184,33
1714,6,8269,883453,883459,33
7193,6,8673,883055,883061,33
5135,7,8581,883153,883160,33
2415,8,9875,881866,881874,33
2167,8,9896,881853,881861,33
4433,9,9223,882534,882543,33
9026,9,9268,882498,882507,33
7035,10,8469,883306,883316,33
3163,10,9610,882175,882185,33
2855,12,9756,882039,882051,33
8703,12,9992,881815,881827,33
8556,13,9047,882772,882785,33
8265,14,9655,882177,882191,33
2203,16,8826,883020,883036,33
1935,17,9831,882031,882048,33
9934,19,8747,883132,883151,33
8591,20,8753,883145,883165,33
6262,20,9097,882821,882841,33
6871,20,9807,882131,882151,33
2550,22,9024,882934,882956,33
4304,22,9323,882657,882679,33
1376,22,9996,882006,882028,33
6484,25,8066,883958,883983,33
7523,26,8357,883692,883718,33
6510,28,8568,883507,883535,33
3161,28,8852,883251,883279,33
6679,28,8886,883245,883273,33
9635,30,8077,884082,884112,33
1589,31,8092,884097,884128,33
9539,31,9318,882902,882933,33
3134,31,9538,882713,882744,33
8983,31,9566,882716,882747,33
5659,31,9645,882668,882699,33
3425,32,8631,883713,883745,33
7202,33,8423,883953,883986,33
1928,36,8810,883599,883635,33
6335,38,8519,883926,883964,33
1888,40,8440,884043,884083,33
3062,42,9373,883150,883192,33
9514,43,8899,883666,883709,33
3422,44,8922,883686,883730,33
5213,45,8683,883969,884014,33
9235,45,9473,883224,883269,33
4333,46,9784,882958,883004,33
9979,47,8211,884577,884624,33
4314,48,9934,882901,882949,33
3208,50,9211,883672,883722,33
3801,54,9352,883581,883635,33
2602,55,8965,884022,884077,33
3706,59,8499,884543,884602,33
3392,77,9338,883763,883840,33
1114,78,9822,883356,883434,33
8247,82,8471,884785,884867,33
3645,82,8766,884572,884654,33
6829,82,9168,884252,884334,33
9419,83,8053,885449,885532,33
3139,87,8917,884668,884755,33
6206,87,9051,884621,884708,33
4180,89,9568,884191,884280,33
2090,90,9888,883960,884050,33
1185,92,9507,884431,884523,33
8878,93,8659,885371,885464,33
7143,93,9487,884636,884729,33
5159,94,8510,885706,885800,33
1796,94,8535,885775,885869,33
5900,99,9091,885313,885412,33
1397,102,8598,885905,886007,33
9547,102,9480,885125,885227,33
3277,104,9088,885619,885723,33
7318,106,8579,886232,886338,33
4805,106,9664,885253,885359,33
2107,109,8698,886325,886434,33
5301,110,9314,885818,885928,33
5515,111,9171,886071,886182,33
2206,112,8470,886883,886995,33
1354,112,9728,885737,885849,33
7484,112,9841,885736,885848,33
4455,117,9876,885813,885930,33
1766,122,8243,887563,887685,33
4548,122,8546,887382,887504,33
9262,122,9250,886800,886922,33
7376,123,8634,887538,887661,33
4264,123,9757,886538,886661,33
8926,123,9846,886572,886695,33
7296,126,8842,887699,887825,33
4029,129,9791,886876,887005,33
8701,135,8579,888217,888352,33
5125,137,9316,887615,887752,33
6100,138,8555,888513,888651,33
2364,142,9879,887327,887469,33
6110,143,8517,888831,888974,33
8585,143,8599,888892,889035,33
2830,143,9378,888256,888399,33
5764,145,9599,888178,888323,33
9388,150,9107,888815,888965,33
8039,152,9543,888529,888681,33
3367,158,9559,888665,888823,33
5473,159,8213,890169,890328,33
6878,159,8829,889712,889871,33
1657,160,8464,890236,890396,33
8793,160,9777,889083,889243,33
6858,161,9145,889875,890036,33
6899,161,9280,889901,890062,33
3393,162,8377,890965,891127,33
5727,163,8226,891278,891441,33
7786,163,8522,891145,891308,33
6935,164,8953,890877,891041,33
9800,164,9935,890059,890223,33
5646,166,8134,892024,892190,33
2794,166,9104,891220,891386,33
4223,167,8437,892053,892220,33
4845,167,9610,891047,891214,33
9008,172,9381,891443,891615,33
3849,173,8458,892538,892711,33
2706,173,9501,891668,891841,33
5672,175,9469,891873,892048,33
9788,176,8029,893488,893664,33
9069,176,9307,892386,892562,33
3953,176,9478,892391,892567,33
8361,177,9916,892129,892306,33
9881,179,9130,893092,893271,33
5657,179,9934,892467,892646,33
3070,186,8035,894545,894731,33
6346,189,9180,893586,893775,33
9476,194,9963,892992,893186,33
3620,195,9194,893955,894150,33
1141,195,9912,893432,893627,33
1870,199,8583,894956,895155,33
7258,201,9125,894613,894814,33
1370,201,9221,894718,894919,33
5800,204,8712,895428,895632,33
1955,206,9751,894593,894799,33
1765,207,9106,895444,895651,33
3940,208,8825,895932,896140,33
3297,210,8631,896334,896544,33
9333,213,8508,896667,896880,33
2795,219,8223,897165,897384,33
2636,221,8015,897592,897813,33
9230,221,8060,897768,897989,33
8743,225,9398,896651,896876,33
8257,228,8600,897674,897902,33
4977,231,8949,897553,897784,33
5440,237,8656,898077,898314,33
6249,237,8716,898254,898491,33
6329,237,8806,898401,898638,33
7690,239,8354,899090,899329,33
7040,239,9438,898245,898484,33
9570,240,8005,899917,900157,33
7700,240,8508,899654,899894,33
8161,242,8818,899584,899826,33
3144,244,8999,899645,899889,33
5994,244,9566,899322,899566,33
6350,247,8610,900522,900769,33
3285,248,9135,900244,900492,33
1757,250,9510,900117,900367,33
5527,251,8026,901851,902102,33
8716,255,9280,900848,901103,33
3046,257,8530,901853,902110,33
7232,257,8628,902012,902269,33
4023,257,8792,902105,902362,33
4463,265,9372,901782,902047,33
6989,270,9757,901662,901932,33
9113,271,9159,902530,902801,33
8513,273,8459,903501,903774,33
8226,273,9932,902301,902574,33
4365,274,8275,904231,904505,33
8628,276,9658,903122,903398,33
6890,278,8607,904449,904727,33
3346,280,8048,905286,905566,33
6908,282,8504,905110,905392,33
3611,282,9487,904409,904691,33
8606,283,8981,905197,905480,33
1341,285,8796,905665,905950,33
8065,294,9408,905338,905632,33
1149,295,9877,905163,905458,33
4241,297,8377,906958,907255,33
5734,300,8739,906893,907193,33
648,49,382,78811,78860,34
953,61,666,78576,78637,34
272,66,394,78909,78975,34
837,78,406,78963,79041,34
650,96,707,78740,78836,34
607,127,362,79181,79308,34
786,137,170,79500,79637,34
213,152,174,79633,79785,34
799,174,957,79002,79176,34
282,185,957,79176,79361,34
956,215,490,79828,80043,34
364,277,691,79842,80119,34
139,297,706,80104,80401,34
2991,1,8433,907499,907500,34
9312,2,9601,906332,906334,34
4097,3,8254,907681,907684,34
4297,3,9319,906619,906622,34
4546,4,8879,907062,907066,34
7497,8,8935,907010,907018,34
7887,10,8739,907214,907224,34
8019,12,8186,907777,907789,34
9568,12,8752,907223,907235,34
1092,17,8124,907863,907880,34
9782,19,8213,907791,907810,34
4748,19,8293,907730,907749,34
3957,21,8140,907902,907923,34
2569,23,9374,906689,906712,34
7604,25,8802,907284,907309,34
2012,25,9679,906432,906457,34
2392,26,9075,907061,907087,34
4072,29,8876,907286,907315,34
2495,30,8887,907304,907334,34
3435,31,8621,907600,907631,34
3215,32,8838,907414,907446,34
4681,33,9379,906905,906938,34
1452,37,8905,907412,907449,34
9085,37,9528,906826,906863,34
2949,38,9639,906752,906790,34
3625,38,9793,906636,906674,34
8762,39,8072,908395,908434,34
3287,39,8908,907598,907637,34
4530,42,8040,908505,908547,34
1950,42,8513,908074,908116,34
8015,44,8335,908294,908338,34
6883,47,8361,908312,908359,34
4014,49,8411,908309,908358,34
5522,50,9862,906907,906957,34
2594,53,9048,907771,907824,34
7270,54,9219,907653,907707,34
6668,54,9844,907082,907136,34
7467,55,8081,908899,908954,34
4115,56,9325,907710,907766,34
6914,60,9189,907902,907962,34
1108,62,8663,908488,908550,34
8908,62,9347,907866,907928,34
8018,65,8710,908565,908630,34
6973,65,9014,908326,908391,34
9485,65,9171,908234,908299,34
8514,68,8428,909042,909110,34
7898,68,9846,907692,907760,34
5741,71,8248,909358,909429,34
8915,72,9198,908479,908551,34
9465,73,9387,908362,908435,34
1735,78,8251,909571,909649,34
9723,78,9497,908403,908481,34
4009,79,8888,909090,909169,34
2119,80,8367,909690,909770,34
6103,81,8660,909477,909558,34
5298,81,9022,909196,909277,34
2336,81,9191,909108,909189,34
3240,82,9076,909304,909386,34
6174,84,8028,910434,910518,34
2553,84,8239,910307,910391,34
8836,84,9309,909321,909405,34
3439,86,9058,909656,909742,34
7208,91,9072,909728,909819,34
8212,91,9426,909465,909556,34
3428,93,8168,910814,910907,34
7359,94,8011,911064,911158,34
3023,94,8539,910630,910724,34
5914,98,8249,911014,911112,34
8969,98,8816,910545,910643,34
7297,98,9036,910423,910521,34
9090,103,8344,911213,911316,34
1475,106,8839,910821,910927,34
1846,107,9392,910374,910481,34
5735,112,8460,911413,911525,34
9815,112,8709,911276,911388,34
8608,113,9821,910276,910389,34
6682,116,8807,911403,911519,34
1432,117,8164,912162,912279,34
9955,120,8855,911588,911708,34
1491,123,9596,910967,911090,34
6805,125,8051,912635,912760,34
1847,125,9600,911211,911336,34
6517,126,9906,911030,911156,34
7262,128,8135,912927,913055,34
6711,128,9494,911696,911824,34
1131,128,9970,911348,911476,34
3988,134,8557,912889,913023,34
7784,135,9044,912536,912671,34
2117,138,8318,913397,913535,34
8052,138,9452,912401,912539,34
6419,142,9952,912039,912181,34
5499,144,9161,912972,913116,34
2617,145,9005,913272,913417,34
1902,149,8239,914183,914332,34
8865,150,8545,914026,914176,34
6910,155,9058,913663,913818,34
5158,156,8054,914822,914978,34
3590,157,9234,913798,913955,34
3836,160,8441,914748,914908,34
9574,161,8568,914781,914942,34
8955,162,9365,914145,914307,34
3691,165,8684,914988,915153,34
1532,167,8862,914975,915142,34
8493,167,9237,914767,914934,34
4900,170,8443,915728,915898,34
3036,174,8964,915377,915551,34
9399,175,8106,916409,916584,34
2640,175,8372,916318,916493,34
2020,177,8475,916390,916567,34
6863,178,9443,915599,915777,34
7908,179,9446,915774,915953,34
4412,182,8799,916600,916782,34
6393,182,9517,916064,916246,34
8977,183,9505,916258,916441,34
2211,185,9326,916620,916805,34
3903,186,8112,918019,918205,34
1262,186,9241,917076,917262,34
3740,186,9328,917175,917361,34
4505,189,8744,917945,918134,34
9883,190,8131,918747,918937,34
4257,193,8477,918591,918784,34
9435,195,8810,918451,918646,34
1579,196,9751,917705,917901,34
1268,197,8756,918896,919093,34
7630,197,9945,917904,918101,34
2890,198,9936,918110,918308,34
3185,200,9459,918785,918985,34
6385,201,9204,919240,919441,34
6453,203,8972,919673,919876,34
4100,207,8487,920361,920568,34
8954,207,8792,920263,920470,34
1975,211,8413,920849,921060,34
6776,215,8245,921228,921443,34
2681,218,9182,920506,920724,34
3871,219,8511,921395,921614,34
6991,221,8152,921973,922194,34
5250,221,9733,920613,920834,34
6613,222,9387,921180,921402,34
4416,222,9639,921150,921372,34
1467,223,9636,921375,921598,34
5955,226,9177,922057,922283,34
3075,226,9460,922000,922226,34
8776,227,8124,923562,923789,34
4122,227,9009,922904,923131,34
6448,227,9544,922596,922823,34
9952,228,8408,923959,924187,34
4490,231,8755,923840,924071,34
9144,232,8293,924533,924765,34
7498,238,8487,924571,924809,34
8405,239,8338,924958,925197,34
2475,239,9834,923701,923940,34
5863,242,8085,925689,925931,34
5071,243,8259,925757,926000,34
7189,246,8878,925381,925627,34
3984,246,8917,925588,925834,34
5456,247,8432,926319,926566,34
9245,248,9209,925789,926037,34
2199,249,9309,925937,926186,34
1033,251,9035,926460,926711,34
6718,252,8505,927241,927493,34
9674,258,8305,927693,927951,34
6607,261,9930,926326,926587,34
3552,262,9608,926909,927171,34
1366,263,8508,928271,928534,34
8992,265,9711,927331,927596,34
1125,266,9166,928141,928407,34
1445,266,9254,928319,928585,34
8644,266,9380,928459,928725,34
2738,267,8071,930034,930301,34
8614,269,8415,929957,930226,34
8351,270,9657,928984,929254,34
6996,271,9403,929508,929779,34
2474,275,8474,930708,930983,34
5369,275,8854,930603,930878,34
7890,275,9705,930027,930302,34
2634,275,9850,930157,930432,34
3457,275,9922,930360,930635,34
6491,276,8036,932521,932797,34
5993,277,8138,932695,932972,34
8880,277,8643,932467,932744,34
1843,280,9109,932278,932558,34
8239,280,9784,931883,932163,34
9572,282,9616,932331,932613,34
2106,283,9173,933056,933339,34
8087,283,9338,933174,933457,34
7785,285,9392,933403,933688,34
8719,286,9483,933597,933883,34
6933,288,8040,935326,935614,34
4534,290,9182,934472,934762,34
8888,293,9295,934649,934942,34
5345,294,9505,934732,935026,34
2456,297,8216,936315,936612,34
2215,297,9249,935579,935876,34
4709,300,8771,936354,936654,34
551,6,560,80547,80553,35
669,27,801,80312,80339,35
533,45,331,80809,80854,35
628,67,353,80832,80899,35
159,89,985,80267,80356,35
789,93,495,80846,80939,35
644,111,478,80956,81067,35
734,126,416,81129,81255,35
634,135,164,81507,81642,35
215,151,106,81700,81851,35
497,153,438,81519,81672,35
223,165,350,81760,81925,35
829,187,987,81288,81475,35
702,207,752,81710,81917,35
600,237,900,81769,82006,35
140,242,750,82156,82398,35
412,243,969,82179,82422,35
771,257,326,83065,83322,35
529,267,455,83193,83460,35
200,295,133,83782,84077,35
1609,2,8328,937097,937099,35
7994,2,9282,936145,936147,35
8833,2,9565,935864,935866,35
7405,5,8566,936865,936870,35
2067,5,8574,936862,936867,35
3558,5,9839,935602,935607,35
5927,6,8244,937202,937208,35
1036,11,9345,936107,936118,35
9460,15,9994,935469,935484,35
3128,16,9426,936052,936068,35
5036,17,8705,936789,936806,35
9746,18,8081,937430,937448,35
6836,25,8446,937083,937108,35
7976,26,8524,937030,937056,35
5870,31,9195,936385,936416,35
8891,32,9264,936347,936379,35
6474,37,8704,936939,936976,35
3968,38,8646,937034,937072,35
9463,38,9109,936609,936647,35
2827,42,9958,935798,935840,35
8188,45,8478,937320,937365,35
4044,47,9713,936130,936177,35
3722,48,9573,936317,936365,35
3915,52,8633,937305,937357,35
6283,52,9348,936642,936694,35
9395,54,9815,936227,936281,35
9099,58,8606,937490,937548,35
7009,59,9710,936444,936503,35
3308,64,9262,936951,937015,35
2657,65,9964,936313,936378,35
6298,66,9125,937217,937283,35
6979,66,9813,936595,936661,35
5686,68,9775,936699,936767,35
7343,70,8803,937739,937809,35
2194,71,8866,937746,937817,35
1545,76,9245,937438,937514,35
2833,90,8173,938586,938676,35
4020,90,8870,937979,938069,35
1595,91,8366,938573,938664,35
3793,91,8910,938120,938211,35
6867,94,8652,938469,938563,35
3274,94,9423,937792,937886,35
1968,97,9420,937889,937986,35
2025,99,8456,938950,939049,35
4476,101,8202,939303,939404,35
8213,108,8667,938939,939047,35
9335,109,9766,937948,938057,35
7704,110,9322,938501,938611,35
3317,114,8595,939338,939452,35
2037,116,8217,939830,939946,35
8729,118,8691,939472,939590,35
10000,118,9752,938529,938647,35
6826,120,9690,938709,938829,35
2420,122,9993,938526,938648,35
5936,123,9254,939387,939510,35
2486,127,8637,940127,940254,35
4172,130,8815,940076,940206,35
7369,131,9830,939191,939322,35
1245,133,9322,939830,939963,35
4570,135,8252,941033,941168,35
2859,135,9892,939528,939663,35
3797,137,8459,941096,941233,35
3413,137,8807,940885,941022,35
5169,137,9325,940504,940641,35
9375,139,9088,940878,941017,35
7557,140,8657,941448,941588,35
6060,140,9432,940813,940953,35
4312,142,9748,940637,940779,35
8695,146,9803,940724,940870,35
2986,149,8589,942084,942233,35
9030,149,9702,941120,941269,35
9758,150,9147,941824,941974,35
4728,151,8993,942128,942279,35
8997,152,8728,942544,942696,35
6227,156,8533,942891,943047,35
6195,160,9666,941914,942074,35
3776,164,8542,943198,943362,35
1106,171,9311,942593,942764,35
2318,174,9474,942601,942775,35
6714,176,9289,942960,943136,35
9153,177,8073,944352,944529,35
3916,178,9210,943392,943570,35
8993,180,8821,943959,944139,35
9994,180,8913,944047,944227,35
4374,181,9452,943688,943869,35
1334,186,8000,945321,945507,35
3442,186,9252,944255,944441,35
3086,186,9471,944222,944408,35
6377,186,9543,944336,944522,35
7968,187,8614,945451,945638,35
1980,193,9138,945114,945307,35
4170,198,8406,946039,946237,35
1001,204,9682,944961,945165,35
3733,205,9946,944901,945106,35
6940,206,9531,945521,945727,35
4078,210,9501,945757,945967,35
7442,211,9282,946186,946397,35
6986,211,9531,946148,946359,35
4643,211,9604,946286,946497,35
4388,213,8564,947537,947750,35
4851,214,8273,948041,948255,35
7457,214,9247,947281,947495,35
6406,216,8110,948632,948848,35
9251,216,8934,948024,948240,35
9050,216,9040,948134,948350,35
3516,222,9404,947986,948208,35
4240,223,8953,948659,948882,35
7607,223,9072,948763,948986,35
6622,224,9094,948964,949188,35
7134,224,9683,948599,948823,35
9922,225,9739,948767,948992,35
7922,227,9194,949537,949764,35
8182,229,8500,950458,950687,35
2598,230,8750,950437,950667,35
9969,232,9521,949896,950128,35
2087,233,9350,950299,950532,35
5810,234,9356,950526,950760,35
7004,235,8042,952074,952309,35
4231,235,8565,951786,952021,35
5825,236,8705,951881,952117,35
5811,238,9382,951440,951678,35
9608,239,9089,951971,952210,35
7281,239,9753,951546,951785,35
3350,241,9373,952165,952406,35
6375,242,8957,952822,953064,35
5221,244,8695,953326,953570,35
9310,245,8497,953768,954013,35
2591,248,9415,953095,953343,35
1995,249,8605,954153,954402,35
4279,249,9151,953856,954105,35
8667,251,8212,955044,955295,35
3951,252,9318,954189,954441,35
7838,254,9766,953993,954247,35
5000,255,9720,954293,954548,35
6884,259,8014,956254,956513,35
5408,259,8183,956344,956603,35
6294,261,8060,956726,956987,35
3029,261,8530,956517,956778,35
1273,263,9409,955899,956162,35
1832,264,9417,956154,956418,35
3624,265,8906,956929,957194,35
7116,266,9660,956440,956706,35
7226,267,8488,957878,958145,35
2516,267,9517,957116,957383,35
6797,267,9931,956969,957236,35
9936,271,8784,958383,958654,35
4392,271,9025,958413,958684,35
1448,273,9578,958131,958404,35
2204,274,8670,959312,959586,35
2158,275,9883,958373,958648,35
9134,277,8936,959595,959872,35
4347,278,8997,959811,960089,35
5530,283,8880,960206,960489,35
7808,283,8944,960425,960708,35
2917,285,8078,961574,961859,35
4468,285,8228,961709,961994,35
9619,289,8501,961721,962010,35
1619,289,8769,961742,962031,35
5090,289,8846,961954,962243,35
7800,290,8210,962879,963169,35
5983,291,8550,962829,963120,35
6828,291,9568,962102,962393,35
8124,292,9280,962681,962973,35
1967,293,9849,962404,962697,35
4580,294,9640,962906,963200,35
1025,296,8369,964471,964767,35
7953,298,8340,964796,965094,35
8447,298,8628,964806,965104,35
5558,298,8664,965068,965366,35
9201,298,9277,964753,965051,35
8252,298,9768,964560,964858,35
9972,300,8625,966001,966301,35
442,48,56,4626,4674,36
539,107,67,4663,4770,36
290,57,888,83322,83379,36
849,116,88,84179,84295,36
478,157,601,83782,83939,36
305,160,251,84289,84449,36
870,170,361,84339,84509,36
646,185,715,84155,84340,36
652,194,647,84408,84602,36
241,211,687,84562,84773,36
733,215,606,84854,85069,36
514,253,206,85469,85722,36
653,277,679,85249,85526,36
565,292,618,85587,85879,36
4413,6,9496,965430,965436,36
3122,10,8172,966760,966770,36
7191,17,9884,965058,965075,36
3414,19,8789,966170,966189,36
6644,21,8047,966931,966952,36
8144,21,8772,966227,966248,36
6589,22,8306,966714,966736,36
6722,24,8655,966387,966411,36
9533,29,9919,965147,965176,36
7299,30,8096,966999,967029,36
3135,34,9523,965602,965636,36
7601,35,8824,966335,966370,36
2380,37,8987,966207,966244,36
1021,37,9905,965326,965363,36
4593,38,8511,966757,966795,36
1048,39,8539,966767,966806,36
4472,40,9163,966182,966222,36
6781,41,9397,965988,966029,36
7829,42,8266,967160,967202,36
5987,43,9010,966458,966501,36
1840,44,8734,966777,966821,36
7234,44,9627,965928,965972,36
8574,45,9509,966090,966135,36
2872,45,9788,965856,965901,36
9080,50,9682,966007,966057,36
6208,50,9821,965918,965968,36
7907,51,9502,966287,966338,36
5280,52,8660,967180,967232,36
3078,55,9604,966288,966343,36
4272,56,9583,966364,966420,36
8637,59,9292,966711,966770,36
7577,61,8644,967418,967479,36
5089,62,9498,966625,966687,36
3214,65,8304,967881,967946,36
1348,65,9152,967098,967163,36
1929,66,9368,966947,967013,36
3741,67,8314,968067,968134,36
1588,69,8609,967839,967908,36
5760,69,8769,967748,967817,36
5238,71,9494,967092,967163,36
9748,77,8391,968266,968343,36
7687,81,9908,966826,966907,36
8146,84,8791,968024,968108,36
6021,85,9930,966969,967054,36
5925,87,9945,967039,967126,36
7926,92,9757,967314,967406,36
3356,94,8569,968594,968688,36
2412,95,9441,967816,967911,36
2581,96,8829,968523,968619,36
4717,98,9517,967931,968029,36
7616,99,9999,967547,967646,36
7433,103,9915,967730,967833,36
3276,104,9539,968209,968313,36
1349,106,8771,969081,969187,36
3507,109,9283,968675,968784,36
8797,112,9215,968852,968964,36
9937,115,8792,969387,969502,36
6888,115,9248,969046,969161,36
1585,116,8052,970357,970473,36
5701,116,9617,968908,969024,36
2978,117,8135,970506,970623,36
9484,117,8544,970214,970331,36
9657,118,8482,970393,970511,36
5746,119,8446,970547,970666,36
9671,121,9790,969322,969443,36
5181,123,9616,969617,969740,36
6026,123,9725,969631,969754,36
3853,126,8717,970762,970888,36
6597,128,8023,971582,971710,36
9290,128,8519,971214,971342,36
9456,131,8271,971590,971721,36
4008,134,8098,971894,972028,36
4397,136,8892,971234,971370,36
5831,136,9986,970276,970412,36
9865,137,9865,970533,970670,36
5897,138,8366,972169,972307,36
4839,138,8809,971864,972002,36
6000,138,9454,971357,971495,36
5580,139,8634,972315,972454,36
4810,139,8738,972350,972489,36
2648,141,8612,972615,972756,36
4635,143,9564,971804,971947,36
5406,144,8510,973001,973145,36
7317,148,8222,973433,973581,36
3840,152,9632,972171,972323,36
6218,154,8326,973629,973783,36
2322,158,8995,973114,973272,36
6566,158,9821,972446,972604,36
6773,160,8452,973973,974133,36
5075,160,8563,974022,974182,36
6875,161,8897,973848,974009,36
3573,161,9213,973693,973854,36
2713,166,9253,973814,973980,36
9702,166,9876,973357,973523,36
8343,168,9394,974005,974173,36
7855,169,8028,975539,975708,36
7033,169,8661,975075,975244,36
2425,170,9468,974437,974607,36
5017,171,9405,974670,974841,36
1709,174,8011,976235,976409,36
7122,175,8745,975675,975850,36
6999,176,8031,976564,976740,36
7066,176,9893,974878,975054,36
7355,177,9157,975790,975967,36
9286,178,9536,975588,975766,36
6253,179,8809,976493,976672,36
6800,181,9266,976215,976396,36
3772,185,8625,977037,977222,36
2263,186,8353,977494,977680,36
9989,186,9687,976346,976532,36
8820,189,9202,977017,977206,36
9108,189,9787,976621,976810,36
3814,191,9871,976726,976917,36
8053,192,8849,977939,978131,36
2118,197,8681,978299,978496,36
1336,199,8874,978303,978502,36
8857,199,9791,977585,977784,36
5265,202,8913,978662,978864,36
1932,202,9488,978289,978491,36
7752,202,9672,978307,978509,36
3312,206,8067,980114,980320,36
7241,207,8347,980040,980247,36
8825,208,9924,978670,978878,36
9543,209,8500,980302,980511,36
6240,210,8058,980953,981163,36
2819,210,9847,979374,979584,36
4520,212,8422,981009,981221,36
6788,212,9266,980377,980589,36
8868,213,8606,981249,981462,36
3224,215,8514,981554,981769,36
4121,215,9290,980993,981208,36
9604,216,8710,981788,982004,36
8101,218,9490,981224,981442,36
9792,218,9986,980946,981164,36
2603,219,8534,982616,982835,36
9756,220,9157,982212,982432,36
8631,222,8180,983409,983631,36
4030,222,9930,981881,982103,36
8685,223,8737,983296,983519,36
3398,224,9399,982857,983081,36
7332,224,9647,982833,983057,36
4622,226,9139,983565,983791,36
9198,227,8391,984539,984766,36
3348,228,9297,983860,984088,36
3396,230,8617,984768,984998,36
9453,230,9541,984074,984304,36
6083,230,9867,983978,984208,36
8449,232,8587,985488,985720,36
7300,233,8182,986125,986358,36
5596,236,9397,985143,985379,36
4120,239,9985,984791,985030,36
1844,240,8274,986741,986981,36
4329,241,8669,986586,986827,36
3862,241,9258,986238,986479,36
3488,242,8906,986831,987073,36
8278,243,8672,987307,987550,36
7378,243,8846,987376,987619,36
6594,244,9205,987260,987504,36
9791,245,8116,988593,988838,36
2433,245,8498,988456,988701,36
8681,246,9993,987206,987452,36
6228,248,8013,989432,989680,36
9454,248,8023,989670,989918,36
9352,249,9083,988858,989107,36
8428,250,8312,989878,990128,36
4318,250,8972,989468,989718,36
4542,250,9658,989032,989282,36
2313,252,9122,989818,990070,36
5954,255,8047,991145,991400,36
8270,256,9540,989907,990163,36
2751,257,9531,990172,990429,36
3404,259,8309,991651,991910,36
4443,259,8453,991766,992025,36
7584,260,9358,991120,991380,36
3063,262,8669,992069,992331,36
1817,264,9368,991632,991896,36
5252,266,9734,991530,991796,36
8654,268,8258,993272,993540,36
1802,272,8040,993758,994030,36
9760,275,8608,993462,993737,36
4885,275,9459,992886,993161,36
5541,277,9663,992957,993234,36
9332,278,8996,993901,994179,36
4452,278,9907,993268,993546,36
1577,280,8174,995279,995559,36
5697,281,8992,994741,995022,36
5926,286,8069,995945,996231,36
2059,287,8524,995776,996063,36
2461,288,9525,995062,995350,36
8507,290,9641,995234,995524,36
3545,292,8567,996598,996890,36
3146,293,8219,997238,997531,36
1134,293,9008,996742,997035,36
7294,294,8434,997609,997903,36
3934,295,9411,996926,997221,36
5781,296,9301,997331,997627,36
6547,298,8137,998791,999089,36
1783,300,8143,999083,999383,36
857,10,53,4784,4794,37
577,110,70,4777,4887,37
749,10,336,86161,86171,37
647,73,369,86138,86211,37
309,80,759,85821,85901,37
774,91,507,86153,86244,37
485,117,656,86095,86212,37
874,130,871,85997,86127,37
216,193,797,86201,86394,37
772,200,477,86714,86914,37
296,207,756,86635,86842,37
202,222,888,86710,86932,37
639,258,234,87586,87844,37
3520,3,8787,998739,998742,37
9408,4,9541,997988,997992,37
5105,5,9112,998421,998426,37
7854,6,8808,998730,998736,37
8620,6,9221,998323,998329,37
8472,10,8147,999403,999413,37
2282,10,9118,998442,998452,37
6492,19,8186,999384,999403,37
3534,19,8835,998754,998773,37
1079,27,8269,999339,999366,37
5598,28,8464,999171,999199,37
2170,29,8212,999451,999480,37
9736,29,8941,998751,998780,37
9734,29,9537,998184,998213,37
2403,31,9024,998726,998757,37
1300,32,8230,999551,999583,37
7292,35,8504,999309,999344,37
4608,37,9744,998104,998141,37
7628,38,8229,999656,999694,37
3492,38,9572,998351,998389,37
2103,39,8125,999836,999875,37
9041,40,9162,998838,998878,37
8782,43,8662,999378,999421,37
4276,46,9987,998096,998142,37
9965,48,9247,998882,998930,37
6684,49,9569,998608,998657,37
4178,51,8001,1000225,1000276,37
3766,53,8292,999985,1000038,37
6175,57,8802,999528,999585,37
1060,61,9630,998757,998818,37
6363,62,9480,998968,999030,37
1487,67,8028,1000482,1000549,37
8805,67,9038,999539,999606,37
2266,68,9296,999348,999416,37
7894,70,8628,1000084,1000154,37
7896,71,8204,1000578,1000649,37
9991,71,9438,999415,999486,37
5193,72,8594,1000330,1000402,37
7959,73,8458,1000538,1000611,37
5627,76,9593,999476,999552,37
4597,78,8149,1000996,1001074,37
1081,80,8796,1000427,1000507,37
6804,81,9173,1000130,1000211,37
1707,81,9996,999388,999469,37
1493,82,8918,1000547,1000629,37
9349,84,8012,1001535,1001619,37
6855,85,8350,1001281,1001366,37
7764,88,9126,1000590,1000678,37
9789,93,9109,1000695,1000788,37
6983,93,9829,1000068,1000161,37
9364,94,9981,1000009,1000103,37
3041,95,8295,1001789,1001884,37
9602,98,8662,1001517,1001615,37
6970,99,9645,1000632,1000731,37
6865,100,9745,1000631,1000731,37
5198,104,9758,1000718,1000822,37
9999,104,9994,1000586,1000690,37
3225,105,8093,1002591,1002696,37
7490,106,8091,1002698,1002804,37
7754,106,9628,1001267,1001373,37
8714,108,8022,1002979,1003087,37
1039,112,8959,1002150,1002262,37
2559,113,8338,1002883,1002996,37
9640,113,9033,1002301,1002414,37
7000,114,9465,1001982,1002096,37
6138,116,8464,1003097,1003213,37
1534,118,8407,1003270,1003388,37
8413,118,8676,1003119,1003237,37
3441,119,9611,1002302,1002421,37
2998,122,9113,1002919,1003041,37
7740,125,8578,1003576,1003701,37
9820,126,8132,1004147,1004273,37
1907,126,8895,1003510,1003636,37
1826,129,8536,1003995,1004124,37
9491,129,9925,1002735,1002864,37
4817,133,9276,1003513,1003646,37
5064,134,8797,1004125,1004259,37
6769,137,8845,1004211,1004348,37
5652,140,9598,1003595,1003735,37
7152,142,8364,1004969,1005111,37
6464,143,8434,1005041,1005184,37
2601,144,8112,1005506,1005650,37
7802,145,9348,1004414,1004559,37
6560,146,9083,1004824,1004970,37
2777,147,8068,1005985,1006132,37
2197,151,9990,1004210,1004361,37
6963,159,8748,1005603,1005762,37
7787,159,9657,1004853,1005012,37
9396,164,9444,1005225,1005389,37
5595,170,9692,1005141,1005311,37
7060,171,8203,1006800,1006971,37
3698,174,8206,1006968,1007142,37
4614,179,8968,1006380,1006559,37
1430,182,9142,1006385,1006567,37
6932,182,9665,1006044,1006226,37
8999,183,8818,1007073,1007256,37
8174,183,9785,1006289,1006472,37
1015,185,8960,1007297,1007482,37
8520,187,8602,1007840,1008027,37
5798,188,9508,1007121,1007309,37
4217,190,9762,1007055,1007245,37
5002,192,9008,1007999,1008191,37
3591,195,8223,1008976,1009171,37
6710,197,8655,1008739,1008936,37
2129,197,8714,1008877,1009074,37
8005,197,8983,1008805,1009002,37
9652,198,8811,1009174,1009372,37
7290,198,9304,1008879,1009077,37
2673,200,8273,1010108,1010308,37
9524,200,9683,1008898,1009098,37
1524,201,9341,1009440,1009641,37
3668,203,8863,1010119,1010322,37
1818,204,9556,1009629,1009833,37
1374,204,9714,1009675,1009879,37
6995,205,9208,1010385,1010590,37
4737,208,8958,1010840,1011048,37
4941,209,9706,1010300,1010509,37
6132,209,9884,1010331,1010540,37
9159,211,9505,1010919,1011130,37
2652,213,9307,1011328,1011541,37
8398,219,9394,1011454,1011673,37
6532,220,8669,1012398,1012618,37
3972,222,8852,1012435,1012657,37
9187,223,8140,1013369,1013592,37
6749,223,9807,1011925,1012148,37
3466,224,8737,1013218,1013442,37
7087,225,9992,1012187,1012412,37
6861,227,8244,1014160,1014387,37
5948,227,8321,1014310,1014537,37
4615,227,8330,1014528,1014755,37
2642,229,9400,1013685,1013914,37
3811,230,8752,1014562,1014792,37
4035,232,8698,1014846,1015078,37
5254,235,8410,1015366,1015601,37
3378,238,8704,1015307,1015545,37
4340,241,8043,1016206,1016447,37
1276,244,9039,1015451,1015695,37
6171,247,8946,1015788,1016035,37
7697,247,9413,1015568,1015815,37
9075,248,8325,1016903,1017151,37
1966,252,9378,1016098,1016350,37
5410,254,8007,1017721,1017975,37
3898,255,8634,1017348,1017603,37
5120,255,9638,1016599,1016854,37
5975,256,8535,1017957,1018213,37
6322,256,8719,1018029,1018285,37
1722,256,9454,1017550,1017806,37
7633,256,9886,1017374,1017630,37
6926,257,8039,1019477,1019734,37
3234,259,8465,1019308,1019567,37
1729,263,8741,1019291,1019554,37
4266,266,8419,1019876,1020142,37
8205,268,8180,1020381,1020649,37
9228,272,8510,1020319,1020591,37
8261,273,8626,1020475,1020748,37
2973,276,9801,1019573,1019849,37
3763,277,9233,1020417,1020694,37
6770,278,8235,1021692,1021970,37
5460,278,9651,1020554,1020832,37
2697,279,8206,1022277,1022556,37
1084,281,9046,1021716,1021997,37
2082,281,9875,1021168,1021449,37
4599,284,9708,1021616,1021900,37
1998,287,8654,1022954,1023241,37
7264,293,8258,1023637,1023930,37
9567,293,9989,1022199,1022492,37
6721,295,8832,1023649,1023944,37
2036,296,8196,1024580,1024876,37
9768,297,8854,1024218,1024515,37
7818,297,9972,1023397,1023694,37
5297,299,9165,1024501,1024800,37
543,18,763,87315,87333,38
227,21,606,87490,87511,38
431,53,442,87675,87728,38
677,127,359,87811,87938,38
817,133,277,88020,88153,38
776,133,863,87567,87700,38
532,135,568,87995,88130,38
718,146,254,88444,88590,38
109,146,410,88434,88580,38
439,179,195,88795,88974,38
432,192,804,88365,88557,38
354,219,514,88847,89066,38
263,233,845,88735,88968,38
475,271,382,89431,89702,38
667,282,267,89817,90099,38
549,294,989,89377,89671,38
847,300,744,89916,90216,38
4189,1,9663,1024302,1024303,38
3518,2,8892,1025074,1025076,38
8935,3,8215,1025753,1025756,38
5336,3,9375,1024596,1024599,38
6159,8,8353,1025621,1025629,38
8047,9,8848,1025134,1025143,38
6820,9,9723,1024268,1024277,38
9007,11,9447,1024553,1024564,38
8934,14,8761,1025250,1025264,38
9062,15,8419,1025606,1025621,38
6824,20,8667,1025373,1025393,38
8104,22,9997,1024063,1024085,38
7471,26,8475,1025607,1025633,38
4873,27,9544,1024564,1024591,38
9738,28,9186,1024949,1024977,38
3365,29,9865,1024298,1024327,38
9509,31,9524,1024668,1024699,38
3808,32,9966,1024257,1024289,38
8220,33,9055,1025200,1025233,38
1767,34,8046,1026242,1026276,38
1082,38,8363,1025959,1025997,38
5461,41,9356,1025004,1025045,38
3501,44,8647,1025754,1025798,38
5933,49,9287,1025158,1025207,38
3688,49,9826,1024668,1024717,38
6420,52,8223,1026320,1026372,38
4002,53,9494,1025101,1025154,38
4832,54,8225,1026423,1026477,38
1345,54,9161,1025541,1025595,38
9455,60,9506,1025250,1025310,38
6209,62,8928,1025888,1025950,38
8583,65,8639,1026239,1026304,38
5690,72,9011,1025932,1026004,38
1660,74,9768,1025247,1025321,38
1864,74,9997,1025092,1025166,38
5245,75,8672,1026491,1026566,38
5217,75,9140,1026098,1026173,38
9818,76,9289,1026024,1026100,38
4706,76,9967,1025422,1025498,38
4067,77,8571,1026894,1026971,38
9641,81,8085,1027457,1027538,38
6783,81,8098,1027525,1027606,38
7350,84,8385,1027319,1027403,38
3176,84,9129,1026659,1026743,38
5409,86,8304,1027568,1027654,38
5246,86,8420,1027538,1027624,38
5417,87,8390,1027654,1027741,38
5949,87,9840,1026291,1026378,38
1173,88,8707,1027511,1027599,38
4967,89,9379,1026927,1027016,38
3725,90,8786,1027609,1027699,38
5700,93,9576,1026909,1027002,38
2651,95,8492,1028086,1028181,38
9361,98,9607,1027066,1027164,38
6551,101,9081,1027690,1027791,38
2051,102,8698,1028174,1028276,38
9341,102,8758,1028216,1028318,38
5101,102,9232,1027844,1027946,38
7170,103,9206,1027972,1028075,38
7110,104,9399,1027882,1027986,38
4406,107,9196,1028189,1028296,38
5937,109,8692,1028800,1028909,38
8899,109,9630,1027971,1028080,38
7095,111,8590,1029120,1029231,38
8928,111,8838,1028983,1029094,38
9047,112,8600,1029332,1029444,38
4973,115,9986,1028058,1028173,38
6681,116,9093,1029066,1029182,38
1916,118,9102,1029173,1029291,38
2187,123,9117,1029276,1029399,38
2484,124,8574,1029942,1030066,38
7714,126,8489,1030151,1030277,38
1372,136,8759,1030007,1030143,38
3467,137,8756,1030146,1030283,38
9835,143,8677,1030362,1030505,38
8946,143,9277,1029905,1030048,38
2600,143,9643,1029682,1029825,38
1764,144,8318,1031150,1031294,38
7107,145,8546,1031066,1031211,38
3577,146,8246,1031511,1031657,38
8040,150,9593,1030310,1030460,38
1147,152,8394,1031659,1031811,38
3090,152,9038,1031167,1031319,38
2156,153,9390,1030967,1031120,38
6258,153,9513,1030997,1031150,38
5356,154,8831,1031832,1031986,38
7728,154,9372,1031445,1031599,38
4652,157,8428,1032543,1032700,38
5837,157,8593,1032535,1032692,38
2000,159,8081,1033204,1033363,38
7108,160,8876,1032568,1032728,38
9074,163,8136,1033468,1033631,38
3072,163,9187,1032580,1032743,38
4174,164,8013,1033917,1034081,38
5501,166,8316,1033778,1033944,38
5626,167,8303,1033957,1034124,38
9783,168,8944,1033483,1033651,38
7381,169,9959,1032636,1032805,38
9628,171,8300,1034464,1034635,38
9637,171,8799,1034136,1034307,38
5451,172,8299,1034807,1034979,38
2254,173,8637,1034641,1034814,38
6306,175,9493,1033958,1034133,38
6010,178,8141,1035485,1035663,38
5251,183,8182,1035622,1035805,38
5812,183,9178,1034809,1034992,38
8026,187,8899,1035271,1035458,38
6025,191,9988,1034369,1034560,38
5553,192,9179,1035369,1035561,38
1672,192,9686,1035054,1035246,38
1265,192,9752,1035180,1035372,38
6676,194,8391,1036733,1036927,38
3783,194,9523,1035795,1035989,38
7080,197,9038,1036474,1036671,38
9688,201,8452,1037257,1037458,38
9958,201,8667,1037243,1037444,38
3243,203,8331,1037780,1037983,38
8070,207,9403,1036911,1037118,38
5371,207,9492,1037029,1037236,38
2618,211,8517,1038211,1038422,38
4403,214,9455,1037484,1037698,38
4889,216,9844,1037309,1037525,38
1305,218,8971,1038398,1038616,38
1728,218,9180,1038407,1038625,38
4182,219,8038,1039767,1039986,38
9164,221,9459,1038565,1038786,38
2993,222,8448,1039797,1040019,38
3821,223,9175,1039292,1039515,38
6439,223,9628,1039062,1039285,38
6064,225,8148,1040765,1040990,38
1038,227,9686,1039452,1039679,38
1651,228,9541,1039824,1040052,38
3338,229,8815,1040778,1041007,38
8175,229,9113,1040709,1040938,38
7424,230,9394,1040657,1040887,38
8158,232,8244,1042037,1042269,38
6653,232,8470,1042043,1042275,38
4482,235,8002,1042743,1042978,38
8128,235,9003,1041977,1042212,38
2457,240,9531,1041684,1041924,38
6199,241,8082,1043373,1043614,38
4715,245,8622,1043074,1043319,38
2921,246,8834,1043107,1043353,38
6400,247,8814,1043373,1043620,38
6049,248,9099,1043335,1043583,38
4761,249,9922,1042760,1043009,38
4749,252,9016,1043915,1044167,38
9645,254,9161,1044022,1044276,38
4127,256,9474,1043963,1044219,38
8697,257,8652,1045041,1045298,38
3936,258,9404,1044546,1044804,38
3859,260,9452,1044756,1045016,38
9494,261,9693,1044775,1045036,38
2692,262,9135,1045594,1045856,38
9459,265,9888,1045103,1045368,38
3196,267,8767,1046489,1046756,38
1249,268,9400,1046123,1046391,38
3010,268,9971,1045820,1046088,38
3790,270,8106,1047953,1048223,38
4852,270,8493,1047836,1048106,38
2711,270,9920,1046679,1046949,38
4557,271,9591,1047278,1047549,38
6728,272,9226,1047914,1048186,38
9920,274,9592,1047820,1048094,38
2200,276,8382,1049304,1049580,38
4907,277,8416,1049546,1049823,38
2022,277,9854,1048385,1048662,38
6573,279,8776,1049740,1050019,38
3711,280,8482,1050313,1050593,38
2885,280,9043,1050032,1050312,38
8225,281,9013,1050342,1050623,38
1910,282,9290,1050346,1050628,38
9355,283,9150,1050768,1051051,38
2021,284,8084,1052117,1052401,38
9842,286,9908,1050577,1050863,38
2034,288,8343,1052428,1052716,38
4136,290,8295,1052764,1053054,38
2881,290,9005,1052344,1052634,38
6647,294,8733,1052906,1053200,38
8728,295,8488,1053445,1053740,38
8402,295,9518,1052710,1053005,38
7999,296,8520,1054003,1054299,38
8624,296,8959,1053860,1054156,38
7064,298,8203,1054912,1055210,38
217,13,71,4886,4899,39
809,132,60,4910,5042,39
352,5,767,90193,90198,39
966,19,999,89966,89985,39
168,26,408,90576,90602,39
251,31,580,90430,90461,39
501,39,400,90641,90680,39
723,58,518,90562,90620,39
199,95,248,90890,90985,39
238,107,206,91027,91134,39
240,155,966,90374,90529,39
150,184,362,91133,91317,39
981,193,870,90809,91002,39
276,205,82,91790,91995,39
810,215,839,91238,91453,39
430,215,894,91398,91613,39
341,216,852,91655,91871,39
931,225,716,92007,92232,39
763,240,420,92528,92768,39
433,255,847,92341,92596,39
569,261,865,92578,92839,39
5425,2,8233,1055180,1055182,39
3895,2,8970,1054445,1054447,39
3181,4,9778,1053639,1053643,39
9457,5,8479,1054942,1054947,39
7699,7,9852,1053574,1053581,39
8948,9,9763,1053670,1053679,39
9145,13,8830,1054612,1054625,39
3002,14,8736,1054719,1054733,39
1315,15,9020,1054449,1054464,39
4682,17,8086,1055398,1055415,39
6686,18,8905,1054596,1054614,39
1393,18,9895,1053624,1053642,39
5510,23,8097,1055440,1055463,39
6265,23,9211,1054349,1054372,39
4450,27,9272,1054311,1054338,39
6116,29,9797,1053813,1053842,39
4007,30,8754,1054885,1054915,39
7717,30,9004,1054665,1054695,39
6717,32,8837,1054862,1054894,39
9518,35,8408,1055323,1055358,39
3893,35,9914,1053852,1053887,39
1303,45,8363,1055438,1055483,39
4705,47,9119,1054727,1054774,39
9971,48,8907,1054986,1055034,39
5256,49,9169,1054772,1054821,39
9206,49,9714,1054276,1054325,39
6288,53,8857,1055182,1055235,39
2423,56,8707,1055385,1055441,39
7644,56,8832,1055316,1055372,39
1535,57,8356,1055848,1055905,39
8827,58,8604,1055657,1055715,39
6574,60,8629,1055690,1055750,39
1157,64,9159,1055220,1055284,39
9859,66,9586,1054857,1054923,39
7563,70,9074,1055435,1055505,39
8646,70,9553,1055026,1055096,39
9770,72,9522,1055127,1055199,39
9646,73,8688,1056033,1056106,39
9017,73,9774,1055020,1055093,39
4343,74,9044,1055823,1055897,39
1494,75,8281,1056660,1056735,39
5794,76,8856,1056160,1056236,39
7073,78,8865,1056227,1056305,39
8536,78,9185,1055985,1056063,39
5067,79,9196,1056052,1056131,39
5269,84,8154,1057173,1057257,39
3148,84,8244,1057167,1057251,39
5991,85,8096,1057399,1057484,39
3647,87,8899,1056681,1056768,39
8499,87,9838,1055829,1055916,39
2190,89,8680,1057074,1057163,39
8752,89,8940,1056903,1056992,39
7729,91,9125,1056807,1056898,39
9540,91,9557,1056466,1056557,39
8733,94,9666,1056448,1056542,39
8393,97,8181,1058027,1058124,39
4466,97,8871,1057434,1057531,39
7250,99,8531,1057871,1057970,39
3854,99,9938,1056563,1056662,39
3969,100,9689,1056911,1057011,39
5731,100,9783,1056917,1057017,39
6224,101,9905,1056895,1056996,39
8587,104,8502,1058399,1058503,39
7396,104,9091,1057914,1058018,39
4033,104,9662,1057447,1057551,39
6948,106,8770,1058443,1058549,39
3828,110,9619,1057700,1057810,39
5353,114,8484,1058945,1059059,39
7058,114,8762,1058781,1058895,39
1023,115,9596,1058061,1058176,39
7307,118,8216,1059556,1059674,39
7971,118,8953,1058937,1059055,39
9797,118,9938,1058070,1058188,39
6403,119,9012,1059114,1059233,39
6267,119,9338,1058907,1059026,39
5747,120,8538,1059826,1059946,39
8427,120,9435,1059049,1059169,39
9238,121,9616,1058988,1059109,39
9483,121,9993,1058732,1058853,39
8523,122,9504,1059342,1059464,39
2893,122,9565,1059403,1059525,39
6581,126,8223,1060867,1060993,39
2079,129,8555,1060661,1060790,39
2154,129,8900,1060445,1060574,39
4642,131,9243,1060231,1060362,39
5783,133,9086,1060519,1060652,39
1069,135,9959,1059779,1059914,39
7444,136,9575,1060298,1060434,39
5634,142,9788,1060221,1060363,39
4284,143,9317,1060834,1060977,39
9961,145,8450,1061844,1061989,39
8753,146,8817,1061622,1061768,39
1386,151,8984,1061601,1061752,39
7432,151,9707,1061029,1061180,39
2980,152,9438,1061449,1061601,39
6389,153,8525,1062514,1062667,39
3407,155,9059,1062133,1062288,39
8284,159,9550,1061797,1061956,39
1011,161,8822,1062684,1062845,39
6237,162,9015,1062652,1062814,39
6674,168,8507,1063322,1063490,39
4187,168,8715,1063282,1063450,39
3386,168,9584,1062581,1062749,39
4874,171,8394,1063939,1064110,39
5908,171,9066,1063438,1063609,39
3228,171,9649,1063026,1063197,39
2607,172,8116,1064730,1064902,39
3579,173,9069,1063949,1064122,39
4381,173,9584,1063607,1063780,39
3775,176,9811,1063553,1063729,39
1344,177,8423,1065117,1065294,39
5915,177,8656,1065061,1065238,39
3217,178,9311,1064583,1064761,39
3022,181,9444,1064628,1064809,39
4103,183,9738,1064515,1064698,39
5556,185,8825,1065611,1065796,39
1706,187,8112,1066509,1066696,39
3180,187,9303,1065505,1065692,39
6129,189,9611,1065384,1065573,39
6104,196,9507,1065677,1065873,39
6736,199,8730,1066650,1066849,39
1024,199,9827,1065752,1065951,39
8258,201,9981,1065797,1065998,39
8460,206,8336,1067643,1067849,39
6915,206,9888,1066297,1066503,39
7256,207,9866,1066525,1066732,39
1976,208,9552,1067046,1067254,39
4831,210,9291,1067515,1067725,39
7345,211,9109,1067907,1068118,39
2092,212,9257,1067970,1068182,39
5110,212,9869,1067570,1067782,39
6066,225,9620,1068031,1068256,39
8788,225,9657,1068219,1068444,39
1527,226,9887,1068214,1068440,39
3405,227,8727,1069600,1069827,39
9334,233,8932,1069622,1069855,39
7255,236,8488,1070299,1070535,39
2919,238,9408,1069615,1069853,39
7230,239,8925,1070336,1070575,39
2705,240,9222,1070278,1070518,39
2291,250,9274,1070466,1070716,39
7325,256,9772,1070218,1070474,39
9237,257,9597,1070649,1070906,39
4721,258,9892,1070611,1070869,39
2370,259,8152,1072609,1072868,39
9368,259,8624,1072396,1072655,39
2239,260,8823,1072456,1072716,39
7635,266,9636,1071903,1072169,39
4611,268,9008,1072797,1073065,39
5894,268,9622,1072451,1072719,39
8732,269,8031,1074310,1074579,39
5864,269,8406,1074204,1074473,39
5402,271,8888,1073991,1074262,39
1831,272,9186,1073964,1074236,39
2214,273,8878,1074544,1074817,39
1983,273,8887,1074808,1075081,39
5215,274,9298,1074670,1074944,39
4803,278,9882,1074360,1074638,39
1274,280,9307,1075213,1075493,39
8370,281,8204,1076596,1076877,39
9359,281,9240,1075841,1076122,39
7156,283,9578,1075784,1076067,39
3037,285,9019,1076626,1076911,39
1318,287,8636,1077294,1077581,39
8009,287,9543,1076674,1076961,39
7393,287,9727,1076777,1077064,39
3769,288,8618,1078173,1078461,39
4210,288,9043,1078036,1078324,39
5404,288,9693,1077674,1077962,39
5433,288,9894,1077761,1078049,39
8990,292,8182,1079761,1080053,39
2454,292,9265,1078970,1079262,39
9996,292,9561,1078966,1079258,39
3697,293,9535,1079284,1079577,39
6965,294,8819,1080293,1080587,39
2212,299,8251,1081155,1081454,39
6096,299,9395,1080310,1080609,39
183,37,67,5035,5072,40
192,12,619,93085,93097,40
620,32,409,93307,93339,40
902,45,301,93447,93492,40
538,71,609,93184,93255,40
924,77,857,93007,93084,40
405,105,994,92947,93052,40
748,114,812,93234,93348,40
833,124,209,93951,94075,40
670,143,577,93707,93850,40
908,150,221,94206,94356,40
792,166,478,94099,94265,40
528,172,649,94094,94266,40
889,181,149,94766,94947,40
995,245,525,94571,94816,40
252,254,203,95138,95392,40
887,261,249,95346,95607,40
5520,3,9923,1080081,1080084,40
2372,9,9281,1080726,1080735,40
8824,12,8087,1081929,1081941,40
7776,12,8185,1081843,1081855,40
1364,12,9466,1080574,1080586,40
2216,13,9269,1080783,1080796,40
3762,17,8151,1081914,1081931,40
3905,17,8426,1081656,1081673,40
5902,17,8563,1081536,1081553,40
6984,17,8684,1081432,1081449,40
5571,19,8011,1082122,1082141,40
6795,19,8192,1081960,1081979,40
5906,21,8920,1081251,1081272,40
1504,25,8937,1081255,1081280,40
9643,25,9201,1081016,1081041,40
3695,29,9888,1080354,1080383,40
4064,29,9937,1080334,1080363,40
3805,37,9904,1080396,1080433,40
1405,38,9339,1080998,1081036,40
6014,38,9864,1080511,1080549,40
3098,39,8369,1082044,1082083,40
5400,39,9052,1081400,1081439,40
4447,39,9575,1080916,1080955,40
4806,40,9096,1081434,1081474,40
2988,40,9190,1081380,1081420,40
2674,41,9483,1081127,1081168,40
7380,42,9776,1080875,1080917,40
5072,44,9377,1081316,1081360,40
5295,45,8920,1081817,1081862,40
3106,46,8523,1082259,1082305,40
1238,51,8392,1082436,1082487,40
9277,52,8208,1082671,1082723,40
7200,53,8864,1082067,1082120,40
9212,59,8034,1082950,1083009,40
2334,59,8039,1083004,1083063,40
3229,59,9768,1081334,1081393,40
3087,60,9772,1081389,1081449,40
7653,61,8354,1082867,1082928,40
3464,62,8089,1083193,1083255,40
4294,63,8627,1082717,1082780,40
5606,63,9824,1081583,1081646,40
4183,64,8472,1082998,1083062,40
6200,66,9739,1081795,1081861,40
1653,67,9400,1082200,1082267,40
5847,69,8491,1083176,1083245,40
2838,70,9694,1082042,1082112,40
7461,71,9187,1082619,1082690,40
6310,72,8290,1083587,1083659,40
8244,78,8301,1083648,1083726,40
8102,79,8052,1083975,1084054,40
8090,80,9347,1082759,1082839,40
9357,81,9353,1082833,1082914,40
1178,83,9381,1082886,1082969,40
7937,83,9800,1082550,1082633,40
8940,84,8929,1083504,1083588,40
9064,88,8012,1084505,1084593,40
9973,88,9342,1083263,1083351,40
7707,93,8483,1084210,1084303,40
9303,93,8813,1083973,1084066,40
1067,94,8356,1084523,1084617,40
3536,97,8107,1084866,1084963,40
7660,99,8634,1084436,1084535,40
4984,100,8270,1084899,1084999,40
8375,100,8567,1084702,1084802,40
6157,100,8838,1084531,1084631,40
9227,107,8573,1084896,1085003,40
5349,107,9293,1084283,1084390,40
5804,111,9350,1084333,1084444,40
8720,114,9136,1084658,1084772,40
5963,115,9640,1084268,1084383,40
6575,118,9886,1084137,1084255,40
1199,121,8257,1085884,1086005,40
1934,121,8980,1085282,1085403,40
5555,122,8195,1086188,1086310,40
3798,125,9002,1085503,1085628,40
9923,127,9556,1085074,1085201,40
9701,130,8177,1086580,1086710,40
8786,132,8295,1086592,1086724,40
2312,133,9358,1085661,1085794,40
4605,134,8003,1087149,1087283,40
7793,135,9290,1085996,1086131,40
5789,135,9805,1085616,1085751,40
3120,136,9074,1086482,1086618,40
3283,136,9448,1086244,1086380,40
8148,137,8076,1087752,1087889,40
8996,142,8087,1087878,1088020,40
6527,143,8004,1088103,1088246,40
6027,147,8779,1087471,1087618,40
4625,151,9407,1086990,1087141,40
6852,152,9911,1086637,1086789,40
9634,155,8427,1088273,1088428,40
6842,155,8916,1087939,1088094,40
6356,157,8428,1088582,1088739,40
2809,157,9993,1087174,1087331,40
6815,159,9633,1087691,1087850,40
1419,165,9926,1087557,1087722,40
9471,166,8979,1088669,1088835,40
3535,167,8518,1089296,1089463,40
3982,168,9278,1088703,1088871,40
8675,169,9986,1088163,1088332,40
2498,172,9226,1089092,1089264,40
2478,175,9028,1089462,1089637,40
7554,176,8832,1089833,1090009,40
3800,180,9529,1089312,1089492,40
7267,184,9188,1089833,1090017,40
5525,185,9415,1089790,1089975,40
2088,186,8296,1091094,1091280,40
3364,187,8445,1091131,1091318,40
7682,187,9358,1090405,1090592,40
5047,189,8891,1091059,1091248,40
2007,190,8412,1091727,1091917,40
3064,190,8874,1091455,1091645,40
9941,193,8585,1091934,1092127,40
7034,197,8001,1092711,1092908,40
5938,198,8031,1092878,1093076,40
6632,198,8929,1092178,1092376,40
7703,198,9074,1092231,1092429,40
4582,199,8834,1092669,1092868,40
1638,201,9641,1092061,1092262,40
7115,205,8688,1093215,1093420,40
8611,207,8414,1093694,1093901,40
6317,208,8143,1094172,1094380,40
9452,208,9393,1093130,1093338,40
1539,209,8693,1094038,1094247,40
5643,210,8187,1094753,1094963,40
5792,210,8546,1094604,1094814,40
4496,211,9928,1093432,1093643,40
4960,216,8199,1095372,1095588,40
9366,217,9676,1094111,1094328,40
5920,217,9877,1094127,1094344,40
2274,218,8468,1095753,1095971,40
4081,224,9711,1094728,1094952,40
9718,227,9707,1094956,1095183,40
7503,229,9648,1095242,1095471,40
4750,229,9738,1095381,1095610,40
8717,229,9909,1095439,1095668,40
8313,230,9492,1096085,1096315,40
7924,232,8397,1097410,1097642,40
6424,234,9394,1096645,1096879,40
2849,235,8976,1097297,1097532,40
4655,237,8053,1098455,1098692,40
2205,242,8213,1098532,1098774,40
5615,244,8884,1098103,1098347,40
6719,245,8650,1098581,1098826,40
3175,246,9168,1098308,1098554,40
1415,248,9856,1097866,1098114,40
5537,248,9964,1098006,1098254,40
4117,250,8602,1099616,1099866,40
3263,250,9299,1099169,1099419,40
8987,257,9744,1098974,1099231,40
9779,258,9762,1099213,1099471,40
7638,262,8784,1100449,1100711,40
9887,262,9539,1099956,1100218,40
7268,265,9757,1100000,1100265,40
4966,266,9121,1100901,1101167,40
7279,270,8796,1101492,1101762,40
8657,272,8426,1102132,1102404,40
2997,272,8795,1102035,1102307,40
7775,272,9773,1101329,1101601,40
3928,273,8712,1102662,1102935,40
2962,274,8532,1103115,1103389,40
4199,274,8631,1103290,1103564,40
6046,279,8473,1103722,1104001,40
2468,279,9082,1103392,1103671,40
7612,280,8507,1104246,1104526,40
6569,281,9319,1103714,1103995,40
2180,283,9127,1104187,1104470,40
6344,284,8328,1105269,1105553,40
8960,286,8167,1105714,1106000,40
6198,286,8202,1105965,1106251,40
4484,289,8251,1106202,1106491,40
4918,289,9065,1105677,1105966,40
1418,290,8703,1106328,1106618,40
9325,291,8813,1106508,1106799,40
4379,292,8617,1106995,1107287,40
1007,292,8824,1107080,1107372,40
1666,293,8036,1108160,1108453,40
2614,293,9535,1106954,1107247,40
6595,294,8253,1108529,1108823,40
3578,295,9051,1108025,1108320,40
7383,296,8157,1109214,1109510,40
6421,296,8839,1108828,1109124,40
375,88,58,5081,5169,41
520,2,565,95291,95293,41
408,8,133,95725,95733,41
709,25,891,94975,95000,41
844,38,126,95765,95803,41
679,39,849,95080,95119,41
498,40,571,95397,95437,41
284,63,347,95661,95724,41
154,97,343,95728,95825,41
134,100,299,95869,95969,41
537,103,116,96152,96255,41
739,111,739,95632,95743,41
289,132,949,95533,95665,41
878,134,730,95884,96018,41
952,136,193,96555,96691,41
579,198,492,96392,96590,41
725,216,916,96166,96382,41
622,236,138,97160,97396,41
798,269,88,97446,97715,41
761,270,588,97215,97485,41
312,275,572,97501,97776,41
712,277,87,98261,98538,41
172,281,278,98347,98628,41
818,297,442,98464,98761,41
1923,3,9142,1108821,1108824,41
4290,5,8834,1109132,1109137,41
4098,6,9687,1108284,1108290,41
6085,10,9093,1108884,1108894,41
4321,11,8653,1109334,1109345,41
8473,13,8737,1109261,1109274,41
4400,17,8944,1109067,1109084,41
2726,21,9760,1108268,1108289,41
5028,22,8694,1109355,1109377,41
2362,23,8754,1109317,1109340,41
5972,23,9577,1108517,1108540,41
8263,23,9917,1108200,1108223,41
6969,24,8579,1109561,1109585,41
5437,25,9357,1108807,1108832,41
1904,27,9797,1108392,1108419,41
7409,28,8405,1109811,1109839,41
7459,31,9767,1108477,1108508,41
7904,31,9952,1108323,1108354,41
4162,32,8560,1109746,1109778,41
2135,37,8658,1109680,1109717,41
9901,40,8722,1109653,1109693,41
2219,42,8493,1109922,1109964,41
2033,45,9671,1108786,1108831,41
7781,45,9716,1108786,1108831,41
5031,46,9639,1108908,1108954,41
4239,46,9837,1108756,1108802,41
3999,51,9072,1109567,1109618,41
7214,51,9903,1108787,1108838,41
7301,57,8425,1110316,1110373,41
5563,57,9046,1109752,1109809,41
8986,58,8093,1110762,1110820,41
5113,58,8704,1110209,1110267,41
8861,60,8673,1110298,1110358,41
5867,72,8212,1110819,1110891,41
2030,72,9064,1110039,1110111,41
2389,73,9080,1110095,1110168,41
5921,75,8813,1110435,1110510,41
4533,76,9087,1110236,1110312,41
6367,77,8791,1110608,1110685,41
3268,77,9609,1109867,1109944,41
2520,84,8115,1111438,1111522,41
6163,85,8924,1110713,1110798,41
5647,86,9814,1109908,1109994,41
1533,87,9665,1110143,1110230,41
4702,94,8450,1111445,1111539,41
7118,95,8881,1111108,1111203,41
5357,95,9550,1110534,1110629,41
5988,97,8133,1112046,1112143,41
2050,99,8414,1111862,1111961,41
2676,101,8921,1111454,1111555,41
9519,102,9482,1110994,1111096,41
8380,102,9979,1110599,1110701,41
5045,107,8191,1112489,1112596,41
5843,107,8877,1111910,1112017,41
5903,111,8013,1112881,1112992,41
2577,111,8926,1112079,1112190,41
9466,111,9081,1112035,1112146,41
9178,116,8465,1112762,1112878,41
8066,118,9735,1111608,1111726,41
2585,120,8150,1113311,1113431,41
2715,122,8491,1113090,1113212,41
4048,122,9061,1112642,1112764,41
8154,126,8915,1112910,1113036,41
8312,126,9582,1112369,1112495,41
2631,127,8303,1113774,1113901,41
8274,131,9581,1112623,1112754,41
2363,134,9182,1113153,1113287,41
4814,135,8589,1113880,1114015,41
5243,137,9522,1113082,1113219,41
6568,138,8408,1114333,1114471,41
1028,142,8777,1114102,1114244,41
6840,143,8147,1114874,1115017,41
8417,144,8040,1115124,1115268,41
5744,144,8720,1114588,1114732,41
8197,146,8209,1115243,1115389,41
9560,152,8100,1115498,1115650,41
6759,153,9926,1113824,1113977,41
2086,156,8080,1115823,1115979,41
9636,156,9755,1114304,1114460,41
3759,159,9191,1115024,1115183,41
4401,161,8530,1115844,1116005,41
9119,163,8844,1115691,1115854,41
4848,164,9718,1114980,1115144,41
6112,165,8457,1116405,1116570,41
7816,167,9226,1115801,1115968,41
7792,169,9804,1115390,1115559,41
5982,170,9247,1116116,1116286,41
6266,171,9465,1116068,1116239,41
1468,171,9521,1116183,1116354,41
6943,171,9647,1116228,1116399,41
6147,173,8021,1118025,1118198,41
6561,173,8146,1118073,1118246,41
4938,173,9653,1116739,1116912,41
9172,174,8032,1118533,1118707,41
1135,176,9523,1117216,1117392,41
3754,178,9243,1117672,1117850,41
3335,178,9892,1117201,1117379,41
3604,178,9894,1117377,1117555,41
1942,179,8060,1119389,1119568,41
1635,181,8492,1119136,1119317,41
9813,183,9207,1118602,1118785,41
5787,183,9503,1118489,1118672,41
4299,185,9135,1119040,1119225,41
6727,189,9348,1119012,1119201,41
8647,190,8620,1119929,1120119,41
6552,192,8277,1120462,1120654,41
5899,195,9254,1119677,1119872,41
6998,197,9651,1119475,1119672,41
5592,205,8455,1120868,1121073,41
3899,207,8561,1120967,1121174,41
7194,207,9019,1120716,1120923,41
6833,208,8826,1121116,1121324,41
5058,209,8521,1121629,1121838,41
2237,212,9721,1120638,1120850,41
8209,213,9964,1120607,1120820,41
2712,214,9196,1121588,1121802,41
5946,218,9869,1121129,1121347,41
1090,219,8657,1122559,1122778,41
7028,219,9877,1121558,1121777,41
4244,221,8262,1123392,1123613,41
4464,224,9344,1122531,1122755,41
3774,227,8587,1123512,1123739,41
2279,228,9895,1122431,1122659,41
8602,231,9481,1123073,1123304,41
2923,234,8157,1124628,1124862,41
3986,238,8210,1124809,1125047,41
6352,238,9484,1123773,1124011,41
8502,239,9806,1123689,1123928,41
9221,242,9446,1124288,1124530,41
8653,248,8769,1125207,1125455,41
7985,249,8950,1125274,1125523,41
3852,250,9189,1125284,1125534,41
8240,253,8350,1126373,1126626,41
9876,255,9140,1125836,1126091,41
4762,256,8239,1126992,1127248,41
4965,258,9158,1126329,1126587,41
9446,263,9163,1126582,1126845,41
2864,264,8480,1127528,1127792,41
2693,268,9252,1127020,1127288,41
5751,271,9026,1127514,1127785,41
6029,272,9736,1127075,1127347,41
9717,274,8878,1128205,1128479,41
4315,274,9471,1127886,1128160,41
2352,275,8122,1129509,1129784,41
8708,275,8635,1129271,1129546,41
7092,278,8844,1129337,1129615,41
8356,281,8901,1129558,1129839,41
8147,282,9553,1129187,1129469,41
2267,282,9710,1129312,1129594,41
5881,283,9350,1129954,1130237,41
2225,284,8280,1131307,1131591,41
5589,285,8595,1131276,1131561,41
7458,285,8739,1131417,1131702,41
4782,285,8952,1131489,1131774,41
9767,287,9282,1131444,1131731,41
8095,287,9783,1131230,1131517,41
8002,288,8851,1132449,1132737,41
1401,288,9228,1132360,1132648,41
4259,291,8393,1133483,1133774,41
2294,293,9138,1133029,1133322,41
6090,297,9531,1132929,1133226,41
8596,299,8057,1134700,1134999,41
5294,300,8365,1134691,1134991,41
319,1,429,98774,98775,42
266,6,943,98261,98267,42
550,46,810,98400,98446,42
770,51,718,98538,98589,42
508,72,722,98585,98657,42
421,80,265,99114,99194,42
326,88,917,98542,98630,42
909,94,631,98916,99010,42
950,95,223,99418,99513,42
925,100,545,99191,99291,42
834,104,973,98863,98967,42
125,113,924,99016,99129,42
936,116,574,99479,99595,42
629,132,135,100034,100166,42
676,147,677,99624,99771,42
415,157,871,99577,99734,42
191,169,870,99735,99904,42
993,181,623,100151,100332,42
546,183,133,100822,101005,42
481,201,863,100275,100476,42
938,203,857,100482,100685,42
736,206,804,100738,100944,42
756,225,556,101192,101417,42
464,235,941,101032,101267,42
813,242,569,101639,101881,42
945,249,813,101637,101886,42
503,258,721,101978,102236,42
929,263,569,102388,102651,42
531,266,960,102260,102526,42
934,280,317,103169,103449,42
322,295,420,103346,103641,42
2142,1,9717,1133639,1133640,42
2186,1,9825,1133532,1133533,42
8938,4,8189,1135169,1135173,42
2416,4,8452,1134910,1134914,42
3114,4,9684,1133682,1133686,42
8334,7,8421,1134949,1134956,42
3281,8,9339,1134038,1134046,42
2647,8,9436,1133949,1133957,42
9871,9,8583,1134810,1134819,42
8897,9,9460,1133942,1133951,42
3380,12,8680,1134731,1134743,42
6181,14,8954,1134469,1134483,42
5630,17,9197,1134240,1134257,42
9681,26,9039,1134415,1134441,42
9474,30,8163,1135317,1135347,42
6480,31,8887,1134623,1134654,42
7779,31,8926,1134615,1134646,42
7439,32,8676,1134896,1134928,42
9210,32,8942,1134662,1134694,42
9054,33,9400,1134236,1134269,42
7947,35,9694,1133975,1134010,42
7911,36,8624,1135080,1135116,42
3047,36,9741,1133999,1134035,42
9084,37,8448,1135328,1135365,42
9493,37,9176,1134637,1134674,42
2350,38,8398,1135452,1135490,42
2290,44,8447,1135441,1135485,42
1059,45,8523,1135409,1135454,42
1436,46,8810,1135167,1135213,42
8931,48,9773,1134250,1134298,42
8590,49,8368,1135703,1135752,42
4130,54,9155,1134965,1135019,42
7796,55,9294,1134880,1134935,42
1339,56,8100,1136129,1136185,42
5180,57,8451,1135834,1135891,42
7718,57,9888,1134454,1134511,42
2763,59,9134,1135265,1135324,42
7817,60,9403,1135055,1135115,42
9127,62,9783,1134735,1134797,42
7129,63,8589,1135991,1136054,42
3137,63,9231,1135412,1135475,42
4663,65,8574,1136132,1136197,42
2626,65,8973,1135798,1135863,42
9264,65,9377,1135459,1135524,42
5161,66,8094,1136807,1136873,42
2742,69,8306,1136661,1136730,42
8664,69,9878,1135158,1135227,42
7650,70,9698,1135407,1135477,42
3408,71,8020,1137155,1137226,42
1752,71,8766,1136480,1136551,42
9902,71,9356,1135961,1136032,42
5998,71,9930,1135458,1135529,42
5338,72,8467,1136992,1137064,42
6902,72,9480,1136051,1136123,42
2576,74,8410,1137193,1137267,42
4653,75,8512,1137165,1137240,42
3746,80,8358,1137394,1137474,42
7708,80,9107,1136725,1136805,42
9258,80,9495,1136417,1136497,42
6141,83,8190,1137802,1137885,42
5698,84,9824,1136251,1136335,42
5108,86,8046,1138113,1138199,42
8463,86,8714,1137531,1137617,42
4142,86,9923,1136408,1136494,42
8909,87,9668,1136749,1136836,42
4790,89,9589,1136915,1137004,42
2582,90,9666,1136927,1137017,42
1960,91,8893,1137790,1137881,42
5114,93,8357,1138417,1138510,42
4696,94,8767,1138100,1138194,42
7531,95,8004,1138957,1139052,42
9188,98,8215,1138841,1138939,42
8001,98,9688,1137466,1137564,42
1074,100,8963,1138289,1138389,42
4341,100,9614,1137738,1137838,42
7427,101,9665,1137787,1137888,42
9709,102,9472,1138081,1138183,42
8533,105,9517,1138138,1138243,42
2397,109,8021,1139739,1139848,42
9774,109,9880,1137989,1138098,42
9552,111,9380,1138598,1138709,42
4436,111,9901,1138188,1138299,42
7475,127,8183,1140017,1140144,42
8067,127,8819,1139508,1139635,42
3902,127,8916,1139538,1139665,42
1596,130,8944,1139637,1139767,42
3942,132,9318,1139393,1139525,42
7130,134,9809,1139034,1139168,42
1988,135,8213,1140764,1140899,42
3948,135,9699,1139413,1139548,42
6456,136,8355,1140892,1141028,42
9898,139,9061,1140322,1140461,42
8721,143,8320,1141202,1141345,42
2861,143,9210,1140455,1140598,42
6939,148,9954,1139854,1140002,42
9087,151,8302,1141654,1141805,42
3743,154,9138,1140969,1141123,42
7089,154,9171,1141090,1141244,42
2899,154,9350,1141065,1141219,42
9138,158,8182,1142387,1142545,42
3778,160,8412,1142315,1142475,42
7939,163,8463,1142424,1142587,42
2787,166,8169,1142881,1143047,42
3097,166,9862,1141354,1141520,42
7288,167,9999,1141383,1141550,42
6518,169,8807,1142742,1142911,42
1285,169,9967,1141751,1141920,42
7977,171,8802,1143085,1143256,42
8761,172,8782,1143276,1143448,42
8705,172,9102,1143128,1143300,42
7037,172,9579,1142823,1142995,42
5182,174,8017,1144557,1144731,42
3669,174,9379,1143369,1143543,42
5577,176,8689,1144233,1144409,42
5038,176,9109,1143989,1144165,42
8325,177,8568,1144706,1144883,42
4590,178,8293,1145158,1145336,42
5651,178,9245,1144384,1144562,42
9502,179,8168,1145639,1145818,42
7351,182,8188,1145798,1145980,42
9985,182,8535,1145633,1145815,42
6365,182,9055,1145295,1145477,42
5281,184,9964,1144568,1144752,42
8930,185,8709,1146007,1146192,42
3563,186,9100,1145801,1145987,42
6825,187,8459,1146628,1146815,42
3383,188,9832,1145442,1145630,42
7640,189,9557,1145905,1146094,42
1973,192,8682,1146969,1147161,42
7478,195,9214,1146629,1146824,42
6454,198,8211,1147827,1148025,42
6936,200,9432,1146804,1147004,42
4947,202,8848,1147588,1147790,42
6252,203,9868,1146770,1146973,42
9911,204,8393,1148448,1148652,42
1476,204,9675,1147370,1147574,42
8064,205,9593,1147656,1147861,42
6309,206,8854,1148600,1148806,42
4634,206,9136,1148524,1148730,42
8346,207,8650,1149216,1149423,42
8229,208,8018,1150055,1150263,42
9582,211,8775,1149506,1149717,42
3058,213,9934,1148558,1148771,42
7715,216,9056,1149649,1149865,42
5346,217,8325,1150596,1150813,42
2995,217,9678,1149460,1149677,42
1356,217,9829,1149526,1149743,42
4563,218,9522,1150050,1150268,42
9316,219,9497,1150293,1150512,42
7867,221,8784,1151225,1151446,42
4166,221,9714,1150516,1150737,42
7750,221,9734,1150717,1150938,42
9854,222,9351,1151321,1151543,42
9203,224,8195,1152699,1152923,42
5024,224,9817,1151301,1151525,42
8171,225,9106,1152236,1152461,42
5714,226,9455,1152112,1152338,42
8332,227,8376,1153417,1153644,42
1046,228,9278,1152742,1152970,42
9931,231,8123,1154125,1154356,42
8544,231,9774,1152705,1152936,42
5149,231,9983,1152727,1152958,42
6756,234,9426,1153515,1153749,42
7738,234,9675,1153500,1153734,42
6520,235,8219,1155190,1155425,42
8840,235,8936,1154708,1154943,42
1314,236,9009,1154870,1155106,42
7188,240,9902,1154213,1154453,42
7627,248,8761,1155594,1155842,42
5569,251,8083,1156520,1156771,42
4422,252,9734,1155120,1155372,42
2948,256,8884,1156222,1156478,42
6550,257,8671,1156691,1156948,42
8945,257,8923,1156696,1156953,42
7758,257,9652,1156224,1156481,42
5389,264,9764,1156369,1156633,42
6764,266,9813,1156584,1156850,42
4510,268,8438,1158225,1158493,42
6707,268,9361,1157570,1157838,42
9291,271,9141,1158058,1158329,42
8038,282,9865,1157605,1157887,42
2209,283,8265,1159487,1159770,42
1191,285,9155,1158880,1159165,42
6108,287,9457,1158863,1159150,42
8249,293,8990,1159617,1159910,42
3379,294,9224,1159676,1159970,42
1584,294,9519,1159675,1159969,42
3150,295,8947,1160541,1160836,42
6394,296,8465,1161318,1161614,42
5292,298,9186,1160893,1161191,42
4421,299,9612,1160765,1161064,42
246,27,782,103279,103306,43
509,88,478,103610,103698,43
451,111,314,103862,103973,43
575,145,795,103492,103637,43
791,168,622,103810,103978,43
972,187,271,104329,104516,43
856,195,441,104346,104541,43
450,267,554,104428,104695,43
3813,1,9235,1161441,1161442,43
5234,3,8970,1161707,1161710,43
4473,4,9760,1160920,1160924,43
5482,6,9659,1161025,1161031,43
4017,7,8116,1162574,1162581,43
9060,10,9023,1161674,1161684,43
5185,10,9299,1161408,1161418,43
1333,11,8874,1161843,1161854,43
7747,12,8030,1162698,1162710,43
4005,15,9097,1161643,1161658,43
9696,16,8223,1162532,1162548,43
1104,19,9998,1160773,1160792,43
8042,21,8296,1162494,1162515,43
1990,21,8621,1162190,1162211,43
4637,22,8199,1162633,1162655,43
5712,23,9108,1161746,1161769,43
9295,23,9849,1161028,1161051,43
3327,24,8101,1162799,1162823,43
3712,24,8955,1161969,1161993,43
5309,24,9023,1161925,1161949,43
7263,26,9990,1160982,1161008,43
7941,27,8583,1162415,1162442,43
1873,28,9753,1161272,1161300,43
5691,28,9893,1161160,1161188,43
9950,29,9900,1161181,1161210,43
4275,30,8915,1162195,1162225,43
9129,37,8071,1163069,1163106,43
4168,41,8043,1163134,1163175,43
5330,43,8716,1162502,1162545,43
6068,45,9940,1161321,1161366,43
4760,46,8886,1162420,1162466,43
9196,52,9886,1161466,1161518,43
2272,53,9687,1161717,1161770,43
3035,54,8562,1162895,1162949,43
7333,60,8410,1163101,1163161,43
3626,65,8733,1162838,1162903,43
9439,65,9411,1162225,1162290,43
5819,66,8313,1163388,1163454,43
8567,68,9422,1162345,1162413,43
6741,69,9885,1161950,1162019,43
7530,71,9221,1162683,1162754,43
5444,73,9977,1161998,1162071,43
3973,74,8165,1163883,1163957,43
3242,74,9914,1162208,1162282,43
6271,78,9617,1162579,1162657,43
8944,80,8988,1163286,1163366,43
6889,81,9622,1162732,1162813,43
5009,85,8098,1164337,1164422,43
3607,87,8507,1164013,1164100,43
6762,88,8489,1164118,1164206,43
5052,89,8042,1164653,1164742,43
6080,89,8927,1163857,1163946,43
4167,91,8094,1164779,1164870,43
9374,94,8308,1164656,1164750,43
7015,94,9513,1163545,1163639,43
8353,95,9441,1163711,1163806,43
5360,96,8904,1164343,1164439,43
8550,97,8884,1164459,1164556,43
8677,98,9309,1164131,1164229,43
9301,99,9185,1164353,1164452,43
3858,102,9236,1164401,1164503,43
7809,103,8286,1165453,1165556,43
7841,103,8454,1165388,1165491,43
8645,103,9726,1164219,1164322,43
9169,103,9862,1164186,1164289,43
9244,104,8811,1165340,1165444,43
1644,106,9550,1164705,1164811,43
3664,108,8919,1165442,1165550,43
5947,108,9472,1164997,1165105,43
3834,109,8004,1166573,1166682,43
1219,109,9435,1165251,1165360,43
5892,109,9965,1164830,1164939,43
1953,110,9686,1165218,1165328,43
7974,113,9085,1165929,1166042,43
9306,115,9183,1165944,1166059,43
4815,116,9218,1166024,1166140,43
1055,117,9836,1165522,1165639,43
3719,118,8544,1166931,1167049,43
5883,118,9048,1166545,1166663,43
3231,119,9652,1166059,1166178,43
2172,120,9267,1166563,1166683,43
2442,121,9125,1166825,1166946,43
4850,125,8474,1167597,1167722,43
4905,128,9742,1166454,1166582,43
5391,129,9637,1166687,1166816,43
1209,130,9213,1167240,1167370,43
2144,131,8437,1168146,1168277,43
5528,131,8901,1167813,1167944,43
7421,133,8377,1168468,1168601,43
8552,136,8802,1168176,1168312,43
3326,138,8695,1168419,1168557,43
4196,138,9594,1167658,1167796,43
6734,139,8439,1168951,1169090,43
6916,140,9198,1168331,1168471,43
3143,140,9975,1167694,1167834,43
3167,142,9992,1167817,1167959,43
8988,147,8591,1169360,1169507,43
8444,147,9616,1168482,1168629,43
8510,150,9569,1168676,1168826,43
9872,151,8675,1169720,1169871,43
2385,162,8761,1169785,1169947,43
7964,164,9005,1169703,1169867,43
2462,164,9313,1169559,1169723,43
7083,167,8393,1170643,1170810,43
3724,169,8467,1170736,1170905,43
5673,170,8987,1170385,1170555,43
9853,173,8906,1170636,1170809,43
7725,173,9107,1170608,1170781,43
1170,173,9164,1170724,1170897,43
7610,175,8887,1171174,1171349,43
3027,178,8188,1172048,1172226,43
5119,181,8996,1171418,1171599,43
7377,183,8785,1171810,1171993,43
4936,185,8596,1172182,1172367,43
7546,187,8660,1172303,1172490,43
5010,187,9006,1172144,1172331,43
3155,188,9390,1171947,1172135,43
8403,192,9390,1172135,1172327,43
8994,192,9444,1172273,1172465,43
2105,195,8226,1173683,1173878,43
6205,196,8122,1173982,1174178,43
6399,197,8721,1173579,1173776,43
1194,199,8380,1174117,1174316,43
7349,199,8768,1173928,1174127,43
7695,199,9261,1173634,1173833,43
1474,200,9090,1174004,1174204,43
1098,202,9730,1173564,1173766,43
9700,203,8268,1175228,1175431,43
3684,205,9865,1173834,1174039,43
1441,209,8410,1175494,1175703,43
6843,210,8627,1175486,1175696,43
2287,211,8497,1175826,1176037,43
1320,213,9185,1175349,1175562,43
3851,216,8754,1175993,1176209,43
9329,217,9875,1175088,1175305,43
7916,217,9991,1175189,1175406,43
8775,218,8916,1176481,1176699,43
3491,218,9619,1175996,1176214,43
9957,219,9140,1176693,1176912,43
4730,220,8272,1177780,1178000,43
9520,220,8641,1177631,1177851,43
5118,222,9988,1176504,1176726,43
4577,224,8740,1177974,1178198,43
2104,226,8553,1178385,1178611,43
7948,227,8610,1178554,1178781,43
2060,227,9117,1178274,1178501,43
9220,231,9432,1178186,1178417,43
1945,232,8997,1178852,1179084,43
5703,233,8156,1179925,1180158,43
8633,234,8986,1179328,1179562,43
6146,234,9474,1179074,1179308,43
5607,235,8240,1180542,1180777,43
4031,236,8838,1180179,1180415,43
3246,241,8898,1180355,1180596,43
4146,243,8749,1180745,1180988,43
9255,244,8574,1181163,1181407,43
3666,255,8722,1181259,1181514,43
2147,257,8197,1182039,1182296,43
3450,257,8669,1181824,1182081,43
2902,260,9130,1181620,1181880,43
7845,261,9404,1181606,1181867,43
7287,262,9724,1181547,1181809,43
3427,264,9147,1182386,1182650,43
4251,265,9590,1182207,1182472,43
1791,266,9287,1182775,1183041,43
4451,266,9579,1182749,1183015,43
3960,271,8648,1183946,1184217,43
2646,274,8943,1183922,1184196,43
5872,276,9789,1183350,1183626,43
6641,278,9061,1184354,1184632,43
3977,278,9539,1184154,1184432,43
2493,280,9982,1183989,1184269,43
7600,281,9657,1184594,1184875,43
6694,281,9954,1184578,1184859,43
7025,282,8982,1185831,1186113,43
6318,284,8345,1186750,1187034,43
8044,285,9488,1185891,1186176,43
5621,288,8229,1187435,1187723,43
3925,288,8526,1187426,1187714,43
4552,291,8909,1187331,1187622,43
5039,292,9728,1186803,1187095,43
7084,293,9663,1187160,1187453,43
6856,295,8621,1188495,1188790,43
5497,296,9093,1188318,1188614,43
8233,299,8860,1188847,1189146,43
8774,299,9096,1188910,1189209,43
6542,300,8518,1189787,1190087,43
899,191,58,5169,5360,44
105,7,409,104840,104847,44
229,8,773,104483,104491,44
826,10,377,104887,104897,44
572,19,375,104899,104918,44
605,38,562,104731,104769,44
796,46,177,105154,105200,44
851,53,611,104766,104819,44
563,70,231,105199,105269,44
584,98,667,104833,104931,44
195,101,669,104929,105030,44
281,110,240,105459,105569,44
135,135,354,105455,105590,44
257,137,745,105199,105336,44
382,151,149,105932,106083,44
440,187,734,105498,105685,44
454,205,88,106331,106536,44
151,251,395,106229,106480,44
802,277,408,106467,106744,44
265,284,201,106951,107235,44
518,286,346,107090,107376,44
694,288,294,107428,107716,44
923,298,218,107792,108090,44
5852,2,9268,1189337,1189339,44
9535,3,8178,1190429,1190432,44
4612,7,9985,1188625,1188632,44
7068,11,8105,1190512,1190523,44
2952,14,9324,1189304,1189318,44
1600,15,8854,1189788,1189803,44
6366,19,9229,1189428,1189447,44
4917,20,8008,1190668,1190688,44
7998,24,8839,1189857,1189881,44
4515,24,9809,1188911,1188935,44
8441,25,9798,1188946,1188971,44
4068,29,9141,1189628,1189657,44
1872,34,8368,1190430,1190464,44
1648,36,8019,1190813,1190849,44
8951,37,9385,1189483,1189520,44
7617,37,9512,1189393,1189430,44
2501,37,9792,1189150,1189187,44
1747,41,8747,1190232,1190273,44
5104,43,8672,1190348,1190391,44
8451,43,9908,1189155,1189198,44
7492,44,8509,1190597,1190641,44
3749,46,8960,1190190,1190236,44
8792,46,9352,1189844,1189890,44
3477,49,8621,1190621,1190670,44
6275,50,8779,1190512,1190562,44
4609,51,9072,1190269,1190320,44
5049,51,9427,1189965,1190016,44
6107,52,8943,1190500,1190552,44
8476,54,8211,1191284,1191338,44
4934,54,9092,1190457,1190511,44
4770,60,8699,1190904,1190964,44
8000,61,8579,1191084,1191145,44
5485,63,8722,1191002,1191065,44
9173,68,8288,1191499,1191567,44
3220,68,8641,1191214,1191282,44
3019,69,9141,1190782,1190851,44
3187,71,9061,1190931,1191002,44
8571,72,9182,1190881,1190953,44
1444,75,9530,1190605,1190680,44
5170,75,9565,1190645,1190720,44
8149,76,8427,1191858,1191934,44
8455,76,8746,1191615,1191691,44
4716,79,9547,1190890,1190969,44
4193,84,8576,1191940,1192024,44
6009,86,8296,1192304,1192390,44
8094,86,8861,1191825,1191911,44
1939,87,8318,1192454,1192541,44
6938,87,9676,1191183,1191270,44
3359,87,9698,1191248,1191335,44
9794,88,9878,1191155,1191243,44
7982,91,9085,1192036,1192127,44
4884,93,8228,1192984,1193077,44
1093,95,9554,1191751,1191846,44
4802,96,9487,1191913,1192009,44
2868,98,9864,1191632,1191730,44
1142,100,9832,1191762,1191862,44
4282,102,9640,1192054,1192156,44
4143,105,9208,1192588,1192693,44
2817,106,9185,1192716,1192822,44
6277,106,9722,1192285,1192391,44
1859,107,8495,1193618,1193725,44
6216,109,9575,1192645,1192754,44
3009,109,9590,1192739,1192848,44
9959,110,8427,1194011,1194121,44
1748,110,8442,1194106,1194216,44
5204,110,9505,1193153,1193263,44
7536,114,8267,1194501,1194615,44
9786,116,8257,1194625,1194741,44
7962,117,9230,1193768,1193885,44
1310,119,8616,1194499,1194618,44
1456,121,9565,1193669,1193790,44
9112,123,8646,1194709,1194832,44
8454,123,9387,1194091,1194214,44
2724,126,9212,1194389,1194515,44
1547,126,9230,1194497,1194623,44
3456,127,8615,1195238,1195365,44
2829,128,9020,1194960,1195088,44
1166,132,8313,1195795,1195927,44
5302,139,9272,1194968,1195107,44
1771,139,9740,1194639,1194778,44
4357,140,8282,1196236,1196376,44
2126,142,9013,1195645,1195787,44
9727,142,9770,1195030,1195172,44
6137,143,8274,1196668,1196811,44
7415,144,8481,1196604,1196748,44
9796,144,8876,1196353,1196497,44
7067,146,8750,1196623,1196769,44
9656,148,8080,1197439,1197587,44
2992,149,8998,1196669,1196818,44
6155,149,9281,1196535,1196684,44
5844,158,8025,1197940,1198098,44
4383,158,9483,1196640,1196798,44
8509,159,8081,1198200,1198359,44
8306,159,8338,1198102,1198261,44
4434,159,9699,1196900,1197059,44
7054,160,9701,1197057,1197217,44
1912,161,8808,1198110,1198271,44
6011,162,8297,1198782,1198944,44
4509,163,8200,1199041,1199204,44
1312,164,9363,1198041,1198205,44
8468,167,9142,1198426,1198593,44
9690,168,8759,1198976,1199144,44
7709,169,9624,1198279,1198448,44
8971,170,9038,1199034,1199204,44
7235,174,9411,1198831,1199005,44
1435,175,9280,1199136,1199311,44
3331,176,8541,1200050,1200226,44
6787,176,9725,1199042,1199218,44
9530,178,9048,1199895,1200073,44
1738,178,9367,1199754,1199932,44
6798,179,8375,1200924,1201103,44
5390,179,8841,1200637,1200816,44
8936,181,8328,1201329,1201510,44
1449,181,8435,1201403,1201584,44
8389,181,9020,1200999,1201180,44
6504,182,8148,1202052,1202234,44
4449,182,8827,1201555,1201737,44
4912,182,8845,1201719,1201901,44
4572,186,8208,1202538,1202724,44
1425,186,8304,1202628,1202814,44
1297,191,9293,1201825,1202016,44
5617,195,8722,1202587,1202782,44
4796,196,8505,1202999,1203195,44
1264,197,8156,1203544,1203741,44
1483,197,9816,1202081,1202278,44
1906,201,9299,1202795,1202996,44
4997,206,9373,1202922,1203128,44
1951,206,9679,1202822,1203028,44
1897,207,8238,1204469,1204676,44
1510,208,8804,1204110,1204318,44
8771,210,9174,1203948,1204158,44
2162,211,8729,1204603,1204814,44
3751,211,9384,1204159,1204370,44
8807,214,9421,1204333,1204547,44
7815,215,9297,1204671,1204886,44
6562,222,8181,1206002,1206224,44
8612,222,9874,1204531,1204753,44
6204,223,9470,1205157,1205380,44
4893,230,8468,1206382,1206612,44
3474,230,9992,1205088,1205318,44
7385,231,9506,1205804,1206035,44
7585,235,8216,1207325,1207560,44
9715,236,8367,1207409,1207645,44
8634,242,8304,1207708,1207950,44
4819,244,8269,1207985,1208229,44
7870,246,8301,1208197,1208443,44
3600,251,8360,1208384,1208635,44
5995,252,9362,1207633,1207885,44
6328,254,8544,1208703,1208957,44
9233,254,8906,1208595,1208849,44
3559,255,8439,1209316,1209571,44
2078,255,8584,1209426,1209681,44
3255,255,9492,1208773,1209028,44
2335,256,8417,1210103,1210359,44
6951,256,8577,1210199,1210455,44
9827,256,8696,1210336,1210592,44
8309,257,8126,1211162,1211419,44
7791,261,9338,1210207,1210468,44
4809,266,8195,1211611,1211877,44
5275,274,9790,1210282,1210556,44
9300,277,9276,1211070,1211347,44
3589,277,9769,1210854,1211131,44
4795,279,8940,1211960,1212239,44
9784,279,9326,1211853,1212132,44
7482,280,9438,1212020,1212300,44
5737,285,9787,1211951,1212236,44
7486,293,8026,1213997,1214290,44
1568,295,9434,1212882,1213177,44
7940,295,9854,1212757,1213052,44
1823,296,8434,1214472,1214768,44
1670,297,8028,1215174,1215471,44
1127,298,9360,1214139,1214437,44
2912,298,9766,1214031,1214329,44
3883,300,9208,1214887,1215187,44
456,271,65,5353,5624,45
323,47,721,107587,107634,45
778,53,853,107502,107555,45
400,60,632,107776,107836,45
664,69,481,107987,108056,45
866,71,107,108430,108501,45
836,73,223,108385,108458,45
395,94,400,108281,108375,45
164,97,839,107936,108033,45
353,99,475,108397,108496,45
286,104,774,108197,108301,45
850,107,469,108606,108713,45
285,115,454,108728,108843,45
120,133,882,108415,108548,45
458,143,716,108714,108857,45
424,148,85,109488,109636,45
157,193,490,109231,109424,45
414,196,532,109382,109578,45
280,196,844,109266,109462,45
413,211,207,110099,110310,45
515,220,985,109532,109752,45
846,230,452,110285,110515,45
443,274,988,109979,110253,45
174,292,636,110605,110897,45
9877,2,8074,1216321,1216323,45
6202,2,9236,1215161,1215163,45
2718,2,9876,1214523,1214525,45
6626,3,8665,1215736,1215739,45
6514,3,8946,1215458,1215461,45
8288,4,8739,1215668,1215672,45
9710,4,9973,1214438,1214442,45
1751,5,9052,1215363,1215368,45
4404,5,9636,1214784,1214789,45
8760,9,8255,1216170,1216179,45
7874,9,8354,1216080,1216089,45
6544,10,8732,1215711,1215721,45
1624,14,8632,1215821,1215835,45
3481,16,9287,1215180,1215196,45
2645,16,9760,1214723,1214739,45
2836,17,9619,1214880,1214897,45
9819,18,8110,1216406,1216424,45
4645,20,9074,1215460,1215480,45
4511,20,9941,1214613,1214633,45
6270,22,8040,1216534,1216556,45
2408,24,9903,1214693,1214717,45
1856,25,9996,1214624,1214649,45
6912,27,9742,1214903,1214930,45
3206,28,8322,1216350,1216378,45
8358,29,9321,1215379,1215408,45
6097,29,9532,1215197,1215226,45
1009,30,9383,1215375,1215405,45
9133,31,8196,1216592,1216623,45
1782,32,8954,1215865,1215897,45
2224,33,8888,1215963,1215996,45
2115,34,8823,1216061,1216095,45
2746,34,9749,1215169,1215203,45
9299,36,9229,1215723,1215759,45
9925,36,9976,1215012,1215048,45
5283,38,9163,1215861,1215899,45
2132,41,8822,1216240,1216281,45
8221,43,8209,1216894,1216937,45
1662,45,9240,1215906,1215951,45
5060,51,8286,1216905,1216956,45
7537,51,8336,1216906,1216957,45
6471,51,9967,1215326,1215377,45
8172,55,8283,1217061,1217116,45
5671,59,8389,1217010,1217069,45
7008,60,8451,1217007,1217067,45
5832,61,8262,1217256,1217317,45
9598,62,9072,1216507,1216569,45
5099,64,9356,1216285,1216349,45
8347,65,9071,1216634,1216699,45
1576,66,9730,1216040,1216106,45
7429,71,8162,1217674,1217745,45
2035,74,8173,1217734,1217808,45
9837,78,8313,1217668,1217746,45
4798,78,9153,1216906,1216984,45
6521,80,9509,1216628,1216708,45
1384,83,8425,1217792,1217875,45
3366,86,9282,1217018,1217104,45
5379,88,8932,1217454,1217542,45
8319,89,8153,1218321,1218410,45
9124,90,8962,1217601,1217691,45
4886,95,8636,1218017,1218112,45
5642,96,8491,1218257,1218353,45
7618,97,9769,1217075,1217172,45
4904,98,8805,1218136,1218234,45
3384,98,8822,1218217,1218315,45
6457,101,9674,1217463,1217564,45
2896,105,8437,1218801,1218906,45
2161,105,9890,1217453,1217558,45
8133,106,8085,1219363,1219469,45
5354,107,9639,1217915,1218022,45
5939,111,8680,1218981,1219092,45
2660,116,8207,1219565,1219681,45
1391,125,8983,1218905,1219030,45
2384,125,9290,1218723,1218848,45
2140,127,8943,1219195,1219322,45
8492,129,8357,1219908,1220037,45
6362,129,9686,1218708,1218837,45
9581,133,9237,1219286,1219419,45
3480,134,9839,1218817,1218951,45
7673,135,9712,1219078,1219213,45
4992,137,9654,1219271,1219408,45
3198,138,8908,1220154,1220292,45
9807,139,9756,1219444,1219583,45
3293,144,9091,1220248,1220392,45
3382,144,9259,1220224,1220368,45
8569,148,8319,1221308,1221456,45
3964,148,8448,1221327,1221475,45
1204,149,8230,1221693,1221842,45
2685,149,9995,1220077,1220226,45
1095,151,9960,1220261,1220412,45
3847,156,8749,1221623,1221779,45
3470,157,8006,1222522,1222679,45
3998,157,9122,1221563,1221720,45
3294,157,9931,1220911,1221068,45
3489,160,9397,1221602,1221762,45
4556,161,9775,1221384,1221545,45
6533,164,8203,1223117,1223281,45
2328,165,9162,1222322,1222487,45
1777,166,8845,1222804,1222970,45
3381,168,8495,1223320,1223488,45
4336,170,8174,1223809,1223979,45
4087,171,9094,1223059,1223230,45
6691,173,8234,1224090,1224263,45
4787,174,9250,1223247,1223421,45
7680,175,9638,1223033,1223208,45
9737,175,9872,1222974,1223149,45
3478,177,8060,1224961,1225138,45
7113,178,9539,1223659,1223837,45
8522,183,9822,1223554,1223737,45
8344,184,9204,1224355,1224539,45
1244,185,8423,1225320,1225505,45
7006,188,9217,1224711,1224899,45
8480,189,8571,1225545,1225734,45
7746,191,8046,1226259,1226450,45
5694,193,9854,1224642,1224835,45
6639,195,8008,1226681,1226876,45
8210,195,9872,1225012,1225207,45
1280,196,9862,1225217,1225413,45
8374,204,8624,1226651,1226855,45
7181,204,8791,1226688,1226892,45
8826,204,9480,1226203,1226407,45
3031,204,9580,1226307,1226511,45
9662,204,9667,1226424,1226628,45
3764,205,8917,1227378,1227583,45
2701,207,9689,1226811,1227018,45
1842,209,8519,1228188,1228397,45
2510,211,9715,1227201,1227412,45
3829,212,8910,1228217,1228429,45
5335,213,9038,1228301,1228514,45
2745,216,9017,1228535,1228751,45
6693,217,8297,1229471,1229688,45
5386,220,8989,1228996,1229216,45
3024,222,8943,1229262,1229484,45
4585,223,9402,1229025,1229248,45
5896,224,9482,1229168,1229392,45
9083,224,9515,1229359,1229583,45
8736,224,9894,1229204,1229428,45
4116,225,8240,1231082,1231307,45
2113,226,9707,1229840,1230066,45
9022,227,8098,1231675,1231902,45
2137,227,9456,1230544,1230771,45
6660,228,9653,1230574,1230802,45
6412,229,9084,1231371,1231600,45
7111,237,9874,1230810,1231047,45
9480,238,8006,1232915,1233153,45
1003,240,9743,1231416,1231656,45
2422,242,8041,1233358,1233600,45
9538,242,8835,1232806,1233048,45
6726,244,9097,1232786,1233030,45
2340,245,8021,1234106,1234351,45
7158,245,9510,1232862,1233107,45
8844,246,8796,1233821,1234067,45
6513,246,8949,1233914,1234160,45
2146,249,8954,1234155,1234404,45
5092,249,9117,1234241,1234490,45
4502,251,8376,1235231,1235482,45
2937,252,9215,1234643,1234895,45
9185,255,8697,1235413,1235668,45
2438,256,8587,1235778,1236034,45
4701,256,9979,1234642,1234898,45
7593,257,8607,1236270,1236527,45
8656,257,9354,1235780,1236037,45
2447,258,9558,1235833,1236091,45
3564,261,8332,1237317,1237578,45
3618,262,9346,1236564,1236826,45
8409,264,8671,1237501,1237765,45
1012,264,9034,1237402,1237666,45
2377,268,8683,1238017,1238285,45
9462,268,9064,1237904,1238172,45
1102,271,9199,1238037,1238308,45
2242,271,9848,1237659,1237930,45
3981,275,9795,1237983,1238258,45
5082,276,9281,1238772,1239048,45
2238,277,9655,1238674,1238951,45
7866,279,8421,1240185,1240464,45
9165,280,8974,1239911,1240191,45
6499,280,9355,1239810,1240090,45
5145,282,8359,1241086,1241368,45
6313,287,9773,1239954,1240241,45
7539,288,9547,1240467,1240755,45
7045,289,8978,1241324,1241613,45
7061,292,8636,1241955,1242247,45
8082,292,8820,1242063,1242355,45
3825,292,8977,1242198,1242490,45
3506,293,8420,1243047,1243340,45
4334,295,9236,1242524,1242819,45
6509,295,9599,1242456,1242751,45
8331,297,8190,1244160,1244457,45
3927,297,9480,1243167,1243464,45
5457,300,8170,1244774,1245074,45
8287,300,9651,1243593,1243893,45
489,49,62,5627,5676,46
985,170,58,5680,5850,46
459,4,616,110917,110921,46
356,47,683,110854,110901,46
422,75,139,111445,111520,46
832,85,314,111345,111430,46
955,104,795,110949,111053,46
351,134,263,111585,111719,46
947,135,142,111840,111975,46
595,150,154,111963,112113,46
951,178,952,111315,111493,46
865,203,550,111895,112098,46
495,207,354,112294,112501,46
304,227,188,112667,112894,46
398,228,108,112974,113202,46
557,236,436,112874,113110,46
583,255,751,112795,113050,46
363,283,816,112985,113268,46
203,284,200,113884,114168,46
7057,1,8964,1244580,1244581,46
1132,2,9728,1243817,1243819,46
5845,4,8887,1244660,1244664,46
3576,6,9367,1244184,1244190,46
4138,7,8988,1244569,1244576,46
2744,8,8066,1245498,1245506,46
3549,8,8254,1245318,1245326,46
6001,8,8615,1244965,1244973,46
1691,10,8877,1244711,1244721,46
8326,12,8488,1245110,1245122,46
4629,12,9314,1244296,1244308,46
1216,17,9697,1243925,1243942,46
3614,18,8160,1245479,1245497,46
7293,19,8170,1245487,1245506,46
3904,21,9860,1243816,1243837,46
9992,23,8925,1244772,1244795,46
9998,25,8822,1244898,1244923,46
4291,25,9659,1244086,1244111,46
9158,27,8295,1245475,1245502,46
6246,27,9257,1244540,1244567,46
6630,28,9283,1244541,1244569,46
6013,29,8501,1245351,1245380,46
5875,29,9415,1244466,1244495,46
8810,31,8736,1245174,1245205,46
5255,32,8965,1244976,1245008,46
1781,33,8614,1245359,1245392,46
8316,35,9022,1244984,1245019,46
8815,37,8704,1245337,1245374,46
2133,37,8882,1245196,1245233,46
9771,39,8784,1245331,1245370,46
3989,40,8798,1245356,1245396,46
3644,45,9100,1245094,1245139,46
5324,48,8018,1246221,1246269,46
1316,48,9536,1244751,1244799,46
5140,52,9730,1244605,1244657,46
3735,53,8741,1245646,1245699,46
1472,53,9631,1244809,1244862,46
5236,57,8157,1246336,1246393,46
9708,59,9953,1244597,1244656,46
9874,61,8370,1246239,1246300,46
9167,62,8359,1246311,1246373,46
7212,62,9271,1245461,1245523,46
9055,64,8401,1246393,1246457,46
3104,69,9182,1245676,1245745,46
3377,69,9365,1245562,1245631,46
2759,70,9535,1245461,1245531,46
5305,70,9897,1245169,1245239,46
5849,71,8628,1246508,1246579,46
5695,71,9528,1245679,1245750,46
2427,73,9083,1246195,1246268,46
7386,78,9613,1245738,1245816,46
3662,82,8494,1246935,1247017,46
2951,87,8213,1247298,1247385,46
6196,87,8397,1247201,1247288,46
9095,88,9126,1246559,1246647,46
6324,88,9851,1245922,1246010,46
8155,91,8515,1247346,1247437,46
7945,96,8329,1247623,1247719,46
1911,96,8574,1247474,1247570,46
3033,97,9686,1246458,1246555,46
3504,99,9454,1246787,1246886,46
4595,100,9776,1246564,1246664,46
6887,102,8460,1247980,1248082,46
8335,102,9704,1246838,1246940,46
7149,104,8064,1248580,1248684,46
9425,104,8565,1248183,1248287,46
2915,104,8942,1247910,1248014,46
1304,105,9291,1247665,1247770,46
9380,109,8916,1248145,1248254,46
4327,112,8778,1248392,1248504,46
3831,114,8658,1248624,1248738,46
7913,115,8063,1249333,1249448,46
4919,116,9607,1247904,1248020,46
6635,120,8027,1249600,1249720,46
6469,122,9263,1248484,1248606,46
3941,123,8413,1249456,1249579,46
1045,124,9528,1248464,1248588,46
3529,127,8998,1249118,1249245,46
5454,127,9166,1249077,1249204,46
3595,132,8091,1250279,1250411,46
6515,132,8943,1249559,1249691,46
8744,132,9503,1249131,1249263,46
2155,134,9663,1249103,1249237,46
2097,137,9513,1249387,1249524,46
7022,137,9583,1249454,1249591,46
9308,140,9823,1249351,1249491,46
8839,141,8279,1251035,1251176,46
4398,141,8677,1250778,1250919,46
8266,141,9103,1250493,1250634,46
7414,142,8143,1251594,1251736,46
6964,146,9498,1250381,1250527,46
2628,146,9507,1250518,1250664,46
4229,147,8837,1251334,1251481,46
9469,149,8044,1252274,1252423,46
3115,149,8958,1251509,1251658,46
7479,149,9856,1250760,1250909,46
7555,150,8863,1251902,1252052,46
4906,155,8618,1252297,1252452,46
3479,156,8325,1252745,1252901,46
6701,156,8908,1252318,1252474,46
8679,156,9309,1252073,1252229,46
5539,157,8009,1253529,1253686,46
4252,157,8708,1252987,1253144,46
1174,161,8755,1253097,1253258,46
8020,161,9219,1252794,1252955,46
2953,163,8212,1253962,1254125,46
8911,164,9664,1252673,1252837,46
8327,171,8976,1253525,1253696,46
4206,176,8263,1254409,1254585,46
1758,176,9435,1253413,1253589,46
6295,178,8561,1254463,1254641,46
7306,178,9184,1254018,1254196,46
7620,179,8577,1254803,1254982,46
4176,184,8510,1255049,1255233,46
2860,186,9942,1253801,1253987,46
8435,189,9695,1254234,1254423,46
7743,191,9209,1254909,1255100,46
6057,192,8971,1255338,1255530,46
3484,193,9216,1255285,1255478,46
6958,195,9223,1255471,1255666,46
9677,196,8183,1256706,1256902,46
4646,203,8170,1256915,1257118,46
5304,206,9023,1256265,1256471,46
8139,206,9870,1255624,1255830,46
1835,209,8636,1257064,1257273,46
2932,210,8349,1257560,1257770,46
4417,210,8975,1257144,1257354,46
2303,212,8744,1257585,1257797,46
3111,215,8269,1258272,1258487,46
4684,215,8831,1257925,1258140,46
1112,215,9719,1257252,1257467,46
3884,217,9859,1257327,1257544,46
3933,221,8745,1258658,1258879,46
2300,222,9263,1258361,1258583,46
7239,223,8966,1258880,1259103,46
9592,230,8562,1259507,1259737,46
9908,230,8692,1259607,1259837,46
9252,232,9778,1258751,1258983,46
8238,233,9418,1259343,1259576,46
6245,238,8622,1260372,1260610,46
9745,244,8764,1260468,1260712,46
4111,244,9885,1259591,1259835,46
3056,245,8477,1261243,1261488,46
7598,247,8943,1261022,1261269,46
6696,250,8706,1261506,1261756,46
4908,251,9317,1261145,1261396,46
1153,253,9528,1261185,1261438,46
4207,254,8129,1262837,1263091,46
5228,255,8127,1263093,1263348,46
3089,257,8359,1263116,1263373,46
8183,261,8386,1263346,1263607,46
1646,263,8951,1263042,1263305,46
9005,270,8623,1263633,1263903,46
7893,270,9920,1262606,1262876,46
9919,274,9112,1263684,1263958,46
7552,274,9396,1263674,1263948,46
3608,284,8622,1264722,1265006,46
2798,284,9808,1263820,1264104,46
1621,285,8357,1265555,1265840,46
9278,286,8069,1266128,1266414,46
7402,287,9123,1265360,1265647,46
8530,288,9657,1265113,1265401,46
9878,289,8221,1266837,1267126,46
1184,289,9185,1266162,1266451,46
4105,290,8052,1267584,1267874,46
3069,290,8125,1267801,1268091,46
8555,290,8157,1268059,1268349,46
7356,290,9702,1266804,1267094,46
4345,292,9527,1267269,1267561,46
3785,293,9600,1267488,1267781,46
1499,293,9872,1267509,1267802,46
7713,295,9149,1268525,1268820,46
1799,296,9764,1268205,1268501,46
1827,300,9711,1268554,1268854,46
854,5,250,114118,114123,47
385,11,139,114234,114245,47
204,51,194,114190,114241,47
603,63,265,114170,114233,47
474,69,375,114123,114192,47
338,71,764,113803,113874,47
682,91,116,114522,114613,47
773,100,840,113889,113989,47
384,108,352,114477,114585,47
619,113,714,114223,114336,47
982,119,366,114684,114803,47
759,119,857,114312,114431,47
131,142,645,114643,114785,47
473,144,409,115021,115165,47
553,145,407,115167,115312,47
601,149,270,115449,115598,47
941,191,123,115745,115936,47
212,227,215,115844,116071,47
253,251,143,116143,116394,47
946,273,827,115710,115983,47
576,282,624,116186,116468,47
6114,1,8509,1270056,1270057,47
9875,2,9424,1269142,1269144,47
2414,4,9695,1268873,1268877,47
9638,4,9956,1268616,1268620,47
8011,6,9748,1268828,1268834,47
2587,7,8531,1270051,1270058,47
8658,9,9855,1268734,1268743,47
8683,16,8626,1269972,1269988,47
2437,17,8363,1270251,1270268,47
7344,18,8972,1269659,1269677,47
1854,20,8569,1270080,1270100,47
1725,20,9732,1268937,1268957,47
3991,27,8631,1270058,1270085,47
7173,27,9162,1269554,1269581,47
7049,29,9257,1269486,1269515,47
7639,34,9243,1269529,1269563,47
1478,35,8672,1270134,1270169,47
4626,35,9635,1269206,1269241,47
1749,35,9889,1268987,1269022,47
6730,37,8808,1270103,1270140,47
5941,40,9986,1268962,1269002,47
7504,46,8428,1270560,1270606,47
2774,46,8609,1270425,1270471,47
6494,46,9965,1269115,1269161,47
8168,49,9646,1269480,1269529,47
5435,50,9691,1269484,1269534,47
1531,52,8455,1270770,1270822,47
5293,52,8575,1270702,1270754,47
3623,53,9524,1269805,1269858,47
1647,55,8638,1270744,1270799,47
3170,55,9635,1269802,1269857,47
8848,56,9847,1269645,1269701,47
4915,57,8997,1270551,1270608,47
5669,59,8686,1270919,1270978,47
7589,59,9763,1269901,1269960,47
5430,64,9574,1270149,1270213,47
2273,65,8021,1271766,1271831,47
9292,66,8857,1270995,1271061,47
6592,67,9469,1270449,1270516,47
3321,72,8109,1271876,1271948,47
5912,76,9202,1270855,1270931,47
4332,78,8546,1271587,1271665,47
6654,78,8752,1271459,1271537,47
3892,79,9360,1270929,1271008,47
4308,80,9306,1271062,1271142,47
3550,80,9468,1270980,1271060,47
8615,80,9606,1270922,1271002,47
5559,83,8579,1272029,1272112,47
4648,91,9451,1271240,1271331,47
1566,95,8396,1272386,1272481,47
7367,95,9198,1271679,1271774,47
1109,95,9999,1270973,1271068,47
2894,96,9236,1271831,1271927,47
9433,98,8259,1272904,1273002,47
5399,100,9400,1271861,1271961,47
4073,101,8172,1273189,1273290,47
8434,102,8253,1273209,1273311,47
5549,102,8953,1272611,1272713,47
2301,104,8900,1272766,1272870,47
8678,108,9028,1272742,1272850,47
5289,109,8568,1273310,1273419,47
5212,110,9205,1272782,1272892,47
9358,111,9396,1272701,1272812,47
3515,112,9450,1272758,1272870,47
1993,113,8281,1274039,1274152,47
6334,113,8694,1273739,1273852,47
3055,114,9191,1273355,1273469,47
2184,114,9510,1273150,1273264,47
4091,115,8185,1274589,1274704,47
9716,116,8789,1274100,1274216,47
6874,120,9954,1273051,1273171,47
8619,121,9695,1273430,1273551,47
2508,126,8882,1274364,1274490,47
4324,129,8296,1275076,1275205,47
3129,130,8796,1274705,1274835,47
5378,130,9760,1273871,1274001,47
1175,131,9247,1274514,1274645,47
2358,132,8125,1275767,1275899,47
9110,133,9429,1274595,1274728,47
6670,139,9690,1274467,1274606,47
9322,139,9820,1274476,1274615,47
1052,141,8005,1276430,1276571,47
9202,141,8011,1276565,1276706,47
8799,142,8434,1276283,1276425,47
4140,144,8970,1275889,1276033,47
6702,148,9519,1275484,1275632,47
8629,153,9071,1276080,1276233,47
9500,153,9858,1275446,1275599,47
2564,158,9021,1276436,1276594,47
7178,159,8698,1276917,1277076,47
6737,163,9196,1276578,1276741,47
7995,164,8936,1277001,1277165,47
3935,165,8329,1277772,1277937,47
2032,165,9476,1276790,1276955,47
5942,168,9963,1276468,1276636,47
7140,169,9445,1277154,1277323,47
4840,173,8937,1277831,1278004,47
5628,176,8616,1278325,1278501,47
2027,177,9068,1278049,1278226,47
6348,177,9180,1278114,1278291,47
8932,178,9352,1278119,1278297,47
4901,181,8029,1279620,1279801,47
3065,182,9474,1278356,1278538,47
4523,183,9950,1278062,1278245,47
7126,184,8348,1279847,1280031,47
7629,184,8565,1279814,1279998,47
7399,185,9340,1279223,1279408,47
1077,188,8483,1280265,1280453,47
6678,190,9283,1279653,1279843,47
6534,191,8567,1280559,1280750,47
4560,197,9287,1280030,1280227,47
5665,198,8611,1280903,1281101,47
9873,207,9572,1280140,1280347,47
8277,208,8035,1281884,1282092,47
5830,212,9624,1280503,1280715,47
4674,213,8534,1281805,1282018,47
2175,213,9167,1281385,1281598,47
1573,220,8319,1282446,1282666,47
8204,220,8846,1282139,1282359,47
9593,221,8925,1282280,1282501,47
4456,223,8971,1282455,1282678,47
2717,227,8325,1283324,1283551,47
8029,228,8708,1283168,1283396,47
4921,228,9661,1282443,1282671,47
1004,231,9111,1283221,1283452,47
2492,232,9323,1283240,1283472,47
5882,232,9625,1283170,1283402,47
3411,234,9945,1283082,1283316,47
7507,240,8530,1284731,1284971,47
9142,243,8897,1284604,1284847,47
2145,243,9447,1284297,1284540,47
3949,244,8689,1285298,1285542,47
3527,245,9028,1285203,1285448,47
3523,248,8054,1286422,1286670,47
6150,250,8153,1286571,1286821,47
4757,251,8323,1286651,1286902,47
2525,252,9413,1285812,1286064,47
8852,253,9080,1286397,1286650,47
4015,254,8496,1287234,1287488,47
7494,254,9633,1286351,1286605,47
6015,256,8822,1287416,1287672,47
2006,258,9648,1286846,1287104,47
1350,259,8902,1287850,1288109,47
3807,263,8996,1288015,1288278,47
8557,265,9445,1287829,1288094,47
1965,266,8936,1288603,1288869,47
2321,266,9830,1287975,1288241,47
1734,269,8271,1289800,1290069,47
6418,269,8541,1289799,1290068,47
6523,269,9041,1289568,1289837,47
4149,270,8431,1290447,1290717,47
4722,271,8260,1290888,1291159,47
1825,271,9169,1290250,1290521,47
6893,272,9444,1290246,1290518,47
6331,272,9496,1290466,1290738,47
9678,273,8067,1292167,1292440,47
7905,274,9861,1290646,1290920,47
9579,277,9411,1291370,1291647,47
4543,278,9389,1291669,1291947,47
7436,280,9571,1291765,1292045,47
3802,281,8288,1293328,1293609,47
1730,281,9467,1292430,1292711,47
8030,282,9535,1292643,1292925,47
1886,286,9362,1293098,1293384,47
1550,292,8522,1294224,1294516,47
6617,294,9255,1293783,1294077,47
717,87,70,5838,5925,48
645,41,575,116517,116558,48
886,45,346,116787,116832,48
517,63,757,116421,116484,48
372,76,781,116460,116536,48
102,77,967,116350,116427,48
116,87,620,116774,116861,48
882,113,738,116743,116856,48
107,155,459,117135,117290,48
488,179,593,117156,117335,48
885,197,299,117629,117826,48
390,223,97,118028,118251,48
342,228,330,118018,118246,48
558,234,287,118289,118523,48
680,236,798,118012,118248,48
881,254,350,118696,118950,48
727,275,884,118416,118691,48
9279,1,9715,1293617,1293618,48
1820,3,9503,1293830,1293833,48
7454,4,8014,1295322,1295326,48
4024,4,8416,1294924,1294928,48
5139,4,8896,1294448,1294452,48
9260,4,9629,1293719,1293723,48
7596,4,9708,1293644,1293648,48
3841,5,8068,1295288,1295293,48
1121,6,8074,1295287,1295293,48
2804,6,8805,1294562,1294568,48
4322,8,8128,1295245,1295253,48
5661,11,8649,1294732,1294743,48
6650,12,8576,1294816,1294828,48
9269,12,9790,1293614,1293626,48
8281,13,9056,1294360,1294373,48
1793,13,9436,1293993,1294006,48
9869,15,8487,1294955,1294970,48
8636,15,9620,1293837,1293852,48
2852,17,9043,1294429,1294446,48
4650,17,9469,1294020,1294037,48
4125,20,8547,1294959,1294979,48
8662,22,9601,1293925,1293947,48
1612,23,8241,1295307,1295330,48
5953,24,8159,1295412,1295436,48
7942,26,9669,1293926,1293952,48
9659,28,8033,1295588,1295616,48
2637,31,9605,1294044,1294075,48
7334,31,9621,1294059,1294090,48
5331,33,9313,1294398,1294431,48
3172,43,9950,1293794,1293837,48
7254,46,8468,1295319,1295365,48
7957,48,9025,1294808,1294856,48
6211,53,8726,1295155,1295208,48
8122,54,9017,1294917,1294971,48
1999,57,8930,1295058,1295115,48
2799,57,9770,1294275,1294332,48
7735,57,9819,1294283,1294340,48
3980,59,8401,1295758,1295817,48
5272,60,8451,1295767,1295827,48
6992,64,8061,1296217,1296281,48
5618,64,8373,1295969,1296033,48
5361,69,9486,1294920,1294989,48
3867,73,8696,1295779,1295852,48
4385,73,9086,1295462,1295535,48
3610,74,9368,1295253,1295327,48
6382,74,9951,1294744,1294818,48
2235,76,8093,1296676,1296752,48
2011,76,9309,1295536,1295612,48
8759,77,8162,1296759,1296836,48
6543,77,8207,1296791,1296868,48
5570,82,8764,1296311,1296393,48
8114,83,8916,1296241,1296324,48
2684,88,9318,1295922,1296010,48
1555,93,8921,1296407,1296500,48
6077,94,9054,1296367,1296461,48
2481,95,9093,1296422,1296517,48
1085,95,9702,1295908,1296003,48
7670,101,8821,1296884,1296985,48
2653,103,8061,1297745,1297848,48
3919,103,8901,1297008,1297111,48
4386,104,9463,1296549,1296653,48
7328,105,9571,1296545,1296650,48
6699,106,8801,1297420,1297526,48
7062,109,9569,1296758,1296867,48
5579,111,8583,1297853,1297964,48
7909,112,8442,1298105,1298217,48
6062,113,8771,1297888,1298001,48
2521,113,8976,1297796,1297909,48
9986,116,9265,1297620,1297736,48
6725,121,9161,1297840,1297961,48
7481,122,8465,1298657,1298779,48
6368,122,8714,1298530,1298652,48
6651,122,9606,1297760,1297882,48
7491,124,8911,1298577,1298701,48
6688,125,8818,1298794,1298919,48
5806,125,9141,1298596,1298721,48
3388,126,9035,1298827,1298953,48
6299,132,8611,1299377,1299509,48
2985,137,8204,1299916,1300053,48
8365,137,8447,1299810,1299947,48
6180,137,8842,1299552,1299689,48
9342,138,9715,1298816,1298954,48
7568,140,9911,1298758,1298898,48
1549,141,9394,1299415,1299556,48
7938,142,8191,1300759,1300901,48
5388,142,8631,1300461,1300603,48
4409,143,8251,1300983,1301126,48
2547,144,8251,1301126,1301270,48
6192,144,8501,1301020,1301164,48
4503,147,9203,1300462,1300609,48
3963,147,9329,1300483,1300630,48
7850,149,9940,1300019,1300168,48
1044,150,9703,1300405,1300555,48
9470,158,8419,1301839,1301997,48
4470,158,9291,1301125,1301283,48
6663,159,9520,1301054,1301213,48
4053,160,9677,1301056,1301216,48
6113,163,8919,1301974,1302137,48
5080,166,9603,1301453,1301619,48
4118,168,8857,1302365,1302533,48
1346,169,8909,1302481,1302650,48
5644,176,9167,1302392,1302568,48
1190,177,8231,1303504,1303681,48
1054,177,8276,1303636,1303813,48
4165,178,8172,1303917,1304095,48
7485,179,8869,1303398,1303577,48
8693,183,9005,1303441,1303624,48
2047,184,8228,1304401,1304585,48
3162,185,9928,1302885,1303070,48
2820,186,9212,1303786,1303972,48
4854,187,8248,1304936,1305123,48
2942,191,8611,1304760,1304951,48
9762,191,9847,1303715,1303906,48
9597,193,8067,1305686,1305879,48
3026,193,9431,1304515,1304708,48
8814,196,8943,1305196,1305392,48
3996,197,9753,1304582,1304779,48
1520,198,9040,1305492,1305690,48
1606,201,9834,1304896,1305097,48
7036,202,9652,1305279,1305481,48
2480,205,8988,1306145,1306350,48
1753,207,9033,1306305,1306512,48
2632,207,9767,1305778,1305985,48
7044,211,9276,1306476,1306687,48
4054,214,8941,1307022,1307236,48
4974,216,9297,1306880,1307096,48
1636,217,8465,1307928,1308145,48
6082,218,8765,1307845,1308063,48
6278,218,8857,1307971,1308189,48
8290,219,8512,1308534,1308753,48
9482,220,8879,1308386,1308606,48
5466,222,8490,1308995,1309217,48
5412,223,9153,1308554,1308777,48
4581,224,9267,1308663,1308887,48
3174,226,9275,1308879,1309105,48
9691,227,8196,1310184,1310411,48
7814,229,8224,1310383,1310612,48
2246,232,8368,1310468,1310700,48
2548,235,8099,1310969,1311204,48
1981,235,8631,1310672,1310907,48
1416,236,9023,1310515,1310751,48
2426,236,9941,1309833,1310069,48
6361,237,8134,1311876,1312113,48
9897,238,8032,1312215,1312453,48
9946,240,8424,1312061,1312301,48
5666,240,8944,1311781,1312021,48
3833,241,9289,1311676,1311917,48
2429,242,8522,1312684,1312926,48
4498,242,8921,1312527,1312769,48
8597,243,9493,1312197,1312440,48
2297,248,9735,1312198,1312446,48
2680,249,8744,1313437,1313686,48
9036,249,9116,1313314,1313563,48
7883,252,8881,1313798,1314050,48
7880,252,9579,1313352,1313604,48
7150,253,9971,1313212,1313465,48
1641,256,9522,1313914,1314170,48
3107,257,9585,1314107,1314364,48
1137,260,8834,1315115,1315375,48
2892,262,8056,1316153,1316415,48
1512,264,8125,1316346,1316610,48
7671,267,9938,1314797,1315064,48
6981,271,8499,1316503,1316774,48
3210,273,9759,1315514,1315787,48
7778,274,8442,1317104,1317378,48
9899,274,9613,1316207,1316481,48
5422,275,8631,1317463,1317738,48
4948,276,8530,1317839,1318115,48
9287,276,9799,1316846,1317122,48
4481,278,8335,1318586,1318864,48
9458,278,9732,1317467,1317745,48
1385,279,8671,1318806,1319085,48
8649,279,8778,1318978,1319257,48
6072,280,8454,1319581,1319861,48
8477,280,9449,1318866,1319146,48
7590,281,8105,1320490,1320771,48
1971,282,9980,1318896,1319178,48
6463,283,8342,1320816,1321099,48
3123,287,9605,1319836,1320123,48
2016,288,8635,1321093,1321381,48
9863,290,8138,1321878,1322168,48
2449,292,9399,1320907,1321199,48
4816,293,9221,1321377,1321670,48
3048,293,9930,1320961,1321254,48
7050,294,8308,1322876,1323170,48
2900,296,8854,1322624,1322920,48
1984,297,8708,1323066,1323363,48
623,130,63,5932,6062,49
842,42,849,118726,118768,49
482,64,739,118878,118942,49
182,92,865,118816,118908,49
153,127,352,119421,119548,49
496,127,623,119277,119404,49
534,130,708,119319,119449,49
642,159,277,119880,120039,49
274,160,90,120226,120386,49
327,199,263,120213,120412,49
873,230,556,120119,120349,49
512,235,372,120533,120768,49
225,242,667,120473,120715,49
311,253,158,121224,121477,49
427,290,938,120697,120987,49
371,292,673,121252,121544,49
892,294,547,121670,121964,49
6291,2,9281,1322790,1322792,49
7462,3,8725,1323348,1323351,49
2947,3,9354,1322722,1322725,49
6953,4,8220,1323859,1323863,49
4666,5,9460,1322623,1322628,49
4970,6,9931,1322157,1322163,49
7346,7,8545,1323549,1323556,49
2259,8,9385,1322716,1322724,49
1769,10,9390,1322719,1322729,49
1193,10,9768,1322351,1322361,49
1732,12,8823,1323306,1323318,49
8367,12,9755,1322386,1322398,49
5147,12,9782,1322371,1322383,49
4004,13,8061,1324104,1324117,49
7174,14,9549,1322629,1322643,49
5821,15,8009,1324183,1324198,49
5820,15,9149,1323058,1323073,49
1890,16,8733,1323489,1323505,49
4237,18,8679,1323559,1323577,49
7591,18,8865,1323391,1323409,49
6685,22,8464,1323810,1323832,49
3844,25,8275,1324021,1324046,49
7625,28,8272,1324049,1324077,49
4959,32,8597,1323752,1323784,49
6554,32,9563,1322818,1322850,49
7986,35,8426,1323987,1324022,49
2663,36,9247,1323201,1323237,49
9917,37,9143,1323341,1323378,49
6784,39,8584,1323937,1323976,49
3302,39,9784,1322776,1322815,49
7757,40,8763,1323836,1323876,49
9777,43,8606,1324033,1324076,49
9394,43,9103,1323579,1323622,49
8496,46,8853,1323872,1323918,49
7825,46,9907,1322864,1322910,49
5826,48,8620,1324197,1324245,49
4483,49,9093,1323772,1323821,49
1581,50,8607,1324307,1324357,49
6813,52,9636,1323328,1323380,49
4281,54,9993,1323023,1323077,49
4369,56,9652,1323418,1323474,49
1674,59,8555,1324571,1324630,49
1726,60,8406,1324779,1324839,49
7327,60,8482,1324763,1324823,49
3787,61,8980,1324325,1324386,49
2157,62,8425,1324941,1325003,49
6652,63,9590,1323838,1323901,49
8245,65,8704,1324787,1324852,49
8534,70,9832,1323724,1323794,49
4256,72,9862,1323764,1323836,49
6390,73,8217,1325481,1325554,49
9829,75,8059,1325712,1325787,49
8424,75,8296,1325550,1325625,49
1236,77,9298,1324623,1324700,49
5446,81,8859,1325139,1325220,49
5407,82,9882,1324197,1324279,49
1834,83,9601,1324560,1324643,49
8742,84,8539,1325705,1325789,49
8054,84,9242,1325086,1325170,49
4494,84,9630,1324782,1324866,49
5196,85,8980,1325516,1325601,49
5587,87,8328,1326253,1326340,49
9589,89,9458,1325210,1325299,49
5978,92,8760,1325997,1326089,49
4351,95,9798,1325051,1325146,49
3509,96,8879,1326065,1326161,49
6207,96,9666,1325374,1325470,49
6466,98,9809,1325327,1325425,49
1120,100,9921,1325313,1325413,49
8235,103,9048,1326286,1326389,49
9949,105,8270,1327167,1327272,49
5911,107,8438,1327104,1327211,49
2920,110,8774,1326875,1326985,49
8967,111,8343,1327416,1327527,49
3650,111,9002,1326868,1326979,49
3278,113,8923,1327058,1327171,49
9137,113,9979,1326115,1326228,49
7560,115,8355,1327852,1327967,49
1115,117,8036,1328286,1328403,49
1381,118,9550,1326889,1327007,49
4887,121,8838,1327719,1327840,49
7085,123,9062,1327616,1327739,49
2909,123,9767,1327034,1327157,49
5868,128,8031,1328893,1329021,49
7413,128,9649,1327403,1327531,49
2356,132,9687,1327493,1327625,49
2023,132,9719,1327593,1327725,49
3419,138,9167,1328277,1328415,49
4708,140,9818,1327764,1327904,49
1365,141,8204,1329518,1329659,49
8687,141,8216,1329647,1329788,49
1270,143,8575,1329429,1329572,49
6609,144,8500,1329647,1329791,49
2532,146,8490,1329801,1329947,49
2714,150,9979,1328458,1328608,49
2784,153,8368,1330219,1330372,49
3131,153,9882,1328858,1329011,49
1889,154,8180,1330713,1330867,49
6396,159,9295,1329752,1329911,49
6005,160,8558,1330648,1330808,49
9913,162,9025,1330341,1330503,49
8470,163,8609,1330919,1331082,49
4979,163,8950,1330741,1330904,49
7047,165,8732,1331122,1331287,49
1071,168,8757,1331262,1331430,49
7876,169,8660,1331527,1331696,49
2946,172,8222,1332134,1332306,49
9477,175,8537,1331991,1332166,49
1878,176,8416,1332287,1332463,49
9223,178,8806,1332073,1332251,49
8676,180,9691,1331366,1331546,49
8279,181,9968,1331269,1331450,49
9404,182,9437,1331981,1332163,49
1805,184,9781,1331819,1332003,49
1627,185,8369,1333415,1333600,49
7980,185,9050,1332919,1333104,49
4964,188,9403,1332751,1332939,49
5639,188,9856,1332486,1332674,49
9742,189,8247,1334283,1334472,49
1937,192,9141,1333578,1333770,49
7314,193,8931,1333980,1334173,49
5303,198,8460,1334644,1334842,49
5220,201,8359,1334943,1335144,49
2621,201,8779,1334724,1334925,49
9687,201,9275,1334429,1334630,49
1100,202,8383,1335522,1335724,49
3818,202,9053,1335054,1335256,49
6768,203,8981,1335328,1335531,49
7487,204,8074,1336438,1336642,49
1941,207,8196,1336520,1336727,49
6260,208,8065,1336858,1337066,49
1255,208,9134,1335997,1336205,49
1429,210,8588,1336751,1336961,49
2863,211,8080,1337469,1337680,49
6529,212,8117,1337643,1337855,49
2737,212,9861,1336111,1336323,49
5333,213,8172,1338012,1338225,49
1168,213,8174,1338223,1338436,49
9243,213,8555,1338055,1338268,49
1239,215,8554,1338269,1338484,49
6909,217,8287,1338751,1338968,49
8132,218,9499,1337756,1337974,49
8462,219,8498,1338975,1339194,49
4725,220,8237,1339455,1339675,49
4718,220,8915,1338997,1339217,49
8187,223,9798,1338334,1338557,49
7496,224,8793,1339562,1339786,49
8605,225,8357,1340222,1340447,49
2911,226,8345,1340459,1340685,49
5655,227,8810,1340220,1340447,49
7147,229,8111,1341146,1341375,49
3357,229,8964,1340522,1340751,49
8525,230,9721,1339994,1340224,49
3588,231,8541,1341404,1341635,49
9413,231,8906,1341270,1341501,49
5574,231,8975,1341432,1341663,49
1570,239,9326,1341312,1341551,49
5035,240,8648,1342229,1342469,49
7315,242,9112,1342005,1342247,49
1457,242,9325,1342034,1342276,49
8593,243,9511,1342090,1342333,49
2072,244,8329,1343515,1343759,49
9162,245,9175,1342913,1343158,49
4818,247,9051,1343282,1343529,49
8237,247,9827,1342753,1343000,49
7447,250,8771,1344056,1344306,49
5489,250,9057,1344020,1344270,49
8481,255,9279,1344048,1344303,49
2410,258,8793,1344789,1345047,49
6746,259,8544,1345296,1345555,49
6386,259,9862,1344237,1344496,49
9564,260,9557,1344801,1345061,49
3452,261,9470,1345148,1345409,49
6131,266,9782,1345097,1345363,49
5439,267,8147,1346998,1347265,49
5083,268,9499,1345913,1346181,49
2043,268,9795,1345885,1346153,49
6942,269,9118,1346830,1347099,49
8962,269,9784,1346433,1346702,49
3340,272,8699,1347787,1348059,49
6625,275,9725,1347033,1347308,49
4169,278,9876,1347157,1347435,49
5348,282,9530,1347781,1348063,49
2534,284,8043,1349550,1349834,49
7766,284,8942,1348935,1349219,49
1136,284,9734,1348427,1348711,49
4636,285,8896,1349549,1349834,49
9651,286,8220,1350510,1350796,49
4083,289,8727,1350289,1350578,49
4955,291,8748,1350557,1350848,49
3178,291,8789,1350807,1351098,49
3179,292,8103,1351784,1352076,49
4759,295,9679,1350500,1350795,49
2271,300,9965,1350509,1350809,49
377,9,756,121755,121764,50
760,12,86,122434,122446,50
279,27,599,121933,121960,50
540,46,558,122001,122047,50
730,55,632,121973,122028,50
903,73,987,121673,121746,50
567,79,376,122357,122436,50
630,80,230,122582,122662,50
247,88,881,122011,122099,50
119,96,224,122756,122852,50
883,158,414,122662,122820,50
765,188,912,122322,122510,50
738,195,832,122590,122785,50
714,211,100,123517,123728,50
494,220,134,123694,123914,50
480,229,103,123945,124174,50
254,251,463,123814,124065,50
536,262,303,124225,124487,50
397,268,705,124085,124353,50
487,283,256,124802,125085,50
206,298,348,124993,125291,50
6763,1,9076,1351698,1351699,50
8966,4,8710,1352065,1352069,50
2728,4,9666,1351113,1351117,50
7848,8,8203,1352580,1352588,50
1745,8,8577,1352214,1352222,50
1681,9,9967,1350832,1350841,50
2579,10,8771,1352037,1352047,50
2664,11,9878,1350940,1350951,50
7871,12,9897,1350932,1350944,50
6301,13,8026,1352815,1352828,50
3232,15,8345,1352509,1352524,50
7997,18,8896,1351973,1351991,50
3512,20,9453,1351434,1351454,50
2233,25,8540,1352367,1352392,50
7973,26,8196,1352736,1352762,50
5340,29,8476,1352482,1352511,50
2972,31,8147,1352840,1352871,50
4894,32,8291,1352727,1352759,50
5397,40,8325,1352725,1352765,50
2883,40,9606,1351484,1351524,50
2665,41,8958,1352172,1352213,50
5605,43,8443,1352728,1352771,50
2189,43,9413,1351801,1351844,50
4954,44,9023,1352234,1352278,50
8010,44,9315,1351986,1352030,50
2791,45,8761,1352584,1352629,50
5684,47,9591,1351799,1351846,50
4399,49,8709,1352728,1352777,50
4957,49,9878,1351608,1351657,50
9508,51,9516,1352019,1352070,50
8057,52,9953,1351633,1351685,50
7657,54,9586,1352052,1352106,50
8118,56,8554,1353138,1353194,50
3956,58,8075,1353673,1353731,50
6486,60,9539,1352267,1352327,50
6844,65,9171,1352695,1352760,50
3580,65,9922,1352009,1352074,50
3247,66,8570,1353426,1353492,50
3334,67,9296,1352766,1352833,50
2772,68,8088,1354041,1354109,50
7705,68,9350,1352847,1352915,50
6226,69,8347,1353918,1353987,50
3572,69,9067,1353267,1353336,50
9248,71,9434,1352969,1353040,50
6411,72,9223,1353251,1353323,50
3403,72,9242,1353304,1353376,50
6254,78,9872,1352746,1352824,50
2733,92,8184,1354512,1354604,50
4863,92,9232,1353556,1353648,50
8461,95,8891,1353989,1354084,50
2814,95,9979,1352996,1353091,50
5232,96,8413,1354657,1354753,50
5477,100,8700,1354466,1354566,50
1780,102,8222,1355044,1355146,50
4211,102,8345,1355023,1355125,50
8822,102,9542,1353928,1354030,50
9102,102,9612,1353960,1354062,50
3099,106,9979,1353695,1353801,50
8440,109,9202,1354578,1354687,50
5257,109,9394,1354495,1354604,50
6405,111,8468,1355530,1355641,50
3816,111,8591,1355518,1355629,50
5201,111,8715,1355505,1355616,50
4216,112,8877,1355454,1355566,50
7749,113,8266,1356177,1356290,50
6832,113,8959,1355597,1355710,50
6145,113,9104,1355565,1355678,50
3201,113,9790,1354992,1355105,50
3528,116,8637,1356258,1356374,50
7074,121,9389,1355622,1355743,50
7005,123,9050,1356082,1356205,50
6191,124,8316,1356939,1357063,50
9562,125,8226,1357153,1357278,50
6378,126,9022,1356482,1356608,50
5085,126,9788,1355842,1355968,50
1626,126,9813,1355943,1356069,50
4584,127,9141,1356741,1356868,50
2002,129,8755,1357254,1357383,50
9345,130,9899,1356239,1356369,50
3561,134,8961,1357307,1357441,50
6656,142,8004,1358398,1358540,50
5981,142,9024,1357520,1357662,50
1893,143,8109,1358577,1358720,50
6305,143,8502,1358327,1358470,50
3341,144,8690,1358282,1358426,50
8817,146,8068,1359048,1359194,50
1800,147,9524,1357738,1357885,50
5667,149,8975,1358434,1358583,50
4286,151,9561,1357997,1358148,50
6988,151,9909,1357800,1357951,50
1855,152,8973,1358887,1359039,50
4931,155,9024,1358988,1359143,50
3638,157,8735,1359432,1359589,50
5573,158,9298,1359026,1359184,50
4040,159,9558,1358924,1359083,50
9596,160,9080,1359561,1359721,50
5380,160,9788,1359013,1359173,50
7684,165,8316,1360645,1360810,50
1490,166,8967,1360159,1360325,50
4788,168,8197,1361095,1361263,50
6293,169,8416,1361044,1361213,50
8671,169,9434,1360195,1360364,50
5057,172,8937,1360861,1361033,50
6229,173,9865,1360105,1360278,50
1863,177,9417,1360726,1360903,50
7341,178,9832,1360488,1360666,50
6683,180,8494,1362004,1362184,50
3264,184,9245,1361433,1361617,50
3493,186,8906,1361956,1362142,50
5614,189,8079,1362969,1363158,50
5176,189,8836,1362401,1362590,50
8778,190,9657,1361769,1361959,50
2940,191,9898,1361718,1361909,50
9765,192,8750,1363057,1363249,50
5934,192,9171,1362828,1363020,50
6716,192,9344,1362847,1363039,50
6505,192,9533,1362850,1363042,50
3177,192,9649,1362926,1363118,50
7958,193,8732,1364035,1364228,50
7925,195,9603,1363357,1363552,50
9443,199,8110,1365045,1365244,50
7219,199,8579,1364775,1364974,50
1408,199,9162,1364391,1364590,50
9371,203,9103,1364649,1364852,50
1814,204,9928,1364027,1364231,50
5855,205,8756,1365403,1365608,50
7446,205,9448,1364916,1365121,50
4724,207,8740,1365829,1366036,50
2955,208,8901,1365875,1366083,50
7160,210,8675,1366309,1366519,50
4269,210,8745,1366449,1366659,50
2834,210,9211,1366193,1366403,50
3708,210,9211,1366403,1366613,50
1760,212,9705,1366119,1366331,50
1403,213,9274,1366762,1366975,50
5721,215,9419,1366830,1367045,50
3059,221,9669,1366795,1367016,50
1278,222,8348,1368337,1368559,50
3974,225,9347,1367560,1367785,50
4923,230,8501,1368631,1368861,50
5854,231,8168,1369194,1369425,50
7915,231,8649,1368944,1369175,50
9870,233,9470,1368354,1368587,50
8713,242,9138,1368919,1369161,50
8143,243,8516,1369783,1370026,50
8952,243,8883,1369659,1369902,50
5127,244,9559,1369226,1369470,50
6364,245,8516,1370513,1370758,50
4644,245,9504,1369770,1370015,50
7795,246,9048,1370471,1370717,50
9744,248,9978,1369787,1370035,50
7733,249,8616,1371397,1371646,50
9970,249,8916,1371346,1371595,50
4700,250,8824,1371687,1371937,50
1261,252,9222,1371539,1371791,50
5805,255,9152,1371861,1372116,50
2260,259,8122,1373146,1373405,50
1513,269,9766,1371761,1372030,50
8077,270,9604,1372192,1372462,50
1885,271,8824,1373242,1373513,50
3420,273,8086,1374251,1374524,50
6465,275,8684,1373926,1374201,50
7878,280,8944,1373941,1374221,50
5148,283,8616,1374549,1374832,50
5266,284,8525,1374923,1375207,50
5448,284,9741,1373991,1374275,50
2888,284,9814,1374202,1374486,50
3819,285,9685,1374615,1374900,50
4555,286,8896,1375689,1375975,50
1158,287,8156,1376715,1377002,50
8268,289,9645,1375513,1375802,50
6446,290,8250,1377197,1377487,50
6584,298,8993,1376744,1377042,50
1640,299,8774,1377261,1377560,50
6559,299,9328,1377006,1377305,50

Average Waiting Time = 722191

Average Turn Around Time = 722339
