Process,Burst Time,Arrival Time,Waiting Time,Turn Around Time,Priority
1,18,2,0,18,1
22,15,4,16,31,1
93,44,4,31,75,1
41,1,11,68,69,1
20,46,13,67,113,1
2,27,20,106,133,1
16,38,20,133,171,1
47,29,21,170,199,1
86,20,24,196,216,1
29,2,27,213,215,1
36,35,40,202,237,1
59,40,45,232,272,1
85,44,45,272,316,1
110,183,52,2131,2314,1
33,19,59,352,371,1
60,22,59,371,393,1
9,3,67,385,388,1
45,36,70,385,421,1
126,290,73,2597,2887,1
77,36,74,467,503,1
62,5,88,489,494,1
13,25,89,493,518,1
98,37,90,517,554,1
43,24,95,549,573,1
815,222,104,2453,2675,1
693,217,190,2389,2606,1
589,294,196,2514,2808,1
416,57,309,1159,1216,1
554,67,351,1124,1191,1
827,148,430,1555,1703,1
724,166,516,1900,2066,1
804,278,629,2125,2403,1
337,175,842,1640,1815,1
357,55,954,738,793,1
673,88,962,735,823,1
624,224,969,1727,1951,1
5374,182,8000,644544,644726,1
6359,287,8001,953090,953377,1
2990,14,8004,96,110,1
2003,152,8016,644610,644762,1
8575,165,8068,644560,644725,1
3938,64,8074,238239,238303,1
9617,147,8086,452830,452977,1
9928,83,8087,238290,238373,1
2068,240,8101,812604,812844,1
6548,66,8105,238355,238421,1
9565,3,8111,353,356,1
6772,231,8112,812633,812864,1
2018,113,8130,452933,453046,1
6468,200,8135,644608,644808,1
2887,153,8139,644654,644807,1
5157,51,8155,238521,238572,1
7417,193,8157,644639,644832,1
9720,251,8162,952966,953217,1
8497,257,8165,952964,953221,1
6616,234,8181,812695,812929,1
8863,62,8181,238696,238758,1
4339,125,8186,453190,453315,1
6217,115,8194,453207,453322,1
2527,203,8203,812707,812910,1
6044,58,8203,238836,238894,1
8917,69,8204,238843,238912,1
8401,78,8207,238859,238937,1
4883,118,8227,453239,453357,1
6280,217,8243,812670,812887,1
8494,82,8254,238940,239022,1
1519,20,8269,1148,1168,1
9268,229,8273,812657,812886,1
4358,119,8276,453308,453427,1
4579,77,8291,239035,239112,1
3803,93,8292,239061,239154,1
3186,15,8294,1343,1358,1
5512,187,8296,644843,645030,1
8745,262,8296,952840,953102,1
7780,149,8311,453392,453541,1
8211,255,8312,952836,953091,1
7528,292,8313,952840,953132,1
8208,59,8332,239314,239373,1
6629,155,8344,644982,645137,1
9559,280,8372,952823,953103,1
6435,146,8388,453564,453710,1
5065,202,8395,812764,812966,1
3699,24,8398,1754,1778,1
1431,196,8402,645029,645225,1
3822,219,8402,812759,812978,1
7286,64,8409,239546,239610,1
8445,246,8417,812763,813009,1
2073,237,8428,812798,813035,1
7592,144,8432,453816,453960,1
1837,109,8435,453857,453966,1
8317,258,8471,952754,953012,1
9650,277,8497,952736,953013,1
1214,300,8501,952759,953059,1
6290,299,8502,952808,953107,1
6918,170,8512,645315,645485,1
4825,83,8515,239904,239987,1
7096,191,8515,645332,645523,1
3306,170,8522,645366,645536,1
4423,13,8523,2403,2416,1
5720,184,8527,645381,645565,1
2750,114,8530,454171,454285,1
3204,129,8530,454185,454314,1
3421,255,8532,952827,953082,1
3653,104,8568,454226,454330,1
7151,33,8589,2600,2633,1
2654,260,8591,952773,953033,1
9623,286,8600,952774,953060,1
3505,85,8602,240300,240385,1
3566,34,8609,2763,2797,1
9032,193,8610,645482,645675,1
3290,1,8621,2835,2836,1
3926,148,8627,454321,454469,1
8199,99,8642,240395,240494,1
6775,200,8648,645487,645687,1
8976,210,8649,812964,813174,1
5828,293,8658,952752,953045,1
3282,175,8668,645617,645792,1
8163,59,8674,240612,240671,1
5861,50,8700,3107,3157,1
7950,149,8718,454478,454627,1
1411,298,8728,952725,953023,1
1559,71,8731,240664,240735,1
6955,27,8743,3264,3291,1
6740,94,8751,240665,240759,1
2797,260,8768,952733,952993,1
9225,223,8771,813002,813225,1
5259,53,8793,240767,240820,1
9170,54,8798,240765,240819,1
3261,92,8843,240724,240816,1
3525,157,8853,645607,645764,1
2489,243,8858,812938,813181,1
8185,260,8862,952649,952909,1
5003,288,8869,952652,952940,1
6257,81,8876,240933,241014,1
9942,200,8879,645738,645938,1
3732,87,8886,241004,241091,1
1925,166,8888,645779,645945,1
9052,1,8908,3826,3827,1
8660,113,8911,454784,454897,1
4807,195,8918,645765,645960,1
8842,121,8946,454812,454933,1
8387,249,8950,812989,813238,1
3966,99,8952,241225,241324,1
5365,121,8955,454874,454995,1
5785,50,8957,4078,4128,1
3929,151,8965,645813,645964,1
3101,131,8988,454912,455043,1
5202,83,9007,241369,241452,1
9045,73,9022,241387,241460,1
1424,282,9025,952534,952816,1
9437,238,9027,813011,813249,1
8595,174,9032,645847,646021,1
4929,285,9038,952553,952838,1
8796,246,9074,813052,813298,1
5218,276,9075,952551,952827,1
3451,242,9076,813146,813388,1
9192,98,9076,241706,241804,1
8109,49,9088,4597,4646,1
7374,50,9091,4643,4693,1
3641,158,9116,645987,646145,1
5455,275,9121,952531,952806,1
9330,97,9127,241803,241900,1
7289,155,9132,646029,646184,1
5459,62,9143,241884,241946,1
4045,202,9148,813166,813368,1
8080,227,9151,813165,813392,1
3339,154,9181,646085,646239,1
5779,193,9197,646073,646266,1
5502,273,9208,952469,952742,1
6877,289,9220,952480,952769,1
8981,167,9229,646184,646351,1
4158,4,9240,5144,5148,1
6347,68,9275,242114,242182,1
4289,234,9278,813165,813399,1
1358,195,9302,646178,646373,1
8098,292,9310,952429,952721,1
8914,278,9310,952471,952749,1
9444,50,9314,5324,5374,1
9626,143,9324,455657,455800,1
5160,144,9338,455686,455830,1
8241,168,9342,646283,646451,1
2768,209,9357,813220,813429,1
5586,23,9389,5499,5522,1
4856,87,9398,242409,242496,1
3102,122,9411,455757,455879,1
6467,223,9412,813174,813397,1
4052,148,9422,455818,455966,1
7330,267,9430,952379,952646,1
5012,14,9432,5729,5743,1
2451,116,9449,455889,456005,1
3040,115,9452,455902,456017,1
3017,2,9478,5797,5799,1
2210,15,9492,5785,5800,1
9040,219,9494,813165,813384,1
5717,281,9497,952329,952610,1
3295,106,9514,455955,456061,1
3826,218,9520,813208,813426,1
8194,168,9531,646412,646580,1
9464,9,9534,6008,6017,1
7320,181,9540,646421,646602,1
6388,260,9556,952301,952561,1
1849,98,9588,242906,243004,1
4587,297,9590,952277,952574,1
2074,227,9593,813253,813480,1
3931,216,9609,813264,813480,1
8190,265,9622,952292,952557,1
1671,48,9624,6277,6325,1
6166,78,9625,243117,243195,1
6928,275,9656,952273,952548,1
6582,300,9668,952286,952586,1
3013,70,9682,243188,243258,1
2710,117,9684,456291,456408,1
5888,18,9686,6513,6531,1
7688,49,9715,6502,6551,1
5116,24,9721,6545,6569,1
8142,144,9722,456270,456414,1
7706,252,9723,952281,952533,1
2509,288,9736,952270,952558,1
8804,296,9746,952298,952594,1
8635,209,9761,813428,813637,1
2488,3,9763,6777,6780,1
7734,194,9764,646778,646972,1
4495,290,9767,952323,952613,1
6338,217,9786,813462,813679,1
5609,58,9793,243547,243605,1
9566,6,9794,6949,6955,1
9527,138,9806,456580,456718,1
7416,7,9819,6980,6987,1
5001,292,9822,952308,952600,1
7661,211,9828,813487,813698,1
7515,237,9830,813496,813733,1
8686,184,9833,647003,647187,1
1138,12,9852,7154,7166,1
3879,254,9868,952304,952558,1
2502,283,9896,952280,952563,1
2001,209,9900,813563,813772,1
9450,269,9901,952308,952577,1
1727,10,9903,7315,7325,1
4181,153,9921,647149,647302,1
6282,235,9940,813582,813817,1
4066,192,9951,647172,647364,1
2262,74,9954,243994,244068,1
7003,126,9962,457012,457138,1
9431,165,9973,647192,647357,1
7989,94,9990,244082,244176,1
24,16,3,17575,17591,2
21,40,12,17582,17622,2
17,20,14,17620,17640,2
57,26,17,17637,17663,2
25,47,18,17662,17709,2
51,26,21,17706,17732,2
34,16,23,17730,17746,2
28,1,36,17733,17734,2
40,48,44,17726,17774,2
4,16,49,17769,17785,2
79,39,51,17783,17822,2
5,9,52,17821,17830,2
50,21,54,17828,17849,2
68,23,55,17848,17871,2
70,16,58,17868,17884,2
39,23,65,17877,17900,2
61,48,65,17900,17948,2
53,41,66,17947,17988,2
49,16,67,17987,18003,2
91,19,74,17996,18015,2
298,46,74,18015,18061,2
989,230,78,823480,823710,2
959,151,80,657151,657302,2
99,48,81,18152,18200,2
82,15,83,18198,18213,2
19,1,87,18209,18210,2
56,50,90,254127,254177,2
794,65,98,254120,254185,2
937,55,98,254136,254191,2
163,288,136,962093,962381,2
608,19,198,18295,18314,2
830,28,314,18198,18226,2
777,284,362,961906,962190,2
256,195,459,656874,657069,2
869,224,524,823165,823389,2
249,159,557,656872,657031,2
891,135,563,466838,466973,2
197,52,580,253960,254012,2
752,134,686,466751,466885,2
805,221,755,822959,823180,2
452,33,887,18045,18078,2
410,129,946,466576,466705,2
210,8,948,18066,18074,2
800,125,991,466561,466686,2
5780,32,8021,11050,11082,2
1413,6,8023,11080,11086,2
3861,259,8037,954266,954525,2
7760,177,8049,649490,649667,2
6587,198,8052,649515,649713,2
2593,105,8060,459668,459773,2
3868,135,8070,459664,459799,2
3318,235,8085,815701,815936,2
4478,174,8100,649566,649740,2
2926,93,8128,246965,247058,2
9038,231,8161,815661,815892,2
5689,61,8179,247008,247069,2
9190,277,8193,954120,954397,2
5270,166,8209,649582,649748,2
5682,152,8213,649595,649747,2
1992,40,8223,11523,11563,2
1696,216,8259,815645,815861,2
7231,122,8265,459855,459977,2
8906,126,8268,459875,460001,2
5143,96,8271,247228,247324,2
1542,210,8275,815646,815856,2
7225,251,8292,954049,954300,2
2781,218,8294,815688,815906,2
1259,44,8308,11821,11865,2
5797,184,8321,649690,649874,2
4352,213,8364,815637,815850,2
6190,109,8400,460020,460129,2
2963,58,8410,247436,247494,2
4723,288,8423,953920,954208,2
6099,281,8436,953946,954227,2
4492,181,8453,649743,649924,2
2306,102,8460,460120,460222,2
2874,288,8461,953953,954241,2
8811,227,8469,815696,815923,2
7283,22,8478,12185,12207,2
9011,34,8481,12204,12238,2
6624,94,8492,247663,247757,2
7094,141,8492,460191,460332,2
2505,7,8505,12312,12319,2
8738,237,8507,815686,815923,2
9078,144,8514,460261,460405,2
3995,141,8522,460298,460439,2
5171,272,8527,953926,954198,2
8640,61,8563,247887,247948,2
8483,240,8571,815710,815950,2
1554,151,8580,649898,650049,2
4677,35,8581,12586,12621,2
4302,12,8592,12610,12622,2
1227,229,8631,815691,815920,2
8385,214,8637,815715,815929,2
6911,3,8641,12671,12674,2
2435,260,8646,953830,954090,2
7261,119,8647,460515,460634,2
5841,292,8652,953835,954127,2
7368,219,8652,815815,816034,2
9200,116,8654,460628,460744,2
3944,191,8658,650072,650263,2
6508,160,8688,650084,650244,2
6854,48,8698,12960,13008,2
8479,31,8700,13006,13037,2
6553,124,8725,460674,460798,2
7453,294,8736,953794,954088,2
1563,30,8780,13055,13085,2
9326,248,8783,815754,816002,2
7732,169,8791,650092,650261,2
4620,137,8793,460781,460918,2
7483,119,8811,460801,460920,2
1379,46,8815,13246,13292,2
7621,252,8825,953750,954002,2
2299,281,8834,953744,954025,2
9647,82,8839,248573,248655,2
6276,168,8845,650158,650326,2
5616,233,8850,815836,816069,2
2472,102,8857,460975,461077,2
6263,54,8862,248733,248787,2
7076,13,8864,13586,13599,2
3472,2,8877,13586,13588,2
1634,202,8881,815839,816041,2
7806,140,8895,460990,461130,2
2112,252,8898,953712,953964,2
9642,161,8898,650274,650435,2
6585,201,8910,815863,816064,2
9014,196,8942,650292,650488,2
6106,46,8954,13805,13851,2
1187,205,8959,815816,816021,2
6900,157,8977,650354,650511,2
3077,116,8988,461238,461354,2
2379,73,9011,249039,249112,2
9686,53,9045,249029,249082,2
1266,178,9064,650275,650453,2
2788,212,9065,815716,815928,2
2611,90,9079,249099,249189,2
7954,252,9084,953529,953781,2
6808,30,9089,14157,14187,2
6956,271,9107,953509,953780,2
3670,12,9115,14210,14222,2
6974,46,9119,14218,14264,2
4082,170,9132,650386,650556,2
1829,292,9140,953498,953790,2
1763,153,9184,650405,650558,2
6503,13,9209,14321,14334,2
1594,59,9210,249259,249318,2
3080,118,9224,461369,461487,2
7996,192,9230,650363,650555,2
5885,196,9235,650401,650597,2
6886,241,9271,815673,815914,2
9757,3,9273,14515,14518,2
1958,84,9325,249354,249438,2
5591,283,9330,953351,953634,2
6873,172,9338,650445,650617,2
5205,107,9346,461516,461623,2
9926,259,9348,953367,953626,2
5862,33,9349,14687,14720,2
7529,248,9357,815729,815977,2
5532,151,9382,650524,650675,2
9177,183,9397,650511,650694,2
2444,272,9411,953314,953586,2
5128,176,9418,650574,650750,2
2565,202,9419,815766,815968,2
6241,87,9422,249792,249879,2
6720,74,9438,249814,249888,2
3546,105,9443,461777,461882,2
6233,83,9448,249879,249962,2
8379,40,9463,15096,15136,2
7266,172,9466,650603,650775,2
6524,101,9475,461801,461902,2
2019,174,9485,650607,650781,2
3252,171,9496,650621,650792,2
4513,281,9502,953246,953527,2
8941,188,9554,650635,650823,2
8516,42,9568,15325,15367,2
2323,144,9582,461896,462040,2
3755,258,9617,953163,953421,2
9525,300,9650,1061479,1061779,2
3721,147,9656,461967,462114,2
1565,60,9674,250187,250247,2
8377,166,9705,650623,650789,2
2756,37,9706,15523,15560,2
3286,237,9734,815604,815841,2
9891,187,9739,650656,650843,2
9785,265,9746,953093,953358,2
2583,189,9752,650731,650920,2
4055,279,9755,953100,953379,2
9218,4,9762,15749,15753,2
4488,254,9768,953117,953371,2
3603,35,9781,15783,15818,2
3448,237,9806,815720,815957,2
5708,275,9822,953068,953343,2
8103,47,9831,15866,15913,2
4107,151,9918,650805,650956,2
6279,257,9923,952993,953250,2
8023,196,9924,650851,651047,2
5323,72,9942,250530,250602,2
8785,60,9948,250547,250607,2
6012,171,9959,650863,651034,2
9284,98,9966,250590,250688,2
6223,216,9975,815689,815905,2
2192,278,9988,952936,953214,2
38,15,1,26184,26199,3
32,29,9,26191,26220,3
72,45,12,26217,26262,3
23,36,18,26256,26292,3
14,1,19,26291,26292,3
58,37,23,26288,26325,3
55,28,25,26323,26351,3
84,29,27,26349,26378,3
18,28,31,26374,26402,3
37,9,32,26401,26410,3
44,31,35,26407,26438,3
35,45,42,26431,26476,3
64,39,54,26464,26503,3
54,47,56,26501,26548,3
46,5,63,26541,26546,3
97,49,64,260642,260691,3
87,29,67,26590,26619,3
74,7,68,26618,26625,3
78,7,69,26624,26631,3
75,2,73,26627,26629,3
89,36,75,26627,26663,3
92,26,77,26661,26687,3
602,198,77,825656,825854,3
73,27,90,26722,26749,3
332,23,250,26589,26612,3
211,247,329,825405,825652,3
790,133,334,472189,472322,3
853,12,450,26508,26520,3
358,110,617,471942,472052,3
843,126,683,471889,472015,3
983,223,956,824828,825051,3
5487,173,8016,653080,653253,3
9868,82,8023,253027,253109,3
9725,136,8031,464670,464806,3
2257,102,8040,464700,464802,3
9356,111,8053,464692,464803,3
4104,202,8063,817747,817949,3
2286,92,8068,253212,253304,3
8426,50,8068,253256,253306,3
1241,18,8076,19422,19440,3
3701,95,8086,253240,253335,3
3575,248,8104,954851,955099,3
8075,102,8156,464703,464805,3
3227,242,8162,817703,817945,3
6434,238,8162,817748,817986,3
2619,25,8169,19587,19612,3
5296,254,8175,954781,955035,3
4475,136,8181,464833,464969,3
8184,282,8200,954763,955045,3
5237,78,8207,253509,253587,3
2343,195,8218,653204,653399,3
9977,263,8218,954780,955043,3
2070,38,8230,19839,19877,3
1453,98,8272,464931,465029,3
3839,233,8274,817827,818060,3
4474,280,8298,954716,954996,3
3661,133,8302,465002,465135,3
8579,202,8303,817884,818086,3
2452,169,8323,653347,653516,3
1066,86,8345,253793,253879,3
5199,75,8345,253831,253906,3
9115,296,8383,954664,954960,3
6860,174,8387,653355,653529,3
9365,41,8393,20194,20235,3
2904,12,8409,20219,20231,3
4808,32,8415,20225,20257,3
3140,86,8461,253840,253926,3
2185,208,8475,817767,817975,3
2815,251,8484,954612,954863,3
6269,245,8494,817809,818054,3
6591,222,8496,817855,818077,3
3011,138,8508,465232,465370,3
6786,279,8520,954580,954859,3
6092,297,8522,954610,954907,3
9724,173,8523,653546,653719,3
2757,228,8551,817925,818153,3
9894,180,8579,653566,653746,3
6325,115,8592,465439,465554,3
8883,287,8592,954590,954877,3
3958,277,8594,954628,954905,3
4775,210,8613,817994,818204,3
7363,23,8637,20755,20778,3
1181,32,8661,20754,20786,3
9135,158,8674,653654,653812,3
4305,30,8732,20763,20793,3
8484,1,8733,20792,20793,3
5124,283,8738,954514,954797,3
2201,299,8741,1062391,1062690,3
2232,74,8747,254425,254499,3
5869,76,8749,254449,254525,3
7408,30,8758,20960,20990,3
2244,272,8773,954565,954837,3
6941,186,8791,653698,653884,3
3907,29,8799,21045,21074,3
6401,226,8805,817965,818191,3
1593,183,8820,653758,653941,3
4529,8,8825,21144,21152,3
8903,245,8826,817973,818218,3
7969,100,8865,465734,465834,3
1809,10,8867,21206,21216,3
4527,65,8915,254605,254670,3
9541,77,8930,254607,254684,3
2821,92,8966,254600,254692,3
4373,78,8966,254644,254722,3
2467,34,8968,21307,21341,3
4453,295,8974,954389,954684,3
7326,225,9000,817897,818122,3
9805,182,9002,653762,653944,3
7881,195,9011,653788,653983,3
4647,65,9015,254821,254886,3
1792,56,9021,254832,254888,3
8062,212,9022,817903,818115,3
8549,253,9027,954384,954637,3
9001,254,9047,954370,954624,3
8322,288,9049,954375,954663,3
9616,138,9068,465934,466072,3
5561,274,9078,954387,954661,3
6426,298,9082,1062052,1062350,3
7340,151,9093,654054,654205,3
8141,181,9135,654016,654197,3
9546,292,9137,954405,954697,3
1787,243,9155,818085,818328,3
3923,250,9162,954425,954675,3
5545,130,9163,466230,466360,3
5663,148,9182,654153,654301,3
9024,76,9182,255365,255441,3
1267,114,9187,466289,466403,3
8570,292,9187,954403,954695,3
2633,214,9188,818198,818412,3
7731,170,9188,654248,654418,3
5377,147,9211,466432,466579,3
1464,169,9214,654245,654414,3
9850,212,9214,818189,818401,3
1526,206,9230,818188,818394,3
6738,137,9237,466606,466743,3
5622,75,9242,255774,255849,3
1875,36,9251,22546,22582,3
4598,125,9257,466626,466751,3
7663,36,9262,22619,22655,3
6050,61,9299,255793,255854,3
8177,41,9300,22665,22706,3
1161,141,9309,466602,466743,3
7017,201,9311,818116,818317,3
5581,131,9326,466679,466810,3
7573,68,9335,255917,255985,3
2556,196,9352,654279,654475,3
3459,180,9354,654326,654506,3
3585,11,9355,22939,22950,3
1321,214,9360,818071,818285,3
4437,31,9386,22967,22998,3
2761,223,9390,818058,818281,3
7788,295,9442,954193,954488,3
1064,154,9462,654401,654555,3
1406,242,9487,818037,818279,3
1233,161,9496,654424,654585,3
8301,57,9509,256155,256212,3
5144,199,9529,818040,818239,3
8202,104,9537,466952,467056,3
8224,276,9538,954145,954421,3
7362,231,9543,818078,818309,3
6054,99,9546,467050,467149,3
5887,193,9550,654534,654727,3
5084,6,9553,23407,23413,3
2723,84,9556,256411,256495,3
2766,93,9564,256439,256532,3
9741,35,9566,23496,23531,3
4185,61,9578,256470,256531,3
3756,19,9584,23561,23580,3
4780,164,9585,654545,654709,3
8295,133,9595,467103,467236,3
2983,218,9599,818056,818274,3
7365,173,9602,654595,654768,3
3292,206,9621,818055,818261,3
4928,161,9626,654647,654808,3
7932,149,9626,654661,654810,3
8126,42,9627,23873,23915,3
8853,246,9630,818055,818301,3
6458,82,9638,256815,256897,3
5931,85,9654,256833,256918,3
2124,221,9664,818070,818291,3
8195,156,9668,654721,654877,3
1223,217,9672,818086,818303,3
7423,171,9693,654755,654926,3
9775,175,9697,654775,654950,3
8350,85,9749,257020,257105,3
7319,253,9759,953953,954206,3
7949,147,9775,467559,467706,3
3183,226,9778,818050,818276,3
3358,106,9786,467648,467754,3
9666,266,9794,953924,954190,3
2375,250,9814,953923,954173,3
6864,109,9822,467721,467830,3
6168,136,9842,467713,467849,3
3889,24,9844,24514,24538,3
6120,263,9850,953890,954153,3
8519,56,9877,257370,257426,3
7943,299,9882,1061253,1061552,3
2496,278,9891,953915,954193,3
5059,139,9892,467852,467991,3
1687,231,9893,818214,818445,3
2405,298,9908,1061229,1061527,3
6307,157,9932,655018,655175,3
6657,284,9946,953941,954225,3
5889,76,9955,257643,257719,3
8099,122,9964,468022,468144,3
6733,49,9975,257700,257749,3
6845,162,9981,655029,655191,3
3406,47,9993,25013,25060,3
100,29,17,35036,35065,4
26,44,22,35060,35104,4
66,18,24,35102,35120,4
12,19,25,35119,35138,4
90,36,33,35130,35166,4
15,43,38,35161,35204,4
8,30,43,35199,35229,4
95,20,49,35223,35243,4
94,24,58,35234,35258,4
69,36,66,35250,35286,4
76,35,69,35283,35318,4
42,30,82,35305,35335,4
6,25,99,35318,35343,4
31,47,99,35343,35390,4
872,8,109,35380,35388,4
237,228,133,828111,828339,4
335,121,152,477960,478081,4
269,63,307,267515,267578,4
781,65,324,267514,267579,4
315,4,359,35326,35330,4
145,3,372,35317,35320,4
429,294,383,963544,963838,4
991,252,384,963593,963845,4
556,60,431,267521,267581,4
741,197,445,827933,828130,4
910,224,482,827899,828123,4
696,235,502,827909,828144,4
753,260,502,963483,963743,4
581,208,674,827828,828036,4
845,85,680,267525,267610,4
389,69,740,267503,267572,4
387,215,777,827739,827954,4
170,228,902,827635,827863,4
668,226,927,827644,827870,4
657,17,950,35353,35370,4
686,294,954,963047,963341,4
1798,283,8032,956019,956302,4
5078,193,8036,657642,657835,4
7972,144,8044,470731,470875,4
8340,274,8064,956026,956300,4
4364,30,8074,28481,28511,4
6868,94,8088,260561,260655,4
6438,241,8093,820660,820901,4
7744,136,8104,470818,470954,4
4202,190,8116,657711,657901,4
2928,225,8118,820682,820907,4
7154,180,8150,657773,657953,4
3788,202,8184,820647,820849,4
4025,25,8194,28720,28745,4
4876,2,8194,28745,28747,4
8542,200,8195,820644,820844,4
8014,94,8209,260823,260917,4
4197,81,8217,260862,260943,4
4243,73,8220,260893,260966,4
2476,84,8242,260897,260981,4
9280,144,8243,470965,471109,4
7726,198,8255,820590,820788,4
9890,83,8263,261009,261092,4
5500,86,8268,261040,261126,4
5816,74,8283,261064,261138,4
8251,39,8284,29127,29166,4
8781,108,8294,471012,471120,4
8963,180,8296,657813,657993,4
3599,211,8306,820543,820754,4
5517,183,8313,657882,658065,4
1347,197,8343,820523,820720,4
4268,168,8354,657930,658098,4
9219,173,8376,657932,658105,4
1211,253,8396,955724,955977,4
4827,232,8427,820492,820724,4
7382,265,8470,955659,955924,4
7739,91,8491,261363,261454,4
9098,161,8493,657994,658155,4
7636,99,8502,471307,471406,4
4545,123,8529,471284,471407,4
3003,36,8535,29573,29609,4
1583,26,8540,29604,29630,4
2845,243,8546,820461,820704,4
1479,187,8549,658005,658192,4
5923,96,8562,471377,471473,4
3061,99,8578,471362,471461,4
8616,262,8600,955550,955812,4
9257,3,8602,29803,29806,4
9157,227,8629,820477,820704,4
2989,253,8660,955508,955761,4
6671,163,8660,658087,658250,4
8956,190,8692,658074,658264,4
3987,202,8693,820496,820698,4
5710,44,8695,29948,29992,4
2401,227,8723,820474,820701,4
9181,26,8725,30009,30035,4
7046,161,8755,658157,658318,4
2207,140,8756,471580,471720,4
9586,120,8776,471605,471725,4
4526,53,8790,261924,261977,4
7672,151,8808,658121,658272,4
5777,225,8841,820389,820614,4
6735,232,8859,820402,820634,4
9402,105,8872,471681,471786,4
2048,41,8889,30247,30288,4
3921,209,8895,820404,820613,4
9156,155,8899,658187,658342,4
4766,220,8926,820388,820608,4
9427,55,8929,262127,262182,4
8086,15,8943,30422,30437,4
2512,242,8950,820390,820632,4
8033,85,8961,262151,262236,4
7903,162,9002,658195,658357,4
4271,277,9008,955169,955446,4
7668,73,9024,262222,262295,4
9569,55,9025,262247,262302,4
7917,26,9026,30636,30662,4
3394,22,9038,30650,30672,4
2339,16,9039,30671,30687,4
4596,182,9040,658225,658407,4
1231,210,9061,820377,820587,4
1778,33,9077,30743,30776,4
6250,126,9092,471863,471989,4
8791,54,9100,262324,262378,4
1977,125,9101,471885,472010,4
6479,241,9121,820333,820574,4
8121,286,9136,955074,955360,4
9053,206,9138,820413,820619,4
1037,40,9150,30985,31025,4
7765,248,9171,955081,955329,4
6234,254,9173,955083,955337,4
3445,81,9209,262510,262591,4
4980,262,9209,955057,955319,4
6695,299,9234,1061907,1062206,4
7803,60,9244,262605,262665,4
9068,170,9250,658453,658623,4
2399,166,9284,658445,658611,4
1107,146,9289,658462,658608,4
3454,225,9292,820471,820696,4
8910,222,9318,820476,820698,4
1279,104,9319,472285,472389,4
6834,229,9321,820501,820730,4
2171,243,9326,820531,820774,4
3864,231,9333,820573,820804,4
7771,89,9333,262961,263050,4
4649,159,9337,658666,658825,4
5282,280,9338,954996,955276,4
9073,3,9347,31674,31677,4
5318,24,9354,31670,31694,4
3034,85,9359,263073,263158,4
2504,103,9378,472480,472583,4
3616,280,9382,954988,955268,4
8674,218,9400,820643,820861,4
5097,249,9432,954974,955223,4
6194,205,9432,820685,820890,4
9618,120,9444,472618,472738,4
8665,2,9455,31922,31924,4
2038,242,9464,820664,820906,4
3349,116,9469,472667,472783,4
6700,283,9492,954919,955202,4
7469,11,9496,32024,32035,4
8466,239,9511,820715,820954,4
2250,52,9516,263434,263486,4
1684,56,9521,263434,263490,4
8430,39,9523,32149,32188,4
2491,43,9536,32175,32218,4
8384,224,9538,820733,820957,4
6327,221,9548,820753,820974,4
9506,230,9570,820758,820988,4
2523,264,9577,954873,955137,4
6165,164,9584,659034,659198,4
4951,74,9596,263608,263682,4
5022,231,9611,820803,821034,4
8916,154,9614,659074,659228,4
5809,173,9631,659067,659240,4
7422,164,9658,659069,659233,4
3153,207,9674,820777,820984,4
6121,122,9682,473063,473185,4
8846,83,9687,263832,263915,4
9072,269,9701,954769,955038,4
5131,13,9709,32703,32716,4
6857,174,9715,659132,659306,4
6056,21,9730,32742,32763,4
9232,200,9737,820777,820977,4
7098,184,9766,659161,659345,4
6059,80,9776,263971,264051,4
4255,124,9784,473184,473308,4
2605,20,9807,32874,32894,4
3219,110,9812,473185,473295,4
1287,194,9815,659152,659346,4
4727,169,9830,659187,659356,4
7445,23,9833,33009,33032,4
3081,40,9840,33025,33065,4
1964,14,9843,33062,33076,4
8672,33,9860,33059,33092,4
8871,184,9873,659169,659353,4
8933,189,9888,659194,659383,4
1361,88,9897,264171,264259,4
6493,240,9906,820614,820854,4
6642,118,9924,473333,473451,4
4376,287,9951,954544,954831,4
3943,140,9964,473365,473505,4
6729,75,9970,264331,264406,4
9613,254,9983,954555,954809,4
2284,148,9984,659293,659441,4
8446,49,9988,264437,264486,4
5224,190,9993,659288,659478,4
30,46,1,43515,43561,5
11,4,7,43555,43559,5
88,41,7,43559,43600,5
3,26,16,43591,43617,5
65,29,16,43617,43646,5
67,3,19,43643,43646,5
96,26,24,43641,43667,5
10,16,27,43664,43680,5
80,30,27,43680,43710,5
63,40,29,43708,43748,5
81,11,31,43746,43757,5
7,8,34,43754,43762,5
27,27,34,43762,43789,5
71,35,49,43774,43809,5
612,65,60,274416,274481,5
83,15,64,43840,43855,5
52,17,82,43837,43854,5
48,10,93,43843,43853,5
292,187,105,669225,669412,5
420,201,291,830379,830580,5
641,251,311,964241,964492,5
325,4,356,43728,43732,5
898,51,447,274189,274240,5
318,287,492,964071,964358,5
511,221,560,830221,830442,5
984,35,577,43649,43684,5
960,140,630,483133,483273,5
295,82,643,274139,274221,5
219,30,644,43709,43739,5
484,180,698,668874,669054,5
406,246,780,963830,964076,5
689,8,801,43674,43682,5
660,142,810,668850,668992,5
711,202,920,829942,830144,5
147,124,936,483066,483190,5
345,173,990,668720,668893,5
1598,43,8004,36663,36706,5
3882,48,8005,267095,267143,5
5851,54,8005,267097,267151,5
3447,165,8017,661725,661890,5
7910,200,8022,822852,823052,5
6848,197,8054,822830,823027,5
5967,168,8056,661808,661976,5
4363,172,8066,661825,661997,5
4988,274,8089,956527,956801,5
7059,29,8125,36953,36982,5
2727,127,8150,476219,476346,5
8097,11,8150,37003,37014,5
4313,181,8151,661820,662001,5
5138,281,8162,956488,956769,5
8055,229,8162,822829,823058,5
8180,283,8169,956522,956805,5
7742,45,8191,37157,37202,5
6885,215,8192,822888,823103,5
7103,246,8192,956542,956788,5
8200,178,8196,662060,662238,5
6047,99,8233,476506,476605,5
7934,58,8235,267580,267638,5
6136,283,8257,956483,956766,5
6040,79,8258,267616,267695,5
9731,286,8261,956522,956808,5
5842,171,8269,662122,662293,5
9317,282,8269,956560,956842,5
4575,283,8284,956587,956870,5
9118,248,8287,956627,956875,5
5521,180,8300,662268,662448,5
6814,180,8303,662304,662484,5
3324,215,8309,823096,823311,5
3848,16,8312,37771,37787,5
7535,169,8312,662383,662552,5
8167,220,8313,823117,823337,5
8879,55,8321,268056,268111,5
3530,203,8335,823125,823328,5
4583,37,8345,37938,37975,5
8663,93,8360,268073,268166,5
5944,208,8368,823105,823313,5
7623,78,8391,268136,268214,5
2417,132,8392,476977,477109,5
3082,48,8392,268214,268262,5
4671,258,8401,956521,956779,5
6139,276,8404,956536,956812,5
6123,234,8425,823166,823400,5
8336,193,8438,823197,823390,5
8503,108,8446,477154,477262,5
7509,256,8447,956529,956785,5
2439,123,8461,477202,477325,5
5358,88,8467,268470,268558,5
8412,63,8481,268498,268561,5
6413,144,8494,662621,662765,5
3353,40,8496,38514,38554,5
7689,212,8500,823188,823400,5
8488,175,8509,662658,662833,5
7311,234,8512,823198,823432,5
7106,13,8525,38663,38676,5
2227,242,8544,956448,956690,5
5839,37,8554,38693,38730,5
2979,103,8578,477355,477458,5
7931,167,8590,662709,662876,5
3622,103,8602,477389,477492,5
3391,197,8633,823171,823368,5
8818,141,8637,477412,477553,5
3130,227,8640,823171,823398,5
5840,118,8647,477498,477616,5
1399,47,8668,268892,268939,5
7201,98,8668,477502,477600,5
9492,194,8688,823160,823354,5
7520,17,8700,39044,39061,5
2906,127,8716,477507,477634,5
5632,195,8717,823135,823330,5
4862,43,8727,39126,39169,5
4771,192,8754,823103,823295,5
8626,169,8767,662803,662972,5
4013,249,8799,956195,956444,5
8107,40,8806,39228,39268,5
8022,37,8810,39264,39301,5
6680,28,8816,39295,39323,5
7072,106,8845,477604,477710,5
2010,27,8855,39330,39357,5
6567,163,8860,662787,662950,5
2690,211,8868,823041,823252,5
7179,268,8874,956129,956397,5
6370,122,8875,477731,477853,5
3526,288,8878,956153,956441,5
8394,153,8879,662937,663090,5
2831,125,8883,477848,477973,5
2450,283,8901,956178,956461,5
8028,124,8904,477907,478031,5
6811,88,8906,269454,269542,5
7970,284,8923,956199,956483,5
4074,79,8924,269525,269604,5
9938,194,8925,823205,823399,5
5054,269,8930,956236,956505,5
3138,288,8931,956264,956552,5
6342,298,8932,1062218,1062516,5
4372,48,8948,269722,269770,5
9304,109,8953,478129,478238,5
8004,157,8957,663165,663322,5
2662,131,8959,478187,478318,5
2093,174,8974,663164,663338,5
6897,180,8988,663183,663363,5
3109,165,8991,663219,663384,5
4460,75,8995,269959,270034,5
2400,97,9011,478317,478414,5
8342,39,9040,40322,40361,5
8748,121,9053,478279,478400,5
5239,89,9054,270023,270112,5
6522,26,9077,40416,40442,5
2736,120,9085,478275,478395,5
8505,243,9085,956208,956451,5
9676,277,9085,956211,956488,5
5167,204,9091,823293,823497,5
5670,28,9092,40611,40639,5
6851,190,9096,663285,663475,5
2464,254,9102,956231,956485,5
3300,124,9113,478514,478638,5
4085,232,9117,823331,823563,5
9632,264,9126,956221,956485,5
1899,35,9140,40821,40856,5
6343,195,9140,823400,823595,5
3045,5,9148,40894,40899,5
2316,24,9161,40886,40910,5
3360,113,9176,478626,478739,5
7678,93,9185,270452,270545,5
2967,72,9193,270491,270563,5
5716,79,9208,270502,270581,5
7138,121,9215,478607,478728,5
5316,83,9218,270572,270655,5
6167,224,9240,823305,823529,5
5990,124,9261,478637,478761,5
5209,213,9278,823301,823514,5
8970,51,9283,270685,270736,5
8214,224,9291,823311,823535,5
2806,49,9298,270722,270771,5
4154,279,9309,956062,956341,5
2333,59,9311,270759,270818,5
6673,222,9322,823364,823586,5
3820,216,9327,823391,823607,5
4764,92,9340,270837,270929,5
2052,129,9343,478826,478955,5
6032,222,9345,823399,823621,5
8832,194,9360,823416,823610,5
8573,124,9394,478907,479031,5
4303,1,9406,41631,41632,5
5284,298,9442,1061716,1062014,5
5096,271,9456,956004,956275,5
7751,99,9469,478959,479058,5
7472,113,9478,478956,479069,5
5222,255,9483,956008,956263,5
2929,211,9508,823422,823633,5
7884,166,9509,663705,663871,5
1632,147,9525,663714,663861,5
3692,185,9530,663715,663900,5
7133,154,9556,663733,663887,5
1008,87,9557,271324,271411,5
5951,232,9586,823365,823597,5
9728,1,9591,41999,42000,5
3316,75,9602,271367,271442,5
8784,153,9604,663747,663900,5
8048,156,9614,663749,663905,5
9093,150,9615,663763,663913,5
9197,212,9615,823378,823590,5
2544,160,9640,663796,663956,5
9400,261,9642,955864,956125,5
8151,98,9649,479429,479527,5
9385,90,9653,271674,271764,5
9804,209,9678,823387,823596,5
7211,260,9679,955848,956108,5
6556,169,9691,663911,664080,5
5476,4,9692,42451,42455,5
7187,23,9711,42436,42459,5
9675,209,9714,823420,823629,5
9903,8,9718,42498,42506,5
4869,289,9729,955818,956107,5
5814,182,9745,663983,664165,5
2064,162,9787,663982,664144,5
6637,109,9800,479619,479728,5
9843,297,9826,1061340,1061637,5
6148,294,9860,1061313,1061607,5
2822,127,9876,479655,479782,5
8008,204,9886,823417,823621,5
8518,288,9894,955802,956090,5
7665,8,9896,42742,42750,5
2098,240,9897,823470,823710,5
1848,257,9916,955828,956085,5
5788,72,9917,272159,272231,5
1182,48,9919,272183,272231,5
4712,105,9921,479836,479941,5
5426,77,9942,272209,272286,5
7335,62,9946,272236,272298,5
4522,56,9949,272249,272305,5
8972,58,9949,272259,272317,5
2455,170,9966,664118,664288,5
435,8,109,52997,53005,6
523,38,111,53003,53041,6
306,224,130,833341,833565,6
396,68,141,282173,282241,6
388,186,157,674007,674193,6
535,46,177,282206,282252,6
731,101,196,489717,489818,6
445,255,266,965500,965755,6
155,64,301,282175,282239,6
877,26,366,53101,53127,6
242,202,383,833175,833377,6
954,19,451,53087,53106,6
571,247,467,965319,965566,6
152,280,574,965224,965504,6
366,32,658,52989,53021,6
467,231,763,832909,833140,6
425,152,795,673657,673809,6
166,61,930,281795,281856,6
5115,57,8016,274725,274782,6
2987,91,8022,274731,274822,6
4209,46,8027,274772,274818,6
1006,290,8038,1063144,1063434,6
1755,195,8039,825727,825922,6
2277,46,8043,274849,274895,6
8276,107,8048,482251,482358,6
1882,35,8049,46080,46115,6
5654,158,8069,666493,666651,6
7840,1,8073,46136,46137,6
7694,171,8094,666488,666659,6
2730,139,8107,666508,666647,6
2905,185,8108,666508,666693,6
5740,139,8109,666554,666693,6
8362,208,8109,825666,825874,6
5890,251,8124,957769,958020,6
9909,177,8141,666619,666796,6
7360,54,8157,275150,275204,6
5519,235,8158,825688,825923,6
6422,250,8160,957749,957999,6
5732,177,8181,666714,666891,6
5905,42,8188,46517,46559,6
7252,78,8210,275244,275322,6
3767,76,8237,275250,275326,6
1700,85,8239,275279,275364,6
8841,120,8241,482591,482711,6
2288,275,8258,957666,957941,6
1731,111,8266,482642,482753,6
7245,202,8279,825714,825916,6
2285,179,8304,666726,666905,6
5729,237,8305,957659,957896,6
9997,176,8308,666811,666987,6
8105,55,8314,275566,275621,6
4350,244,8324,957642,957886,6
7580,125,8340,482823,482948,6
7190,91,8344,275638,275729,6
9297,239,8346,957629,957868,6
7647,14,8392,47030,47044,6
2222,118,8403,482841,482959,6
4877,90,8410,275710,275800,6
4435,188,8417,825739,825927,6
6353,114,8421,482897,483011,6
2592,96,8429,482912,483008,6
4592,138,8440,482906,483044,6
8809,50,8449,275900,275950,6
2114,167,8455,666846,667013,6
2357,260,8455,957524,957784,6
6034,128,8460,483027,483155,6
9639,185,8471,666907,667092,6
9386,159,8486,666939,667098,6
6620,12,8503,47473,47485,6
4990,226,8516,825691,825917,6
6188,158,8554,666940,667098,6
7071,13,8560,47518,47531,6
9780,240,8572,957432,957672,6
4355,162,8574,666988,667150,6
3299,264,8583,957426,957690,6
6354,293,8583,1062604,1062897,6
1373,83,8588,276272,276355,6
7337,226,8601,825793,826019,6
7711,153,8633,667097,667250,6
8253,19,8660,47746,47765,6
3432,61,8661,276329,276390,6
2217,57,8674,276332,276389,6
2394,38,8682,47833,47871,6
8219,257,8709,957379,957636,6
1881,47,8725,276339,276386,6
9580,174,8725,667068,667242,6
4191,199,8734,825749,825948,6
5960,201,8786,825710,825911,6
8303,136,8801,483381,483517,6
6785,36,8807,48016,48052,6
8780,35,8812,48047,48082,6
8262,294,8831,1062364,1062658,6
1617,50,8861,276435,276485,6
7975,266,8863,957297,957563,6
8551,297,8896,1062308,1062605,6
9501,257,8905,957336,957593,6
1525,165,8915,667202,667367,6
1938,97,8916,483546,483643,6
7624,248,8920,957343,957591,6
8382,34,8920,48334,48368,6
1936,55,8921,276656,276711,6
8459,264,8925,957351,957615,6
8406,47,8965,276668,276715,6
6036,55,8978,276657,276712,6
3239,123,8980,483582,483705,6
2139,232,8981,825824,826056,6
9704,159,9000,667288,667447,6
9362,278,9013,957292,957570,6
4834,110,9029,483706,483816,6
8777,133,9044,483710,483843,6
6373,105,9052,483744,483849,6
3165,298,9053,1062163,1062461,6
2580,83,9076,276937,277020,6
5343,234,9103,825846,826080,6
3250,115,9109,483795,483910,6
4853,275,9132,957266,957541,6
3799,226,9135,825911,826137,6
8448,100,9166,483856,483956,6
7221,20,9170,48928,48948,6
3649,154,9196,667353,667507,6
4950,215,9199,825887,826102,6
4306,283,9228,957210,957493,6
7435,58,9231,277188,277246,6
3673,181,9237,667424,667605,6
7928,281,9237,957249,957530,6
7175,213,9252,825961,826174,6
9531,10,9267,49166,49176,6
1172,135,9278,484035,484170,6
8232,97,9307,484050,484147,6
5853,248,9316,957216,957464,6
4661,4,9318,49260,49264,6
9094,103,9331,484079,484182,6
7886,121,9341,484081,484202,6
9246,48,9344,277456,277504,6
7912,107,9349,484103,484210,6
2871,61,9384,277465,277526,6
5749,45,9411,49396,49441,6
6924,158,9423,667425,667583,6
4536,200,9445,825844,826044,6
7124,36,9461,49481,49517,6
8592,7,9472,49506,49513,6
3643,54,9482,277475,277529,6
8881,245,9499,957046,957291,6
7662,87,9506,277506,277593,6
2994,8,9516,49604,49612,6
4781,273,9534,957021,957294,6
2406,18,9578,49595,49613,6
1538,220,9594,825807,826027,6
2975,270,9594,956999,957269,6
9729,239,9603,957025,957264,6
1253,154,9621,667535,667689,6
3351,186,9622,667550,667736,6
5713,234,9622,825911,826145,6
7837,230,9636,825945,826175,6
1668,69,9637,277785,277854,6
5815,267,9644,956988,957255,6
6337,258,9651,957013,957271,6
8264,105,9656,484423,484528,6
5427,221,9683,826040,826261,6
1723,36,9684,50047,50083,6
3052,24,9687,50080,50104,6
4668,56,9700,277930,277986,6
8528,289,9712,1061517,1061806,6
7891,259,9722,957015,957274,6
2897,187,9727,826129,826316,6
1561,272,9729,957032,957304,6
7313,78,9729,278096,278174,6
8812,203,9731,826175,826378,6
9607,61,9746,278158,278219,6
1319,274,9763,957035,957309,6
9584,120,9767,484655,484775,6
6870,295,9771,1061462,1061757,6
6256,209,9772,826249,826458,6
4843,40,9793,50538,50578,6
2017,5,9797,50574,50579,6
6244,80,9810,278294,278374,6
4872,99,9812,484733,484832,6
4389,18,9817,50649,50667,6
4150,131,9824,484729,484860,6
7581,259,9827,957060,957319,6
8886,110,9839,484801,484911,6
2566,300,9861,1061382,1061682,6
7654,204,9876,826266,826470,6
8798,218,9886,826274,826492,6
2057,140,9921,668115,668255,6
2028,169,9934,668104,668273,6
1029,224,9945,826247,826471,6
3612,191,9949,826281,826472,6
8089,55,9998,278647,278702,6
841,62,103,288553,288615,7
177,114,257,494733,494847,7
221,56,317,288402,288458,7
329,116,386,494629,494745,7
814,46,429,288347,288393,7
728,222,435,835804,836026,7
990,247,447,966519,966766,7
580,134,476,494658,494792,7
574,194,530,835797,835991,7
685,174,613,677696,677870,7
355,169,709,677639,677808,7
457,299,748,1070516,1070815,7
493,204,749,835638,835842,7
343,130,797,494612,494742,7
307,68,884,288299,288367,7
436,37,993,60646,60683,7
1428,198,8001,828408,828606,7
3748,151,8008,670515,670666,7
8084,191,8033,828392,828583,7
8364,142,8042,670544,670686,7
1020,178,8045,670548,670726,7
9319,241,8045,958987,959228,7
5509,291,8050,1063234,1063525,7
5653,147,8055,670675,670822,7
7595,201,8092,828438,828639,7
3876,32,8096,53976,54008,7
5317,121,8110,487754,487875,7
2369,10,8118,54030,54040,7
9750,157,8126,670663,670820,7
1213,15,8132,54070,54085,7
4659,116,8134,487808,487924,7
5465,44,8152,54109,54153,7
2320,113,8155,487814,487927,7
3846,224,8168,828381,828605,7
4879,149,8175,670683,670832,7
1451,205,8198,828393,828598,7
6949,108,8202,487929,488037,7
4359,239,8235,958857,959096,7
2656,237,8262,958839,959076,7
1501,229,8284,828426,828655,7
4114,102,8285,488003,488105,7
1254,192,8293,828464,828656,7
3678,185,8295,828472,828657,7
5594,297,8311,1062985,1063282,7
2366,132,8312,488127,488259,7
9918,161,8315,670886,671047,7
8847,142,8321,670906,671048,7
4126,148,8325,670909,671057,7
1695,289,8339,1062975,1063264,7
6849,124,8351,488315,488439,7
1788,147,8416,670878,671025,7
1868,211,8422,828444,828655,7
4077,144,8457,670896,671040,7
9773,140,8464,670898,671038,7
5341,73,8467,282270,282343,7
8919,171,8474,670893,671064,7
4234,272,8492,958714,958986,7
3084,275,8498,958750,959025,7
8979,134,8510,488513,488647,7
8904,90,8525,488543,488633,7
8698,47,8530,282461,282508,7
3110,278,8551,958742,959020,7
7206,35,8565,55060,55095,7
4218,77,8566,282473,282550,7
8320,137,8579,670965,671102,7
9293,5,8609,55139,55144,7
5796,194,8618,828421,828615,7
4205,270,8620,958721,958991,7
7820,253,8630,958751,959004,7
5130,91,8656,488643,488734,7
9106,238,8663,958741,958979,7
7804,172,8665,671069,671241,7
5893,110,8666,488727,488837,7
7348,294,8667,1062657,1062951,7
1578,227,8703,828540,828767,7
6186,298,8714,1062625,1062923,7
4038,276,8715,958795,959071,7
1390,205,8741,828643,828848,7
6649,37,8764,55517,55554,7
7558,65,8764,282893,282958,7
9298,79,8806,282872,282951,7
5370,73,8807,282906,282979,7
5424,166,8808,671198,671364,7
8372,121,8810,488880,489001,7
5782,75,8824,283008,283083,7
4539,269,8829,958727,958996,7
3700,134,8834,488934,489068,7
4537,238,8837,958758,958996,7
7361,275,8845,958758,959033,7
2957,31,8858,55900,55931,7
9369,58,8863,283180,283238,7
5046,177,8867,671311,671488,7
6415,46,8870,283232,283278,7
9846,79,8933,283171,283250,7
2961,255,8963,958685,958940,7
9168,30,8970,56039,56069,7
1857,218,8971,828628,828846,7
8111,171,9025,671289,671460,7
8831,29,9031,56096,56125,7
3050,98,9032,489057,489155,7
6530,219,9063,828572,828791,7
2055,271,9067,958606,958877,7
4535,108,9077,489113,489221,7
9772,283,9111,1062247,1062530,7
2691,154,9122,671369,671523,7
7501,192,9123,828645,828837,7
4898,260,9137,958626,958886,7
5467,164,9158,671446,671610,7
9839,65,9169,283510,283575,7
7649,194,9174,828652,828846,7
9051,84,9184,283561,283645,7
1380,17,9185,56499,56516,7
6173,138,9192,671488,671626,7
2922,52,9201,283629,283681,7
6018,43,9204,56585,56628,7
9447,97,9208,489323,489420,7
2526,131,9211,489328,489459,7
5952,54,9212,283716,283770,7
9140,180,9260,671423,671603,7
6777,56,9273,283710,283766,7
2808,70,9274,283721,283791,7
5219,12,9292,56804,56816,7
8129,223,9299,828539,828762,7
9555,154,9315,671460,671614,7
4300,76,9316,283795,283871,7
5834,113,9323,489396,489509,7
8193,192,9331,828548,828740,7
5929,16,9334,56994,57010,7
7238,159,9339,671502,671661,7
5547,70,9342,283936,284006,7
8072,251,9363,958430,958681,7
2448,165,9368,671544,671709,7
1271,30,9372,57148,57178,7
1240,131,9373,489554,489685,7
4119,108,9386,489583,489691,7
2934,103,9407,489581,489684,7
8725,68,9411,284118,284186,7
9904,264,9425,958389,958653,7
6526,236,9426,958422,958658,7
2769,118,9469,489625,489743,7
1664,173,9471,671565,671738,7
6450,111,9472,489697,489808,7
5321,145,9494,671580,671725,7
7153,45,9500,284323,284368,7
9314,298,9516,1061846,1062144,7
4212,102,9518,489765,489867,7
8495,12,9520,57602,57614,7
3332,13,9548,57586,57599,7
4491,72,9552,284362,284434,7
2503,181,9568,671563,671744,7
5957,266,9568,958335,958601,7
3543,174,9582,671642,671816,7
8912,239,9587,958352,958591,7
9591,12,9597,57770,57782,7
2101,288,9617,1061764,1062052,7
6449,269,9675,958322,958591,7
9416,119,9693,489879,489998,7
1828,200,9702,828571,828771,7
8684,31,9706,57849,57880,7
1005,166,9708,671743,671909,7
7357,63,9715,284632,284695,7
4564,129,9717,489977,490106,7
2268,106,9722,490012,490118,7
7830,140,9723,671759,671899,7
9379,12,9731,58075,58087,7
5699,252,9747,958289,958541,7
7213,153,9749,671785,671938,7
1306,16,9756,58150,58166,7
5753,200,9769,828570,828770,7
3091,178,9773,671826,672004,7
4179,180,9775,671867,672047,7
8694,33,9787,58267,58300,7
7839,257,9799,958259,958516,7
2080,217,9817,828588,828805,7
9981,146,9817,671964,672110,7
6507,242,9843,958242,958484,7
5449,219,9856,828632,828851,7
8153,256,9860,958237,958493,7
9401,132,9862,490441,490573,7
8371,181,9863,672070,672251,7
2365,262,9866,958257,958519,7
2223,81,9867,285264,285345,7
7736,96,9867,490571,490667,7
2441,250,9877,958278,958528,7
1737,261,9888,958287,958548,7
7832,79,9897,285406,285485,7
3258,180,9900,672220,672400,7
3486,60,9921,285462,285522,7
9847,139,9945,672220,672359,7
1680,278,9978,958228,958506,7
6128,22,9983,58896,58918,7
121,143,72,682147,682290,8
426,36,91,68853,68889,8
562,146,117,682113,682259,8
758,163,125,682119,682282,8
175,165,208,682067,682232,8
674,130,280,500577,500707,8
568,79,301,295409,295488,8
129,103,317,500583,500686,8
762,73,325,295465,295538,8
392,104,331,500585,500689,8
943,88,344,500589,500677,8
896,25,389,68978,69003,8
230,4,424,68968,68972,8
987,185,437,838332,838517,8
816,61,470,295482,295543,8
483,224,520,838256,838480,8
500,61,595,295419,295480,8
764,229,605,967654,967883,8
334,244,658,967605,967849,8
858,108,849,500265,500373,8
123,137,999,681493,681630,8
5603,286,8010,1063386,1063672,8
5562,59,8027,288225,288284,8
8119,2,8027,61799,61801,8
8112,165,8031,674512,674677,8
7614,69,8077,288235,288304,8
5706,54,8082,288256,288310,8
8076,6,8082,61875,61881,8
2786,9,8086,61877,61886,8
5081,125,8102,493168,493293,8
7027,4,8102,61913,61917,8
6109,67,8133,288260,288327,8
7418,83,8135,288282,288365,8
4261,163,8139,674437,674600,8
6921,270,8151,960179,960449,8
2014,35,8162,62029,62064,8
8314,95,8167,493231,493326,8
1665,189,8210,830800,830989,8
2655,209,8221,830800,831009,8
6952,234,8239,960136,960370,8
8670,100,8247,493294,493394,8
9631,71,8247,288518,288589,8
1486,226,8255,960129,960355,8
7570,196,8268,830878,831074,8
9067,162,8271,674612,674774,8
1400,35,8309,62304,62339,8
1080,226,8316,960069,960295,8
4236,257,8318,960068,960325,8
9921,150,8321,674684,674834,8
8543,195,8324,830934,831129,8
5895,154,8344,674725,674879,8
9983,63,8352,288793,288856,8
2208,148,8355,674736,674884,8
7398,3,8356,62593,62596,8
8874,7,8357,62595,62602,8
1165,52,8362,288847,288899,8
9670,161,8367,674740,674901,8
5767,134,8420,674716,674850,8
5102,70,8444,288862,288932,8
4549,289,8468,1062941,1063230,8
6030,79,8472,288905,288984,8
9544,265,8472,959994,960259,8
2089,248,8473,960033,960281,8
1508,149,8482,674794,674943,8
9822,108,8485,493744,493852,8
4137,65,8487,289102,289167,8
1150,96,8501,493749,493845,8
4370,156,8508,674785,674941,8
9236,207,8520,830896,831103,8
6038,293,8539,1062886,1063179,8
1597,29,8553,63051,63080,8
6703,190,8559,830933,831123,8
5117,200,8573,830931,831131,8
2368,232,8588,959989,960221,8
8176,21,8634,63128,63149,8
1462,276,8661,1062784,1063060,8
5393,70,8687,289276,289346,8
2309,196,8725,830895,831091,8
7646,138,8733,674906,675044,8
1874,218,8743,830895,831113,8
2075,38,8749,63249,63287,8
2330,163,8750,674941,675104,8
1480,94,8751,494003,494097,8
2391,36,8754,63368,63404,8
7965,297,8766,1062682,1062979,8
1997,36,8769,63432,63468,8
2382,213,8774,830951,831164,8
1613,199,8805,830955,831154,8
8937,95,8820,494076,494171,8
6604,81,8823,289563,289644,8
2608,106,8833,494071,494177,8
9630,26,8835,63617,63643,8
7495,2,8844,63634,63636,8
2289,239,8864,959816,960055,8
1369,189,8883,830945,831134,8
6971,213,8905,830934,831147,8
5271,250,8944,959750,960000,8
2572,137,8948,675096,675233,8
7162,294,8949,1062523,1062817,8
1215,40,8950,63788,63828,8
2005,39,8973,63805,63844,8
3016,288,8973,1062520,1062808,8
6035,68,8977,289799,289867,8
7944,181,8993,831022,831203,8
3218,127,9002,494281,494408,8
6976,247,9004,959811,960058,8
5481,212,9019,831046,831258,8
8718,285,9028,1062480,1062765,8
7551,246,9030,959855,960101,8
9583,20,9044,64117,64137,8
9148,152,9046,675325,675477,8
1363,281,9047,1062473,1062754,8
9415,206,9052,831188,831394,8
4298,145,9090,675393,675538,8
7463,163,9095,675401,675564,8
5189,62,9110,290175,290237,8
2850,120,9138,494590,494710,8
8802,180,9144,831124,831304,8
2731,17,9174,64351,64368,8
9141,198,9185,831085,831283,8
2530,37,9186,64399,64436,8
6470,136,9188,675431,675567,8
3438,18,9192,64473,64491,8
9122,99,9194,494702,494801,8
9239,74,9212,290312,290386,8
3702,156,9241,675382,675538,8
5126,29,9253,64559,64588,8
5188,214,9253,831037,831251,8
3237,175,9261,675432,675607,8
5976,41,9264,64663,64704,8
6284,82,9271,290416,290498,8
8828,86,9275,290451,290537,8
5724,33,9287,64767,64800,8
3634,190,9309,831017,831207,8
3571,33,9375,64755,64788,8
3997,291,9401,1062127,1062418,8
8324,113,9405,494728,494841,8
7588,297,9421,1062125,1062422,8
6053,14,9434,64858,64872,8
3947,209,9435,830997,831206,8
1094,275,9445,1062125,1062400,8
8041,180,9445,831065,831245,8
8985,146,9452,675560,675706,8
5827,224,9456,831056,831280,8
3736,55,9472,290693,290748,8
5278,234,9473,959625,959859,8
2230,212,9494,831111,831323,8
9907,54,9501,290764,290818,8
8404,26,9509,65184,65210,8
2081,265,9529,959578,959843,8
6058,138,9542,675668,675806,8
9004,65,9586,290778,290843,8
9234,175,9614,675602,675777,8
9851,176,9642,675617,675793,8
3784,100,9668,495031,495131,8
6125,193,9671,831015,831208,8
1103,168,9673,675676,675844,8
7812,70,9673,290933,291003,8
2770,219,9684,831017,831236,8
8056,143,9690,675741,675884,8
1455,35,9738,65454,65489,8
9016,98,9751,495141,495239,8
9889,104,9761,495142,495246,8
6968,295,9769,1061803,1062098,8
7112,156,9776,675712,675868,8
4235,264,9792,959403,959667,8
7285,196,9821,831015,831211,8
5518,282,9856,1061738,1062020,8
3842,54,9867,291162,291216,8
7042,269,9877,959405,959674,8
1768,52,9879,291205,291257,8
9275,9,9890,65767,65776,8
9953,214,9892,831056,831270,8
5344,64,9912,291225,291289,8
7637,73,9931,291227,291300,8
6340,253,9939,959387,959640,8
3015,59,9968,291264,291323,8
3189,134,9975,675813,675947,8
4773,231,9976,959378,959609,8
8436,81,9981,291355,291436,8
6031,192,9984,831094,831286,8
6095,132,9988,495427,495559,8
8256,52,9995,291467,291519,8
1608,61,9998,291473,291534,8
933,80,106,301384,301464,9
391,241,229,969136,969377,9
703,34,245,76021,76055,9
101,277,265,1071344,1071621,9
233,211,272,840916,841127,9
132,20,332,76052,76072,9
633,180,353,840872,841052,9
968,81,354,301346,301427,9
719,166,454,685611,685777,9
463,282,496,1071123,1071405,9
901,207,520,840757,840964,9
839,5,532,76082,76087,9
193,253,556,968924,969177,9
683,177,711,840645,840822,9
114,202,892,840467,840669,9
9982,48,8003,293994,294042,9
3707,163,8016,678311,678474,9
6869,8,8033,68796,68804,9
8961,73,8087,293959,294032,9
8035,127,8108,497838,497965,9
4842,51,8119,294001,294052,9
3083,105,8145,497843,497948,9
9600,19,8149,68856,68875,9
3230,142,8169,678192,678334,9
2703,1,8180,68886,68887,9
3498,154,8190,678184,678338,9
6037,85,8193,294065,294150,9
3753,282,8200,1063434,1063716,9
1762,263,8217,961343,961606,9
4331,33,8228,69007,69040,9
7727,292,8243,1063406,1063698,9
2760,185,8245,833280,833465,9
5447,145,8246,678333,678478,9
9984,177,8251,833285,833462,9
8271,250,8260,961390,961640,9
9860,22,8275,69203,69225,9
5919,183,8280,833305,833488,9
3768,32,8281,69261,69293,9
9015,23,8290,69284,69307,9
8819,111,8314,498134,498245,9
3685,116,8327,498147,498263,9
2927,5,8345,69336,69341,9
1123,37,8364,69322,69359,9
9403,11,8389,69334,69345,9
9410,41,8405,69329,69370,9
7407,74,8412,294319,294393,9
2638,205,8420,833174,833379,9
9338,96,8436,498113,498209,9
6698,82,8438,294411,294493,9
3971,1,8458,69485,69486,9
5668,179,8458,833167,833346,9
6440,7,8464,69522,69529,9
9866,181,8489,833141,833322,9
5367,298,8494,1063180,1063478,9
9423,259,8516,961211,961470,9
1915,65,8550,294511,294576,9
6807,213,8551,833178,833391,9
2371,46,8562,294565,294611,9
5745,91,8562,498218,498309,9
2325,207,8571,833197,833404,9
7865,228,8573,961193,961421,9
7821,96,8578,498296,498392,9
6177,154,8594,678496,678650,9
9002,263,8595,961179,961442,9
1919,48,8604,294785,294833,9
3028,119,8617,498356,498475,9
5754,70,8623,294815,294885,9
1618,236,8632,961185,961421,9
5483,209,8635,833304,833513,9
4657,125,8662,498433,498558,9
1795,113,8677,498458,498571,9
5508,232,8710,961123,961355,9
1611,67,8730,294951,295018,9
1605,29,8736,70139,70168,9
7177,224,8739,961106,961330,9
4868,162,8740,678600,678762,9
3251,146,8760,678613,678759,9
8282,216,8778,833288,833504,9
1972,3,8810,70262,70265,9
4784,145,8850,678585,678730,9
5719,43,8884,295037,295080,9
5876,129,8899,498528,498657,9
4670,219,8909,833199,833418,9
8758,143,8916,678580,678723,9
4242,221,8932,960917,961138,9
7770,150,8934,678621,678771,9
1206,158,8936,678640,678798,9
5886,112,8937,498754,498866,9
6872,59,8949,295274,295333,9
3676,287,8951,1062754,1063041,9
4391,140,8955,678695,678835,9
6659,276,8989,1062736,1063012,9
5801,247,9008,960936,961183,9
7541,72,9017,295395,295467,9
5540,233,9023,960948,961181,9
2487,203,9041,833342,833545,9
8890,88,9058,498924,499012,9
8410,208,9075,833337,833545,9
2832,179,9092,833354,833533,9
5739,291,9117,1062617,1062908,9
7043,266,9117,960914,961180,9
3937,93,9131,499030,499123,9
4769,46,9136,295650,295696,9
6210,59,9136,295654,295713,9
2196,9,9138,70987,70996,9
9940,169,9170,678851,679020,9
2956,87,9177,499036,499123,9
4301,256,9182,960895,961151,9
3241,157,9198,678908,679065,9
8474,259,9205,960908,961167,9
5240,242,9230,960922,961164,9
8083,192,9242,833439,833631,9
8165,67,9264,295844,295911,9
1099,136,9270,678999,679135,9
5450,115,9280,499199,499314,9
5184,53,9287,295932,295985,9
4192,248,9297,960877,961125,9
8581,289,9300,1062458,1062747,9
6789,193,9342,833449,833642,9
1205,77,9351,296008,296085,9
9116,73,9352,296042,296115,9
5066,99,9367,499274,499373,9
1313,36,9368,71480,71516,9
1116,77,9374,296094,296171,9
7222,53,9425,296078,296131,9
2463,76,9431,296083,296159,9
6610,18,9443,71567,71585,9
5111,163,9456,678955,679118,9
9884,128,9467,499232,499360,9
8300,61,9476,296158,296219,9
9810,78,9495,296158,296236,9
1375,183,9497,833313,833496,9
1034,30,9515,71723,71753,9
9510,206,9524,833295,833501,9
5968,51,9557,296218,296269,9
7691,15,9576,71776,71791,9
5604,122,9577,499253,499375,9
1810,49,9584,296243,296292,9
2338,294,9584,1062196,1062490,9
8368,191,9587,833310,833501,9
3742,163,9591,679034,679197,9
5051,152,9598,679061,679213,9
7308,85,9601,296405,296490,9
7468,232,9615,960681,960913,9
8073,161,9625,679102,679263,9
5223,268,9631,1062176,1062444,9
9624,170,9633,679171,679341,9
1283,212,9639,833367,833579,9
7920,224,9645,960710,960934,9
9331,73,9648,296659,296732,9
2091,41,9651,72304,72345,9
1949,273,9658,1062150,1062423,9
1293,232,9674,960732,960964,9
8059,85,9674,296750,296835,9
5428,180,9691,833491,833671,9
4221,223,9700,960718,960941,9
8456,159,9708,679407,679566,9
6153,106,9723,499804,499910,9
5192,69,9736,296903,296972,9
1442,227,9756,960665,960892,9
6476,149,9794,679396,679545,9
1693,259,9798,960630,960889,9
2903,160,9824,679431,679591,9
1699,119,9843,499881,500000,9
1257,279,9850,1061964,1062243,9
4976,235,9857,960657,960892,9
8218,202,9878,833540,833742,9
2181,142,9884,679537,679679,9
5590,67,9890,297163,297230,9
9035,298,9898,1061928,1062226,9
5602,71,9905,297216,297287,9
9377,224,9911,960665,960889,9
2341,283,9914,1061943,1062226,9
3760,174,9947,679622,679796,9
9838,85,9951,297328,297413,9
1943,136,9954,679660,679796,9
6339,15,9961,73085,73100,9
5676,202,9978,833606,833808,9
8754,228,9984,960643,960871,9
4591,79,9985,297466,297545,9
1013,246,9988,960647,960893,9
675,299,109,1071770,1072069,10
460,116,124,510207,510323,10
525,33,139,83172,83205,10
604,66,227,307389,307455,10
386,173,272,843481,843654,10
586,275,381,1071536,1071811,10
244,133,453,689438,689571,10
401,248,521,970237,970485,10
831,297,523,1071408,1071705,10
275,31,576,83014,83045,10
969,157,684,689302,689459,10
906,159,788,689229,689388,10
479,300,809,1071158,1071458,10
444,4,960,82784,82788,10
228,170,971,689123,689293,10
328,98,994,509757,509855,10
699,92,999,509767,509859,10
3049,218,8010,962873,963091,10
6452,2,8022,75890,75892,10
3881,46,8057,300088,300134,10
9669,246,8058,962828,963074,10
3424,138,8101,682125,682263,10
4756,230,8104,962813,963043,10
6627,243,8118,962814,963057,10
5496,290,8123,1063883,1064173,10
1686,35,8127,76033,76068,10
2083,206,8133,836028,836234,10
2880,124,8161,502915,503039,10
1703,138,8167,682247,682385,10
9726,88,8177,502983,503071,10
7012,90,8189,502976,503066,10
5191,186,8200,835997,836183,10
7275,190,8200,836013,836203,10
3594,248,8201,962805,963053,10
3249,241,8211,962828,963069,10
3370,121,8269,503075,503196,10
7608,87,8290,503092,503179,10
1705,35,8306,76340,76375,10
2597,147,8338,682264,682411,10
5470,72,8349,300515,300587,10
2264,184,8352,835971,836155,10
1377,46,8366,300571,300617,10
1667,291,8368,1063667,1063958,10
4633,151,8369,682342,682493,10
5523,121,8376,503182,503303,10
1979,173,8379,836003,836176,10
8060,260,8384,962727,962987,10
4946,286,8390,1063675,1063961,10
1049,235,8416,962786,963021,10
9179,275,8424,1063666,1063941,10
2918,2,8438,76735,76737,10
7136,57,8455,300823,300880,10
2198,66,8466,300828,300894,10
3781,95,8466,503345,503440,10
2515,192,8495,836070,836262,10
4704,134,8501,682499,682633,10
9793,175,8511,836076,836251,10
1861,192,8542,836050,836242,10
4060,43,8549,300980,301023,10
2039,235,8551,962717,962952,10
7278,213,8557,836102,836315,10
5350,220,8558,962730,962950,10
7748,180,8561,836186,836366,10
1228,247,8575,962718,962965,10
4112,290,8581,1063523,1063813,10
3125,168,8586,682774,682942,10
7683,172,8593,836254,836426,10
4356,150,8596,682850,683000,10
9832,13,8606,77266,77279,10
2773,89,8612,503770,503859,10
4617,36,8623,77303,77339,10
4927,52,8623,301328,301380,10
7030,48,8627,301335,301383,10
1096,204,8645,836204,836408,10
5366,165,8653,682861,683026,10
1086,93,8658,503816,503909,10
3400,290,8661,1063472,1063762,10
1996,257,8678,962739,962996,10
4897,38,8678,77571,77609,10
3598,64,8696,301483,301547,10
6444,242,8722,962737,962979,10
8392,64,8724,301520,301584,10
4069,182,8731,836287,836469,10
7204,233,8738,962748,962981,10
8749,43,8740,301611,301654,10
7514,139,8743,683030,683169,10
3592,229,8765,962739,962968,10
3156,267,8804,1063358,1063625,10
9995,168,8805,683069,683237,10
2825,129,8826,683090,683219,10
9417,38,8829,77909,77947,10
2241,104,8836,504078,504182,10
8837,32,8843,77974,78006,10
7358,11,8851,77998,78009,10
9808,53,8855,301750,301803,10
5434,243,8874,962690,962933,10
1927,122,8908,504070,504192,10
4204,44,8927,301774,301818,10
3945,34,8928,78096,78130,10
1353,254,8929,962663,962917,10
5258,259,8946,962685,962944,10
1956,32,8956,78184,78216,10
6792,66,8969,301819,301885,10
5091,283,8977,1063191,1063474,10
8876,269,8986,1063204,1063473,10
6724,63,8995,301902,301965,10
8673,121,9011,504178,504299,10
1930,221,9017,962750,962971,10
9034,214,9034,836401,836615,10
6164,187,9040,836439,836626,10
7304,31,9047,78453,78484,10
9811,101,9054,504302,504403,10
8668,59,9059,302070,302129,10
5704,143,9064,683207,683350,10
6605,269,9070,1063128,1063397,10
6771,298,9071,1063135,1063433,10
3729,30,9089,78647,78677,10
7016,125,9094,504409,504534,10
2667,140,9125,683251,683391,10
1961,128,9139,683251,683379,10
1146,125,9146,504485,504610,10
7769,200,9167,836419,836619,10
5583,232,9194,962671,962903,10
7669,107,9206,504553,504660,10
8310,64,9222,302345,302409,10
4691,167,9237,683243,683410,10
5332,265,9238,1063005,1063270,10
6397,293,9245,1063002,1063295,10
4102,260,9247,962727,962987,10
1678,206,9260,836536,836742,10
5418,227,9270,962749,962976,10
4890,127,9284,683457,683584,10
4159,123,9287,504797,504920,10
8895,220,9295,962736,962956,10
3221,260,9297,962739,962999,10
7565,227,9317,962764,962991,10
9327,65,9320,302732,302797,10
1171,264,9324,1062955,1063219,10
6608,174,9327,836730,836904,10
8921,53,9341,302819,302872,10
5986,204,9344,836717,836921,10
3786,234,9373,962766,963000,10
9534,39,9377,79414,79453,10
3468,141,9402,683648,683789,10
5554,242,9417,962741,962983,10
9966,124,9420,505091,505215,10
8293,133,9433,683676,683809,10
9488,191,9433,836752,836943,10
2780,242,9470,962715,962957,10
8869,142,9492,683712,683854,10
4215,292,9496,1062786,1063078,10
4567,230,9498,962760,962990,10
1335,270,9505,1062808,1063078,10
9778,30,9511,79729,79759,10
6182,14,9556,79714,79728,10
4371,125,9560,505293,505418,10
4514,253,9572,962747,963000,10
3171,14,9574,79792,79806,10
1242,240,9576,962781,963021,10
1822,11,9580,79841,79852,10
7449,141,9584,683856,683997,10
3431,282,9587,1062735,1063017,10
6588,247,9653,962775,963022,10
2612,100,9707,505403,505503,10
7218,22,9712,79884,79906,10
3554,196,9718,836848,837044,10
9340,174,9749,836843,837017,10
1485,144,9753,683878,684022,10
8834,25,9763,79978,80003,10
8763,185,9817,836779,836964,10
7807,60,9821,303317,303377,10
8486,216,9821,962639,962855,10
9609,145,9822,683915,684060,10
3043,169,9825,683931,684100,10
9389,209,9827,836829,837038,10
5578,129,9845,683998,684127,10
4656,246,9894,962567,962813,10
3079,133,9912,683978,684111,10
9861,66,9921,303530,303596,10
4424,37,9923,80253,80290,10
2842,134,9924,683973,684107,10
5206,131,9947,683958,684089,10
7220,14,9969,80326,80340,10
1497,268,9988,1062355,1062623,10
5730,163,9988,683966,684129,10
860,235,85,972458,972693,11
209,180,183,846650,846830,11
301,164,290,693790,693954,11
585,97,319,515581,515678,11
701,70,348,313461,313531,11
258,224,373,972195,972419,11
365,145,382,693782,693927,11
746,123,418,515582,515705,11
448,285,425,1071931,1072216,11
735,93,429,515655,515748,11
409,68,466,313578,313646,11
930,36,497,90334,90370,11
621,2,599,90268,90270,11
507,143,654,693575,693718,11
434,237,680,971947,972184,11
737,145,742,693550,693695,11
917,56,746,313449,313505,11
911,294,752,1071634,1071928,11
980,229,788,971911,972140,11
768,267,903,1071522,1071789,11
232,55,940,313394,313449,11
127,15,994,90195,90210,11
516,15,998,90206,90221,11
9191,157,8008,686435,686592,11
2348,43,8011,306379,306422,11
1230,19,8044,83255,83274,11
1378,184,8052,839059,839243,11
4037,217,8074,964689,964906,11
6024,218,8114,964656,964874,11
7464,101,8131,508385,508486,11
1426,238,8133,964645,964883,11
9194,281,8154,1064283,1064564,11
1124,127,8180,686512,686639,11
6222,177,8187,839118,839295,11
7582,190,8187,839129,839319,11
6739,109,8194,508552,508661,11
2044,71,8204,306599,306670,11
9273,42,8257,306577,306619,11
4864,152,8276,686506,686658,11
3581,264,8294,1064169,1064433,11
4569,93,8302,508556,508649,11
5030,192,8303,839081,839273,11
8680,215,8305,964591,964806,11
2599,234,8316,964585,964819,11
7223,245,8327,964598,964843,11
4384,102,8357,508681,508783,11
1918,258,8360,1064112,1064370,11
8564,135,8365,686704,686839,11
9521,82,8376,508767,508849,11
7712,282,8380,1064095,1064377,11
6122,71,8381,306947,307018,11
6596,226,8412,964638,964864,11
6351,280,8418,1064084,1064364,11
3629,65,8427,307014,307079,11
3207,160,8430,686780,686940,11
3663,152,8431,686816,686968,11
2024,20,8436,84082,84102,11
9205,22,8446,84092,84114,11
5597,69,8451,307097,307166,11
2776,242,8453,964658,964900,11
3116,280,8456,1064071,1064351,11
8548,22,8466,84214,84236,11
9629,121,8471,508967,509088,11
1167,203,8484,839322,839525,11
7723,161,8486,686919,687080,11
4731,120,8490,509072,509192,11
4627,23,8520,84342,84365,11
1523,271,8525,1064027,1064298,11
6045,98,8536,509107,509205,11
2387,17,8555,84410,84427,11
3758,187,8560,839327,839514,11
7579,39,8571,84451,84490,11
9383,170,8596,839312,839482,11
7801,179,8609,839303,839482,11
8609,17,8611,84530,84547,11
6215,164,8616,686999,687163,11
8580,54,8630,307439,307493,11
8115,36,8632,84606,84642,11
2373,92,8633,509195,509287,11
2240,47,8673,307451,307498,11
9733,81,8699,307432,307513,11
2128,111,8714,509125,509236,11
5441,117,8720,509149,509266,11
8006,177,8738,839187,839364,11
8651,242,8738,964495,964737,11
6841,143,8742,687000,687143,11
4129,272,8757,1063811,1064083,11
5214,17,8769,84865,84882,11
6039,209,8808,839216,839425,11
4184,78,8810,307649,307727,11
3100,218,8811,964499,964717,11
4516,263,8814,1063771,1064034,11
7967,281,8830,1063763,1064044,11
2471,245,8842,964566,964811,11
8920,80,8848,307813,307893,11
4783,217,8851,964592,964809,11
8787,191,8880,839407,839598,11
1075,88,8899,509468,509556,11
2562,228,8908,964542,964770,11
2053,31,8914,85177,85208,11
5210,14,8918,85204,85218,11
6428,175,8941,839415,839590,11
3095,149,8942,687250,687399,11
4337,243,8943,964525,964768,11
6742,198,8947,839462,839660,11
2269,214,8954,964547,964761,11
1388,158,8964,687383,687541,11
2913,161,8969,687413,687574,11
9023,65,8973,308179,308244,11
9076,96,8983,509727,509823,11
2734,155,8984,687436,687591,11
2231,20,8988,85548,85568,11
9665,137,8991,687461,687598,11
1689,134,8996,687470,687604,11
3184,40,9002,85634,85674,11
5965,99,9019,509832,509931,11
2649,213,9040,964465,964678,11
1433,197,9044,839485,839682,11
7282,233,9064,964444,964677,11
2329,135,9098,687508,687643,11
1546,3,9138,85738,85741,11
7366,272,9153,1063466,1063738,11
9226,144,9180,687481,687625,11
6028,144,9198,687484,687628,11
7675,68,9200,308469,308537,11
4823,227,9211,964365,964592,11
4124,24,9241,85838,85862,11
4660,228,9243,964350,964578,11
5980,262,9274,1063362,1063624,11
7863,94,9274,510015,510109,11
5077,298,9302,1063341,1063639,11
1308,61,9319,308583,308644,11
7229,290,9322,1063364,1063654,11
7656,150,9355,687563,687713,11
3556,224,9363,964383,964607,11
7524,247,9370,964390,964637,11
6743,22,9400,86063,86085,11
1247,150,9404,687627,687777,11
9684,219,9418,964379,964598,11
4285,239,9420,964386,964625,11
4610,283,9424,1063297,1063580,11
9428,211,9434,964446,964657,11
6643,201,9444,839688,839889,11
7269,121,9458,510306,510427,11
9605,71,9475,308899,308970,11
6055,5,9486,86319,86324,11
5769,140,9489,687784,687924,11
5325,56,9494,308952,309008,11
6041,147,9500,687790,687937,11
1629,245,9512,964369,964614,11
1970,300,9528,1063221,1063521,11
5429,23,9529,86481,86504,11
6478,24,9555,86478,86502,11
9175,218,9567,964394,964612,11
6818,223,9575,964394,964617,11
1772,189,9590,839753,839942,11
4225,108,9590,510508,510616,11
3739,135,9603,687926,688061,11
3149,255,9607,964375,964630,11
8889,292,9608,1063186,1063478,11
8998,246,9611,964461,964707,11
2689,142,9614,688056,688198,11
9204,45,9632,309322,309367,11
6094,91,9633,510702,510793,11
5658,157,9641,688048,688205,11
8688,29,9643,86894,86923,11
5560,84,9671,510716,510800,11
6913,279,9722,1063109,1063388,11
4824,37,9724,86922,86959,11
4377,88,9730,510702,510790,11
5151,163,9742,688024,688187,11
3955,285,9749,1063106,1063391,11
5600,93,9749,510774,510867,11
1884,207,9753,839833,840040,11
7434,146,9753,688139,688285,11
6803,94,9774,510845,510939,11
5880,179,9787,839840,840019,11
5742,8,9797,87206,87214,11
2314,49,9806,309645,309694,11
3401,189,9812,839828,840017,11
7502,185,9814,839849,840034,11
1574,71,9850,309692,309763,11
7437,266,9856,1063029,1063295,11
6697,216,9862,964381,964597,11
2720,171,9870,839900,840071,11
4896,91,9872,511012,511103,11
4738,245,9883,964366,964611,11
9231,140,9884,688332,688472,11
7480,114,9885,511093,511207,11
2574,233,9896,964388,964621,11
4461,237,9910,964397,964634,11
7716,280,9941,1062955,1063235,11
4958,95,9946,511191,511286,11
6203,15,9952,87659,87674,11
9667,96,9952,511199,511295,11
8381,95,9964,511202,511297,11
3524,234,9972,964407,964641,11
5041,218,9975,964428,964646,11
2767,128,9986,688462,688590,11
4755,198,9986,840053,840251,11
6535,167,9988,840083,840250,11
5079,234,9990,964421,964655,11
1922,108,9994,511438,511546,11
823,14,77,97909,97923,12
308,164,140,849980,850144,12
521,233,177,974263,974496,12
996,162,225,698444,698606,12
189,279,260,1072667,1072946,12
949,64,275,320279,320343,12
927,92,341,521284,521376,12
705,98,375,521263,521361,12
176,160,376,698377,698537,12
171,233,379,974133,974366,12
940,237,406,974134,974371,12
973,115,419,521361,521476,12
347,58,524,320295,320353,12
447,29,637,97831,97860,12
638,45,651,320187,320232,12
710,194,831,849463,849657,12
895,42,951,319933,319975,12
825,162,957,697962,698124,12
745,82,996,520902,520984,12
1750,296,8069,1145474,1145770,12
4274,236,8082,966534,966770,12
1302,88,8088,513895,513983,12
3952,169,8130,842282,842451,12
9769,225,8144,966503,966728,12
9759,162,8151,690978,691140,12
5362,61,8160,313047,313108,12
7756,117,8167,513948,514065,12
6603,62,8185,313084,313146,12
7556,55,8196,313096,313151,12
7347,209,8199,966468,966677,12
8739,283,8206,1064796,1065079,12
8438,34,8226,90934,90968,12
7599,282,8230,1064806,1065088,12
3440,153,8233,691064,691217,12
8045,98,8250,514067,514165,12
6472,243,8271,966488,966731,12
5778,151,8285,691087,691238,12
5736,218,8304,966493,966711,12
3007,98,8306,514153,514251,12
3832,258,8308,1064761,1065019,12
4687,135,8318,691169,691304,12
3025,122,8320,691182,691304,12
6539,251,8321,1064757,1065008,12
7810,211,8343,966555,966766,12
4720,275,8349,1064731,1065006,12
1481,86,8354,514370,514456,12
4726,153,8403,691227,691380,12
2109,54,8410,313578,313632,12
9117,56,8411,313592,313648,12
4245,80,8433,514339,514419,12
7097,63,8468,313592,313655,12
4016,138,8478,691185,691323,12
8666,139,8493,691188,691327,12
2163,102,8497,514358,514460,12
3705,205,8529,842320,842525,12
3235,131,8536,691206,691337,12
3190,156,8552,691201,691357,12
5351,37,8565,91604,91641,12
8722,62,8571,313753,313815,12
9840,163,8574,842318,842481,12
5014,113,8576,514466,514579,12
2292,83,8584,514492,514575,12
4532,215,8605,966343,966558,12
9373,266,8619,1064487,1064753,12
4194,169,8641,842338,842507,12
5773,167,8653,842333,842500,12
2173,285,8667,1064456,1064741,12
4222,67,8683,313984,314051,12
9109,20,8705,91891,91911,12
4669,207,8706,966340,966547,12
2178,170,8708,842369,842539,12
1697,5,8730,91964,91969,12
5480,54,8732,314043,314097,12
2959,67,8733,314057,314124,12
1443,67,8740,314078,314145,12
5756,220,8743,966305,966525,12
5276,281,8747,1064412,1064693,12
6292,240,8784,966323,966563,12
9131,271,8802,1064389,1064660,12
2969,109,8814,514717,514826,12
7277,128,8843,691450,691578,12
5018,298,8847,1144698,1144996,12
3551,47,8871,314255,314302,12
6982,153,8871,691472,691625,12
2085,41,8876,314298,314339,12
4263,23,8881,92325,92348,12
4640,182,8893,842407,842589,12
9136,300,8899,1144650,1144950,12
9180,259,8904,1064399,1064658,12
2247,283,8905,1064408,1064691,12
5738,209,8907,966455,966664,12
5387,244,8912,966454,966698,12
6611,139,8941,691687,691826,12
5625,54,8945,314511,314565,12
1500,240,8953,966452,966692,12
7354,116,8958,515054,515170,12
1811,253,8963,1064384,1064637,12
5511,48,8965,314626,314674,12
7508,288,8979,1064372,1064660,12
3789,299,8985,1144570,1144869,12
4132,46,8999,314681,314727,12
3482,73,9005,314682,314755,12
9801,45,9039,314682,314727,12
3071,107,9041,515131,515238,12
3920,142,9042,691773,691915,12
5183,202,9051,842656,842858,12
9496,202,9063,842684,842886,12
6966,214,9093,966479,966693,12
5187,160,9094,691869,692029,12
1027,221,9105,966476,966697,12
5474,201,9136,842737,842938,12
4011,292,9139,1064296,1064588,12
7918,118,9176,515352,515470,12
9216,130,9182,691947,692077,12
1607,156,9196,691943,692099,12
6615,253,9212,1064266,1064519,12
9896,258,9217,1064265,1064523,12
9166,82,9219,515512,515594,12
4753,50,9235,315092,315142,12
1301,155,9252,692007,692162,12
6655,13,9264,93291,93304,12
3682,283,9273,1064218,1064501,12
5945,5,9278,93329,93334,12
9003,2,9283,93329,93331,12
3375,172,9291,842793,842965,12
8025,254,9294,1064231,1064485,12
6536,40,9295,315203,315243,12
8923,89,9300,515598,515687,12
9627,149,9329,692091,692240,12
8223,138,9337,692112,692250,12
4779,170,9362,842775,842945,12
1631,69,9375,315284,315353,12
4507,76,9377,315312,315388,12
7783,76,9381,315345,315421,12
3780,175,9383,842762,842937,12
6753,176,9396,842762,842938,12
8302,117,9422,515691,515808,12
8318,153,9431,692162,692315,12
4500,204,9484,842688,842892,12
2542,4,9509,93690,93694,12
9241,203,9510,842704,842907,12
1715,107,9514,515760,515867,12
8704,211,9544,966273,966484,12
5484,201,9549,842749,842950,12
9097,67,9562,315561,315628,12
7392,235,9567,966256,966491,12
2876,33,9577,93860,93893,12
6212,138,9577,692259,692397,12
7532,61,9596,315635,315696,12
7547,206,9607,966246,966452,12
7086,9,9625,93962,93971,12
3961,244,9631,966223,966467,12
4003,266,9634,1063896,1064162,12
7525,263,9656,1063891,1064154,12
7298,193,9657,842895,843088,12
3103,60,9677,315776,315836,12
9378,64,9701,315773,315837,12
8337,222,9706,966275,966497,12
7798,11,9715,94154,94165,12
6667,230,9716,966282,966512,12
1042,203,9736,842933,843136,12
8898,280,9766,1063795,1064075,12
4568,290,9770,1063822,1064112,12
4573,72,9805,315894,315966,12
1812,35,9833,94242,94277,12
8854,70,9836,315896,315966,12
7966,245,9842,966269,966514,12
2671,277,9849,1063784,1064061,12
4703,77,9849,315994,316071,12
8541,221,9873,966322,966543,12
5662,87,9902,516097,516184,12
6315,34,9906,94438,94472,12
5174,145,9931,692469,692614,12
5445,124,9938,692487,692611,12
7253,19,9938,94518,94537,12
7259,26,9939,94536,94562,12
8408,148,9945,692484,692632,12
4354,206,9946,966265,966471,12
5261,218,9954,966258,966476,12
5056,204,9983,843028,843232,12
7930,162,9990,692593,692755,12
997,246,195,1073472,1073718,13
812,12,236,104498,104510,13
594,34,249,104497,104531,13
167,217,332,975941,976158,13
362,93,357,526019,526112,13
662,177,523,852618,852795,13
486,92,544,525888,525980,13
255,258,578,1073092,1073350,13
824,245,595,1073090,1073335,13
610,17,604,104404,104421,13
611,9,614,104411,104420,13
828,163,654,852590,852753,13
690,151,693,702181,702332,13
466,260,772,1072915,1073175,13
848,76,775,325857,325933,13
978,134,785,702164,702298,13
868,26,807,104417,104443,13
544,195,829,852462,852657,13
117,93,861,525866,525959,13
220,299,921,1152646,1152945,13
187,177,969,852401,852578,13
8887,133,8002,695087,695220,13
6143,203,8011,968451,968654,13
5688,18,8020,97458,97476,13
4477,257,8022,1065726,1065983,13
1002,290,8039,1145540,1145830,13
9660,100,8048,518935,519035,13
1189,170,8050,845465,845635,13
2063,98,8065,518981,519079,13
5471,190,8073,845454,845644,13
4367,87,8076,519031,519118,13
8106,257,8076,1065730,1065987,13
4841,105,8078,519079,519184,13
1991,145,8084,695267,695412,13
2404,265,8086,1065734,1065999,13
6801,253,8091,1065751,1066004,13
7696,235,8095,968585,968820,13
7902,57,8106,319344,319401,13
6495,88,8115,519230,519318,13
9974,70,8117,319391,319461,13
1420,69,8144,319396,319465,13
9830,179,8148,845579,845758,13
7914,71,8183,319427,319498,13
3412,131,8188,695355,695486,13
2615,42,8241,319441,319483,13
9242,293,8262,1145320,1145613,13
6497,126,8291,695307,695433,13
3284,26,8293,98077,98103,13
2661,284,8305,1065591,1065875,13
4956,219,8316,968485,968704,13
3330,260,8326,1065611,1065871,13
3212,201,8328,968535,968736,13
5322,248,8342,1065612,1065860,13
2792,91,8343,519373,519464,13
3795,254,8357,1065602,1065856,13
7323,10,8401,98261,98271,13
2482,299,8412,1145176,1145475,13
5419,112,8422,519388,519500,13
1553,205,8438,968555,968760,13
2950,89,8442,519443,519532,13
1698,74,8467,319726,319800,13
7679,153,8468,695467,695620,13
3094,217,8469,968529,968746,13
7379,239,8486,968529,968768,13
5856,212,8512,968542,968754,13
2354,239,8524,968542,968781,13
7180,158,8525,695610,695768,13
2700,92,8550,519587,519679,13
1177,93,8573,519579,519672,13
1329,90,8584,519584,519674,13
7603,242,8584,968521,968763,13
2031,27,8585,98657,98684,13
3659,136,8603,695614,695750,13
4932,175,8606,845730,845905,13
6623,248,8644,1065370,1065618,13
5347,165,8660,845735,845900,13
7065,96,8667,519714,519810,13
3734,238,8690,968500,968738,13
1957,44,8693,320160,320204,13
3731,275,8694,1065325,1065600,13
1969,258,8700,1065351,1065609,13
3105,7,8710,98901,98908,13
7936,120,8717,695765,695885,13
1284,247,8725,1065341,1065588,13
1880,294,8736,1144864,1145158,13
5959,184,8741,845871,846055,13
7401,146,8751,695857,696003,13
4963,267,8759,1065355,1065622,13
7983,121,8759,695919,696040,13
6990,206,8777,968666,968872,13
5848,226,8784,968665,968891,13
3908,200,8788,845976,846176,13
7260,79,8793,520127,520206,13
1256,115,8819,520103,520218,13
7512,22,8825,99249,99271,13
6303,50,8836,320569,320619,13
4043,11,8854,99280,99291,13
3642,11,8863,99282,99293,13
9146,49,8870,320547,320596,13
5973,245,8891,1065247,1065492,13
8594,30,8902,99330,99360,13
4804,16,8903,99359,99375,13
6766,14,8905,99373,99387,13
6074,39,8915,320552,320591,13
9648,128,8925,695921,696049,13
1047,258,8935,1065205,1065463,13
4776,34,8973,99433,99467,13
3930,90,8982,520098,520188,13
8471,285,8988,1065167,1065452,13
8655,140,9007,695932,696072,13
5133,118,9012,695950,696068,13
1933,160,9013,845919,846079,13
6987,136,9017,695987,696123,13
2620,295,9052,1144555,1144850,13
4258,152,9053,696011,696163,13
5033,210,9058,968589,968799,13
2965,214,9066,968591,968805,13
6451,203,9078,968593,968796,13
2220,295,9129,1144486,1144781,13
8783,242,9138,968579,968821,13
6994,160,9150,846036,846196,13
1180,73,9151,320941,321014,13
1529,237,9153,968606,968843,13
9672,49,9154,321012,321061,13
8789,279,9170,1065115,1065394,13
9154,48,9191,321025,321073,13
7236,219,9202,968637,968856,13
5748,277,9221,1065100,1065377,13
5999,72,9230,321074,321146,13
1156,118,9231,696278,696396,13
9573,295,9251,1144372,1144667,13
2110,206,9253,968691,968897,13
8397,58,9258,321197,321255,13
1620,152,9268,696324,696476,13
5584,239,9320,968630,968869,13
4745,142,9340,696328,696470,13
8823,194,9357,846125,846319,13
9217,232,9361,968628,968860,13
2764,284,9387,1065012,1065296,13
5674,223,9398,968666,968889,13
1465,101,9420,520753,520854,13
1645,273,9432,1065008,1065281,13
3054,239,9456,968674,968913,13
4075,61,9458,321407,321468,13
9661,258,9465,1065005,1065263,13
1458,237,9538,968674,968911,13
4794,178,9546,846266,846444,13
1224,215,9555,968694,968909,13
6003,123,9567,696536,696659,13
6071,128,9573,696536,696664,13
6455,166,9574,846300,846466,13
4062,2,9579,100533,100535,13
4994,30,9594,100520,100550,13
6089,211,9643,968621,968832,13
9749,191,9663,846261,846452,13
2276,167,9701,846256,846423,13
7859,11,9701,100557,100568,13
8630,203,9714,968561,968764,13
6490,131,9729,696596,696727,13
1521,105,9736,521021,521126,13
6576,45,9736,321659,321704,13
1018,179,9740,846268,846447,13
7702,172,9741,846288,846460,13
3374,233,9753,968525,968758,13
1288,89,9767,521138,521227,13
9195,201,9774,968537,968738,13
8521,43,9797,321800,321843,13
9422,289,9804,1143827,1144116,13
1602,259,9806,1064723,1064982,13
9063,202,9810,968588,968790,13
2543,235,9823,968577,968812,13
8734,132,9841,696826,696958,13
1786,281,9848,1064697,1064978,13
2443,217,9900,968578,968795,13
3726,35,9905,101010,101045,13
2353,285,9917,1064666,1064951,13
3567,130,9922,696883,697013,13
4639,108,9946,521371,521479,13
2557,136,9973,696845,696981,13
1724,205,9987,968551,968756,13
7192,236,9987,968556,968792,13
162,209,174,978410,978619,14
659,1,187,111028,111029,14
880,12,235,110981,110993,14
926,1,274,110954,110955,14
656,94,412,531097,531191,14
1000,80,671,530857,530937,14
235,166,742,855808,855974,14
665,3,773,110567,110570,14
128,6,815,110528,110534,14
248,121,903,706099,706220,14
913,146,911,706098,706244,14
698,48,944,331394,331442,14
6904,251,8048,1066583,1066834,14
6822,69,8055,324332,324401,14
1785,155,8059,848544,848699,14
9256,201,8070,970570,970771,14
8586,45,8093,324402,324447,14
6381,82,8109,523658,523740,14
2624,68,8130,324411,324479,14
8422,167,8141,848504,848671,14
4348,209,8145,970501,970710,14
5803,221,8153,970507,970728,14
9577,170,8166,848574,848744,14
7280,285,8172,1145468,1145753,14
3709,257,8183,1066505,1066762,14
4099,84,8219,523789,523873,14
4940,182,8226,848612,848794,14
9612,153,8250,699191,699344,14
6002,80,8268,523827,523907,14
8610,195,8270,848596,848791,14
3665,112,8272,523867,523979,14
6243,34,8291,103872,103906,14
6184,191,8301,848606,848797,14
2500,126,8316,699244,699370,14
3275,200,8324,970446,970646,14
7291,285,8329,1145316,1145601,14
2748,170,8369,848657,848827,14
3288,119,8396,699296,699415,14
6866,44,8436,324820,324864,14
4380,54,8438,324825,324879,14
8482,296,8455,1145195,1145491,14
4878,230,8456,970403,970633,14
5871,291,8470,1145196,1145487,14
7527,51,8470,324924,324975,14
4911,83,8473,524054,524137,14
7375,80,8474,524061,524141,14
3223,145,8505,699312,699457,14
5759,297,8512,1145165,1145462,14
7946,79,8512,524106,524185,14
9346,47,8524,325074,325121,14
4012,140,8540,699348,699488,14
8050,190,8551,848655,848845,14
2702,297,8558,1145136,1145433,14
2538,212,8565,970455,970667,14
4096,104,8572,524206,524310,14
7274,98,8579,524228,524326,14
7105,18,8580,104505,104523,14
9442,125,8607,699427,699552,14
5383,64,8618,325256,325320,14
1243,256,8619,1066304,1066560,14
3815,186,8621,848744,848930,14
2678,70,8628,325349,325419,14
2573,173,8630,848767,848940,14
9831,2,8633,104692,104694,14
9114,87,8636,524350,524437,14
9393,73,8640,325446,325519,14
9320,155,8655,848761,848916,14
6599,204,8660,970419,970623,14
9193,214,8661,970427,970641,14
2134,26,8663,104849,104875,14
9222,154,8669,699616,699770,14
1498,299,8712,1144999,1145298,14
4151,204,8722,970427,970631,14
6414,207,8744,970414,970621,14
3656,58,8766,325622,325680,14
9143,176,8767,848855,849031,14
2964,284,8771,1144959,1145243,14
9128,175,8775,848910,849085,14
3873,51,8785,325738,325789,14
8632,266,8787,1066241,1066507,14
9186,26,8787,105121,105147,14
4821,125,8790,699815,699940,14
8547,51,8801,325812,325863,14
6557,3,8804,105204,105207,14
2958,189,8810,848937,849126,14
2857,47,8812,325853,325900,14
3723,211,8843,970411,970622,14
4113,12,8848,105274,105286,14
9856,40,8850,325863,325903,14
2310,164,8855,848968,849132,14
3792,285,8859,1144875,1145160,14
4739,270,8864,1066236,1066506,14
1351,7,8868,105414,105421,14
8546,222,8911,970443,970665,14
9515,215,8916,970465,970680,14
2812,2,8936,105427,105429,14
1202,222,8937,970464,970686,14
7183,36,8940,105462,105498,14
5758,198,8945,970483,970681,14
6427,133,8946,700030,700163,14
6133,254,8958,1066175,1066429,14
5711,240,8964,1066186,1066426,14
3376,165,8981,849180,849345,14
1338,245,8989,1066164,1066409,14
6140,54,8990,326182,326236,14
2361,29,8995,105702,105731,14
4224,144,9001,700154,700298,14
5493,230,9001,970556,970786,14
1604,233,9002,970590,970823,14
3423,126,9003,700262,700388,14
7759,126,9007,700270,700396,14
8248,249,9014,1066147,1066396,14
7018,229,9016,970656,970885,14
9912,290,9025,1144714,1145004,14
6664,72,9026,326467,326539,14
8207,130,9034,700375,700505,14
8851,1,9042,106054,106055,14
1544,202,9069,970679,970881,14
1784,225,9072,970683,970908,14
2707,11,9074,106097,106108,14
9553,202,9099,970686,970888,14
8311,248,9118,1066098,1066346,14
6156,152,9122,700463,700615,14
7720,299,9128,1144621,1144920,14
3730,171,9130,849493,849664,14
5342,163,9143,849497,849660,14
1685,291,9144,1144624,1144915,14
7099,268,9156,1066157,1066425,14
8442,296,9157,1144622,1144918,14
5679,183,9187,849585,849768,14
7990,183,9222,849579,849762,14
1087,116,9224,700719,700835,14
6392,278,9225,1066162,1066440,14
5860,50,9241,326895,326945,14
6593,284,9257,1144538,1144822,14
5376,14,9259,106478,106492,14
7741,65,9269,326918,326983,14
4566,195,9278,849634,849829,14
2898,174,9305,849648,849822,14
2669,101,9317,525748,525849,14
6297,219,9321,970765,970984,14
5950,8,9322,106614,106622,14
2099,210,9334,970776,970986,14
1518,300,9335,1144464,1144764,14
3993,92,9336,525872,525964,14
7249,228,9341,970826,971054,14
6934,242,9359,1066155,1066397,14
1599,82,9376,525927,526009,14
9209,147,9393,700912,701059,14
3613,53,9423,327210,327263,14
9088,129,9426,700912,701041,14
2613,53,9433,327254,327307,14
7677,274,9434,1066085,1066359,14
2165,240,9443,1066113,1066353,14
3254,26,9449,106939,106965,14
1759,249,9451,1066108,1066357,14
1359,141,9516,700957,701098,14
6221,204,9541,970827,971031,14
4226,280,9551,1066020,1066300,14
4855,220,9559,970860,971080,14
7730,56,9563,327406,327462,14
1543,159,9570,849854,850013,14
4561,289,9587,1144232,1144521,14
3337,18,9599,107111,107129,14
4108,199,9616,970870,971069,14
9343,282,9624,1144204,1144486,14
5472,167,9632,849920,850087,14
9070,4,9657,107182,107186,14
7104,24,9719,107124,107148,14
6016,23,9723,107144,107167,14
2725,97,9738,526118,526215,14
1743,202,9744,970788,970990,14
3355,86,9744,526173,526259,14
4891,74,9751,327541,327615,14
9967,157,9758,849848,850005,14
8068,197,9766,970773,970970,14
7872,3,9769,107343,107346,14
1853,265,9770,1065930,1066195,14
9948,190,9774,849917,850107,14
5462,130,9777,701243,701373,14
9615,250,9804,1065924,1066174,14
8862,98,9812,526350,526448,14
5728,92,9837,526348,526440,14
5601,96,9844,526358,526454,14
4844,220,9850,970775,970995,14
7587,299,9858,1143972,1144271,14
8816,182,9873,849977,850159,14
5770,2,9894,107591,107593,14
3880,267,9909,1065875,1066142,14
9468,296,9936,1143913,1144209,14
1340,26,9944,107617,107643,14
1702,149,9950,701326,701475,14
6618,55,9964,327935,327990,14
9398,217,9967,970809,971026,14
1068,231,9975,970823,971054,14
9305,165,9993,850049,850214,14
5019,89,9994,526580,526669,14
862,255,149,1075714,1075969,15
190,74,190,536438,536512,15
112,68,225,337919,337987,15
755,218,233,980647,980865,15
333,292,288,1153584,1153876,15
681,236,317,1075612,1075848,15
918,228,381,980609,980837,15
852,34,425,117636,117670,15
627,134,492,711137,711271,15
214,199,607,980421,980620,15
967,244,639,1075295,1075539,15
239,164,699,859638,859802,15
691,23,830,117409,117432,15
754,147,849,710920,711067,15
780,79,855,536116,536195,15
137,70,866,337680,337750,15
505,244,881,1075066,1075310,15
160,156,924,859467,859623,15
294,104,950,536103,536207,15
820,214,952,980167,980381,15
124,41,993,337735,337776,15
9247,276,8002,1145889,1146165,15
6959,148,8007,703954,704102,15
6336,261,8025,1067977,1068238,15
3609,46,8073,330771,330817,15
5966,241,8086,1067946,1068187,15
2862,38,8093,330798,330836,15
9313,113,8107,703969,704082,15
8925,18,8120,110682,110700,15
9575,2,8133,110687,110689,15
1252,265,8151,1067891,1068156,15
6462,15,8157,110701,110716,15
7372,20,8169,110704,110724,15
7919,80,8181,529169,529249,15
4021,62,8183,330821,330883,15
8181,236,8206,1067870,1068106,15
3280,152,8209,852428,852580,15
3646,48,8214,330890,330938,15
4378,209,8254,973094,973303,15
1164,293,8258,1145636,1145929,15
9103,7,8261,110884,110891,15
2283,252,8266,1067857,1068109,15
2650,181,8277,852482,852663,15
5364,13,8291,110933,110946,15
2977,24,8292,110945,110969,15
1677,234,8295,1067849,1068083,15
3193,128,8310,704080,704208,15
1877,227,8330,973160,973387,15
1807,45,8337,331038,331083,15
6461,209,8344,973183,973392,15
8927,170,8345,852565,852735,15
8755,62,8354,331104,331166,15
5624,133,8365,704159,704292,15
3158,281,8395,1145519,1145800,15
4982,57,8398,331160,331217,15
4267,82,8407,529444,529526,15
3912,229,8419,973168,973397,15
7477,191,8438,973188,973379,15
2061,87,8439,529497,529584,15
4198,258,8461,1067728,1067986,15
6665,181,8464,852626,852807,15
2251,113,8468,704273,704386,15
4849,3,8473,111400,111403,15
8731,286,8503,1145419,1145705,15
9766,211,8516,973193,973404,15
6436,195,8520,973210,973405,15
5791,214,8523,973212,973426,15
4326,291,8530,1145405,1145696,15
7411,96,8561,529693,529789,15
7658,270,8568,1067732,1068002,15
2311,186,8583,852778,852964,15
8250,84,8628,529725,529809,15
7164,162,8637,852760,852922,15
6079,266,8645,1067694,1067960,15
1637,267,8683,1067691,1067958,15
9900,113,8689,704444,704557,15
6831,67,8692,331627,331694,15
7321,168,8696,852793,852961,15
4076,160,8697,852810,852970,15
3333,43,8699,331725,331768,15
8896,50,8702,331729,331779,15
5504,163,8709,852808,852971,15
3601,143,8730,704522,704665,15
9962,189,8739,852791,852980,15
9367,6,8781,111851,111857,15
5403,11,8786,111852,111863,15
3298,198,8794,973129,973327,15
3259,230,8798,973133,973363,15
4227,241,8816,1067594,1067835,15
1330,84,8820,530000,530084,15
5488,220,8828,973184,973404,15
4307,193,8870,973172,973365,15
7632,32,8878,111987,112019,15
9130,224,8882,973163,973387,15
3113,81,8883,530062,530143,15
5177,207,8893,973186,973393,15
9964,5,8911,112094,112099,15
4390,232,8913,1067507,1067739,15
3044,44,8921,332005,332049,15
4438,228,8932,973205,973433,15
7576,218,8932,973243,973461,15
4971,70,8966,332042,332112,15
1530,160,8972,852997,853157,15
6443,95,8989,530154,530249,15
8540,22,8998,112264,112286,15
5087,151,9005,852974,853125,15
2643,125,9016,704775,704900,15
4601,84,9017,530224,530308,15
6661,131,9030,704775,704906,15
6323,62,9064,332200,332262,15
7500,172,9071,852909,853081,15
5723,56,9075,332252,332308,15
4933,185,9103,852899,853084,15
5413,146,9107,704796,704942,15
7888,216,9107,973096,973312,15
1325,101,9153,530289,530390,15
2483,53,9160,332335,332388,15
1016,90,9161,530309,530399,15
3658,140,9167,704810,704950,15
9823,185,9192,852885,853070,15
3126,17,9201,112623,112640,15
5656,74,9219,530344,530418,15
2699,261,9228,1067193,1067454,15
6019,271,9228,1067223,1067494,15
7873,6,9233,112716,112722,15
5823,31,9237,112718,112749,15
7166,280,9239,1144714,1144994,15
6487,104,9256,530422,530526,15
4672,300,9264,1144696,1144996,15
9092,224,9294,973099,973323,15
1711,86,9308,530477,530563,15
5680,127,9308,704932,705059,15
7242,172,9308,853004,853176,15
4208,272,9312,1067263,1067535,15
7144,274,9312,1144675,1144949,15
2910,256,9319,1067339,1067595,15
4777,73,9325,332779,332852,15
7549,120,9333,705079,705199,15
2374,132,9344,705077,705209,15
2522,256,9356,1067327,1067583,15
3538,84,9361,530741,530825,15
7655,185,9361,853133,853318,15
7101,237,9365,1067343,1067580,15
1470,44,9396,332967,333011,15
2226,237,9431,1067283,1067520,15
8706,266,9438,1067282,1067548,15
7963,75,9442,530823,530898,15
8352,11,9443,113299,113310,15
4480,2,9462,113291,113293,15
7023,164,9470,853179,853343,15
6790,293,9478,1144510,1144803,15
9276,88,9491,530852,530940,15
7079,112,9496,705219,705331,15
2096,261,9501,1067296,1067557,15
5641,28,9504,113431,113459,15
3837,201,9520,973276,973477,15
1119,93,9543,530929,531022,15
1663,12,9555,113480,113492,15
5557,157,9555,853228,853385,15
5971,274,9576,1144432,1144706,15
2094,289,9586,1144423,1144712,15
7210,66,9592,333260,333326,15
3918,227,9596,973293,973520,15
2331,200,9599,973327,973527,15
1466,140,9613,705376,705516,15
2635,46,9617,333376,333422,15
9787,167,9640,853310,853477,15
4489,101,9647,531111,531212,15
6859,193,9681,973255,973448,15
4638,81,9689,531135,531216,15
2188,47,9693,333458,333505,15
3686,90,9693,531139,531229,15
1454,279,9698,1144327,1144606,15
1331,186,9708,853339,853525,15
6506,122,9711,705463,705585,15
5924,95,9714,531249,531344,15
1866,15,9716,113979,113994,15
8164,151,9717,853366,853517,15
6081,192,9739,973241,973433,15
2853,69,9743,333678,333747,15
3950,166,9760,853364,853530,15
5534,243,9777,1067176,1067419,15
8333,34,9783,114107,114141,15
3463,44,9786,333742,333786,15
4173,225,9798,973225,973450,15
9409,3,9800,114196,114199,15
1072,226,9810,973248,973474,15
9497,15,9827,114208,114223,15
5752,165,9856,853404,853569,15
6891,13,9865,114221,114234,15
2555,111,9871,531380,531491,15
4836,81,9872,531417,531498,15
9012,63,9875,333846,333909,15
2954,57,9885,333863,333920,15
2552,285,9889,1144142,1144427,15
6311,58,9890,333916,333974,15
4342,274,9894,1144149,1144423,15
4588,156,9905,853450,853606,15
1562,205,9907,973269,973474,15
2153,110,9915,531534,531644,15
8376,255,9919,1067130,1067385,15
8650,131,9919,705734,705865,15
1041,59,9935,334115,334174,15
6946,74,9937,531625,531699,15
3426,263,9941,1067132,1067395,15
1203,228,9988,973285,973513,15
9968,276,9992,1144052,1144328,15
8529,171,9995,853566,853737,15
2507,152,9997,853585,853737,15
6945,280,9997,1144050,1144330,15
7271,143,9998,705909,706052,15
169,2,130,124725,124727,16
807,9,189,124668,124677,16
504,239,283,1076912,1077151,16
267,245,370,1076839,1077084,16
890,207,388,983090,983297,16
236,13,507,124464,124477,16
407,188,519,982981,983169,16
932,54,524,343990,344044,16
859,223,538,982965,983188,16
963,166,730,863093,863259,16
143,172,917,862926,863098,16
750,233,968,1076261,1076494,16
4538,257,8026,1069211,1069468,16
5645,58,8031,336682,336740,16
3727,233,8033,1069236,1069469,16
7082,169,8041,855945,856114,16
3547,57,8043,336765,336822,16
7984,35,8054,117315,117350,16
1926,81,8055,534183,534264,16
8767,96,8073,534175,534271,16
4147,226,8077,1069200,1069426,16
6187,148,8082,855966,856114,16
5034,77,8094,534253,534330,16
6709,248,8099,1069179,1069427,16
9407,175,8103,855986,856161,16
7652,79,8110,534317,534396,16
7710,289,8122,1145939,1146228,16
1489,220,8134,975647,975867,16
2810,98,8142,534367,534465,16
1816,7,8145,117644,117651,16
8512,253,8153,1069189,1069442,16
6073,256,8155,1069215,1069471,16
6259,37,8164,337134,337171,16
2359,230,8180,1069221,1069451,16
4801,234,8209,1069197,1069431,16
7851,57,8216,337156,337213,16
4155,188,8230,975746,975934,16
5310,218,8232,975747,975965,16
6780,88,8232,534526,534614,16
5535,118,8236,708580,708698,16
3485,58,8237,337301,337359,16
2445,46,8248,337313,337359,16
3397,266,8248,1069167,1069433,16
7719,115,8250,708614,708729,16
9614,187,8254,975798,975985,16
7868,45,8261,337419,337464,16
3628,247,8278,1069178,1069425,16
6404,260,8285,1069193,1069453,16
7465,282,8292,1145792,1146074,16
7955,181,8311,856314,856495,16
3363,273,8326,1145774,1146047,16
2160,231,8333,1069262,1069493,16
5638,248,8337,1069264,1069512,16
3810,239,8362,1069262,1069501,16
7425,247,8366,1069272,1069519,16
3631,172,8371,856484,856656,16
7991,237,8398,1069262,1069499,16
7553,94,8429,534901,534995,16
9855,195,8448,975966,976161,16
8437,246,8454,1069218,1069464,16
3637,80,8466,534961,535041,16
7773,299,8489,1145618,1145917,16
1658,39,8495,337771,337810,16
8123,156,8512,856525,856681,16
7182,96,8537,534973,535069,16
3433,71,8545,337797,337868,16
6715,3,8548,118508,118511,16
2125,126,8552,708927,709053,16
5660,27,8552,118542,118569,16
9944,4,8561,118560,118564,16
5194,219,8575,975929,976148,16
1776,185,8577,856509,856694,16
8790,108,8580,535066,535174,16
3812,1,8597,118633,118634,16
4106,193,8597,975941,976134,16
5718,42,8601,337957,337999,16
1909,41,8606,337959,338000,16
3152,203,8622,975924,976127,16
5495,263,8628,1069106,1069369,16
8433,53,8633,338010,338063,16
9046,172,8637,856605,856777,16
9542,28,8637,118839,118867,16
4253,296,8650,1145490,1145786,16
3362,214,8677,975967,976181,16
5838,247,8682,1069131,1069378,16
4524,182,8694,856691,856873,16
2308,221,8706,976007,976228,16
3085,224,8716,976033,976257,16
9155,17,8730,118984,119001,16
3875,295,8740,1145430,1145725,16
8191,213,8745,976083,976296,16
1628,206,8781,976075,976281,16
9694,170,8798,856818,856988,16
8160,197,8809,976068,976265,16
1652,290,8821,1145378,1145668,16
7882,276,8831,1145392,1145668,16
2771,277,8833,1145400,1145677,16
7132,192,8838,976171,976363,16
1237,171,8847,856988,857159,16
6754,188,8859,976157,976345,16
2151,34,8879,119237,119271,16
8145,234,8880,1069119,1069353,16
9240,147,8880,857058,857205,16
7312,103,8889,535645,535748,16
1392,287,8896,1145348,1145635,16
8682,28,8899,119391,119419,16
2390,213,8910,976189,976402,16
9761,230,8954,1069095,1069325,16
3430,172,8957,857099,857271,16
7827,15,8968,119455,119470,16
4751,47,8970,338591,338638,16
3677,277,8984,1145281,1145558,16
6540,79,8990,535761,535840,16
3582,27,9000,119543,119570,16
6687,112,9013,709624,709736,16
8285,215,9015,976192,976407,16
9065,134,9028,709651,709785,16
7186,176,9032,857128,857304,16
9436,168,9046,857144,857312,16
1736,201,9060,976177,976378,16
7364,272,9064,1145212,1145484,16
1183,155,9067,857223,857378,16
9126,194,9072,976221,976415,16
4171,49,9080,338889,338938,16
9420,256,9081,1069055,1069311,16
8707,70,9088,338931,339001,16
3878,206,9104,976238,976444,16
3674,101,9120,536046,536147,16
5909,205,9125,976238,976443,16
8032,217,9133,976250,976467,16
2280,222,9136,976279,976501,16
6006,197,9137,976315,976512,16
6020,59,9150,339120,339179,16
5529,236,9161,1069006,1069242,16
6255,107,9161,536220,536327,16
9712,16,9162,120143,120159,16
9621,228,9189,1068989,1069217,16
9027,156,9191,857459,857615,16
4010,210,9194,976350,976560,16
8765,124,9197,710116,710240,16
9150,107,9198,536367,536474,16
8329,145,9201,710128,710273,16
9490,268,9201,1145081,1145349,16
2785,264,9206,1069016,1069280,16
9683,192,9211,976438,976630,16
8328,284,9215,1145069,1145353,16
6712,128,9242,710276,710404,16
4175,231,9255,1069047,1069278,16
7088,131,9267,710309,710440,16
5588,180,9279,857615,857795,16
1417,166,9300,857628,857794,16
1603,214,9302,976434,976648,16
3182,131,9312,710401,710532,16
5134,257,9322,1068986,1069243,16
2195,122,9327,710447,710569,16
8388,64,9341,339709,339773,16
1517,9,9348,120673,120682,16
6669,35,9353,120677,120712,16
5291,189,9365,976440,976629,16
7217,145,9397,710429,710574,16
6134,145,9400,710463,710608,16
5774,114,9432,710468,710582,16
8289,250,9448,1068892,1069142,16
6758,111,9458,710486,710597,16
1043,10,9463,120812,120822,16
7597,106,9464,536877,536983,16
1592,180,9465,857639,857819,16
7906,210,9473,976376,976586,16
9259,94,9473,536977,537071,16
8043,248,9475,1068890,1069138,16
4694,243,9482,1068906,1069149,16
1808,50,9492,340019,340069,16
5015,136,9492,710607,710743,16
8800,132,9503,710624,710756,16
9487,271,9509,1144793,1145064,16
8420,46,9518,340116,340162,16
5267,111,9529,710660,710771,16
4201,120,9540,710652,710772,16
4462,211,9543,976451,976662,16
4320,177,9555,857778,857955,16
4837,202,9558,976462,976664,16
3462,231,9560,1068887,1069118,16
2807,28,9592,121288,121316,16
6892,219,9593,976484,976703,16
7430,264,9625,1068828,1069092,16
2891,191,9643,976508,976699,16
8598,107,9658,537333,537440,16
4690,279,9660,1144647,1144926,16
1954,123,9672,710836,710959,16
4109,154,9678,857920,858074,16
7923,116,9695,710866,710982,16
7052,157,9700,857906,858063,16
9411,255,9704,1068829,1069084,16
9486,106,9710,537539,537645,16
5784,267,9716,1144604,1144871,16
6087,2,9717,121611,121613,16
3343,207,9719,976558,976765,16
4903,93,9724,537634,537727,16
3782,122,9736,710985,711107,16
9699,84,9738,537679,537763,16
5359,132,9741,710994,711126,16
5227,287,9753,1144568,1144855,16
6281,227,9765,1068880,1069107,16
3809,84,9783,537758,537842,16
2275,138,9785,711050,711188,16
4019,223,9793,976586,976809,16
9975,157,9794,858057,858214,16
5833,61,9798,340891,340952,16
7763,161,9799,858063,858224,16
3267,247,9804,1068843,1069090,16
7517,43,9848,340939,340982,16
2765,23,9852,122003,122026,16
5799,282,9852,1144490,1144772,16
4497,31,9890,122023,122054,16
3211,215,9901,976596,976811,16
3053,169,9904,858090,858259,16
8419,208,9910,976617,976825,16
3994,165,9941,858115,858280,16
1169,29,9958,122126,122155,16
4032,14,9958,122155,122169,16
1050,43,9962,341013,341056,16
7342,201,9967,976583,976784,16
9549,34,9979,122218,122252,16
7852,240,9988,1068722,1068962,16
6473,181,9993,858160,858341,16
1248,23,9995,122306,122329,16
811,241,60,1078671,1078912,17
316,293,78,1154287,1154580,17
976,217,247,986442,986659,17
259,286,278,1154121,1154407,17
468,26,297,132163,132189,17
310,2,370,132116,132118,17
380,59,377,350855,350914,17
661,163,449,867895,868058,17
360,106,481,721028,721134,17
530,205,485,986280,986485,17
118,57,672,350690,350747,17
596,98,716,547573,547671,17
499,214,728,986062,986276,17
103,69,767,350688,350757,17
260,235,792,1078041,1078276,17
393,162,797,867682,867844,17
208,196,810,986053,986249,17
441,259,812,1078037,1078296,17
740,134,839,720893,721027,17
998,84,906,547628,547712,17
617,175,994,867581,867756,17
8866,222,8004,1070885,1071107,17
2152,155,8013,860633,860788,17
8746,112,8024,713848,713960,17
7272,186,8032,978925,979111,17
4624,183,8124,978839,979022,17
2677,221,8128,1070764,1070985,17
9576,169,8132,860641,860810,17
8469,52,8134,343846,343898,17
9844,21,8141,125129,125150,17
8267,267,8171,1146255,1146522,17
5173,232,8183,1070751,1070983,17
6161,279,8186,1146248,1146527,17
8418,129,8190,713948,714077,17
9685,165,8203,860711,860876,17
6169,272,8220,1146234,1146506,17
8349,26,8244,125251,125277,17
2540,58,8245,343963,344021,17
4813,196,8245,978916,979112,17
7387,240,8253,1070774,1071014,17
9663,71,8255,540870,540941,17
3975,251,8268,1070780,1071031,17
3415,209,8318,978937,979146,17
7120,272,8332,1146135,1146407,17
7519,293,8408,1146072,1146365,17
8617,92,8414,540857,540949,17
2149,93,8419,540875,540968,17
3667,156,8420,860783,860939,17
8860,45,8426,344156,344201,17
7844,287,8446,1146068,1146355,17
2854,166,8462,860793,860959,17
2793,157,8470,860809,860966,17
4283,116,8475,714131,714247,17
7371,200,8475,978926,979126,17
4926,93,8477,541057,541150,17
4969,253,8507,1070693,1070946,17
3773,77,8515,541079,541156,17
5486,121,8533,714158,714279,17
2753,202,8536,978924,979126,17
8299,227,8551,1070683,1070910,17
6806,31,8557,125746,125777,17
6429,231,8567,1070675,1070906,17
8885,73,8567,541179,541252,17
7571,89,8572,541178,541267,17
1920,277,8576,1145966,1146243,17
5762,84,8599,541207,541291,17
4594,129,8617,714238,714367,17
4528,25,8626,125912,125937,17
4861,42,8651,344537,344579,17
1275,256,8665,1070629,1070885,17
3657,188,8672,978966,979154,17
8710,167,8675,860923,861090,17
7373,167,8679,860944,861111,17
1551,257,8703,1070628,1070885,17
2221,106,8707,714357,714463,17
3703,115,8710,714355,714470,17
1892,94,8731,541378,541472,17
4270,16,8734,126135,126151,17
8152,288,8745,1145815,1146103,17
6070,129,8761,714351,714480,17
8012,109,8786,714350,714459,17
2396,159,8797,860927,861086,17
2324,95,8799,541479,541574,17
9790,185,8799,978925,979110,17
5363,256,8811,1070598,1070854,17
4408,75,8826,541550,541625,17
3199,187,8838,978930,979117,17
8125,235,8850,1070596,1070831,17
9315,79,8864,541590,541669,17
6189,291,8865,1145724,1146015,17
8576,109,8866,714496,714605,17
3173,166,8867,861064,861230,17
8873,91,8876,541696,541787,17
5866,148,8881,861074,861222,17
1591,125,8903,714537,714662,17
1251,184,8910,978943,979127,17
4086,18,8915,126582,126600,17
6272,52,8916,345190,345242,17
5582,66,8951,345173,345239,17
6135,143,8951,861048,861191,17
9806,154,8971,861029,861183,17
6242,150,8975,861037,861187,17
8069,70,8987,541823,541893,17
1299,134,9005,714603,714737,17
5168,127,9041,714596,714723,17
2778,132,9042,714617,714749,17
8730,300,9095,1145526,1145826,17
8813,57,9099,345337,345394,17
2721,296,9118,1145544,1145840,17
9653,89,9119,541872,541961,17
7960,22,9134,126823,126845,17
2095,122,9139,714621,714743,17
9610,93,9142,541905,541998,17
8259,242,9149,1070433,1070675,17
8795,56,9149,345485,345541,17
6600,142,9168,714646,714788,17
9924,46,9179,345512,345558,17
2393,98,9186,541957,542055,17
4641,180,9236,860898,861078,17
3038,259,9250,1070355,1070614,17
6894,98,9255,541989,542087,17
5776,22,9282,127037,127059,17
9825,254,9292,1070353,1070607,17
1162,209,9298,978754,978963,17
2046,39,9302,345611,345650,17
6917,74,9352,541993,542067,17
3992,274,9354,1145345,1145619,17
5533,179,9354,860970,861149,17
9337,108,9363,714710,714818,17
5328,252,9364,1070356,1070608,17
6115,59,9368,345725,345784,17
5568,207,9369,978790,978997,17
8206,157,9384,861053,861210,17
7895,151,9400,861052,861203,17
5107,150,9401,861060,861210,17
5901,291,9418,1145296,1145587,17
7811,155,9440,861067,861222,17
4101,263,9487,1145259,1145522,17
7039,62,9494,345869,345931,17
4791,28,9496,127423,127451,17
5692,196,9550,978714,978910,17
9932,180,9563,861033,861213,17
2639,190,9571,978709,978899,17
1113,184,9603,978687,978871,17
8850,237,9604,1070229,1070466,17
7559,38,9609,345957,345995,17
8363,237,9617,1070234,1070471,17
5226,168,9629,861157,861325,17
6023,289,9630,1145120,1145409,17
6752,289,9653,1145127,1145416,17
6923,142,9661,715044,715186,17
7522,4,9666,127655,127659,17
6232,209,9676,978774,978983,17
9390,33,9679,127680,127713,17
3030,71,9695,542447,542518,17
6835,45,9695,346120,346165,17
7768,150,9695,861231,861381,17
3461,27,9702,127792,127819,17
6220,2,9719,127802,127804,17
3615,126,9722,715094,715220,17
5011,242,9725,1070224,1070466,17
4922,240,9738,1070234,1070474,17
5248,109,9739,715172,715281,17
1063,155,9747,861263,861418,17
4768,276,9750,1145060,1145336,17
9649,256,9763,1070270,1070526,17
5442,36,9778,346328,346364,17
1128,259,9784,1070286,1070545,17
3067,254,9799,1070311,1070565,17
2604,132,9814,715286,715418,17
9263,78,9821,542719,542797,17
8186,198,9827,978886,979084,17
4665,21,9843,128122,128143,17
7142,167,9855,861358,861525,17
5313,178,9871,861367,861545,17
8308,206,9877,978854,979060,17
5414,289,9920,1144907,1145196,17
9915,264,9927,1144930,1145194,17
1770,300,9976,1144886,1145186,17
4993,91,9976,542825,542916,17
3513,154,9978,861448,861602,17
2686,26,9994,128264,128290,17
787,164,103,871339,871503,18
339,190,132,988747,988937,18
331,266,176,1154734,1155000,18
587,166,243,871299,871465,18
732,161,257,871313,871474,18
404,25,293,138156,138181,18
146,169,320,871273,871442,18
273,183,358,988574,988757,18
964,8,365,138175,138183,18
616,90,431,552675,552765,18
875,196,440,988500,988696,18
838,159,464,871234,871393,18
806,280,486,1154438,1154718,18
922,40,489,356449,356489,18
835,222,490,1079859,1080081,18
438,243,593,1079765,1080008,18
287,300,690,1217560,1217860,18
472,287,712,1154280,1154567,18
784,287,900,1154127,1154414,18
161,135,964,725002,725137,18
666,9,965,137946,137955,18
609,80,975,552469,552549,18
462,190,983,988206,988396,18
3779,204,8014,981190,981394,18
8071,83,8021,545506,545589,18
1307,172,8032,863983,864155,18
2383,15,8035,131050,131065,18
9029,102,8044,545534,545636,18
4414,4,8050,131083,131087,18
3039,116,8057,718050,718166,18
3917,28,8080,131090,131118,18
3118,244,8082,1072423,1072667,18
5286,63,8086,349335,349398,18
5750,42,8103,349348,349390,18
8390,129,8111,718046,718175,18
1139,290,8122,1146940,1147230,18
8696,32,8124,131239,131271,18
8724,71,8127,545626,545697,18
3990,257,8155,1146945,1147202,18
2424,142,8165,863995,864137,18
8170,295,8176,1210082,1210377,18
7676,71,8202,545660,545731,18
6927,278,8219,1146926,1147204,18
7438,59,8237,349495,349554,18
7643,228,8269,1072423,1072651,18
9013,31,8273,131386,131417,18
9472,32,8285,131405,131437,18
7856,206,8292,981169,981375,18
2519,250,8298,1072409,1072659,18
8236,153,8329,864020,864173,18
1311,13,8331,131490,131503,18
7078,171,8336,864028,864199,18
6425,300,8350,1209911,1210211,18
9812,223,8356,1072427,1072650,18
5279,259,8358,1146853,1147112,18
9703,84,8363,545818,545902,18
7209,200,8366,981278,981478,18
7794,298,8369,1209900,1210198,18
4742,261,8374,1146884,1147145,18
3014,146,8386,864233,864379,18
6061,213,8390,981355,981568,18
7227,38,8399,349835,349873,18
8735,66,8412,349827,349893,18
1218,128,8413,718419,718547,18
3959,166,8415,864249,864415,18
1295,75,8429,546014,546089,18
7420,283,8451,1146816,1147099,18
9554,52,8454,349954,350006,18
6636,22,8460,131935,131957,18
7428,280,8486,1146812,1147092,18
9089,80,8487,546034,546114,18
7843,113,8509,718457,718570,18
1774,188,8510,981349,981537,18
1459,28,8524,132025,132053,18
4935,10,8549,132028,132038,18
4658,278,8565,1146761,1147039,18
2345,253,8609,1146743,1146996,18
7681,8,8612,132041,132049,18
2243,182,8615,981333,981515,18
9448,9,8616,132078,132087,18
7951,196,8620,981335,981531,18
3510,173,8624,864327,864500,18
3202,135,8629,718564,718699,18
3606,70,8650,546164,546234,18
2265,82,8689,546128,546210,18
1867,232,8696,1072370,1072602,18
5392,139,8698,864325,864464,18
9828,105,8698,718600,718705,18
6512,47,8707,350230,350277,18
1070,202,8711,981303,981505,18
4056,238,8730,1072355,1072593,18
7276,15,8734,132332,132347,18
4607,64,8735,350284,350348,18
1026,142,8738,864360,864502,18
9473,168,8739,864363,864531,18
8950,107,8750,718695,718802,18
5307,152,8767,864365,864517,18
1296,153,8787,864359,864512,18
4368,159,8796,864365,864524,18
8355,276,8807,1146546,1146822,18
9271,208,8807,981310,981518,18
3368,35,8809,350513,350548,18
8882,165,8821,864435,864600,18
4499,39,8824,350534,350573,18
8715,143,8827,864456,864599,18
8246,234,8858,1072291,1072525,18
2302,245,8867,1072303,1072548,18
8751,258,8871,1146506,1146764,18
1192,288,8881,1146502,1146790,18
2317,283,8885,1146534,1146817,18
3514,214,8886,1072433,1072647,18
6881,42,8905,350697,350739,18
1948,203,8917,981461,981664,18
3737,72,8956,546646,546718,18
1282,156,8969,864578,864734,18
4427,247,8981,1072339,1072586,18
4486,183,8982,981462,981645,18
5013,177,8984,981468,981645,18
6416,66,9007,350808,350874,18
8638,179,9025,981429,981608,18
2976,162,9047,864666,864828,18
5491,150,9051,864686,864836,18
9658,19,9056,133015,133034,18
6111,206,9082,981376,981582,18
4141,81,9089,546798,546879,18
7100,109,9090,719152,719261,18
3914,106,9112,719137,719243,18
5623,92,9112,546859,546951,18
4407,108,9151,719102,719210,18
9888,172,9162,864624,864796,18
1352,283,9187,1146263,1146546,18
8642,72,9222,546879,546951,18
4042,192,9223,981304,981496,18
2630,254,9252,1146229,1146483,18
7026,89,9253,546923,547012,18
1575,118,9295,719108,719226,18
9125,105,9304,719115,719220,18
7384,65,9312,351114,351179,18
2245,50,9330,351128,351178,18
3511,164,9331,864600,864764,18
1477,81,9363,546940,547021,18
1051,16,9390,133294,133310,18
9207,122,9394,719064,719186,18
1673,251,9395,1072037,1072288,18
4981,272,9478,1146005,1146277,18
4163,117,9479,719071,719188,18
5516,226,9489,1072020,1072246,18
5207,38,9492,351221,351259,18
9309,30,9496,133402,133432,18
5765,233,9528,1071994,1072227,18
2398,211,9543,981191,981402,18
6751,81,9550,547012,547093,18
4600,210,9552,981218,981428,18
8939,150,9552,864627,864777,18
3954,206,9555,981250,981456,18
2253,102,9560,547121,547223,18
4571,145,9560,864668,864813,18
1773,188,9591,981245,981433,18
7606,41,9624,351400,351441,18
9000,175,9646,864626,864801,18
1495,130,9647,719242,719372,18
8074,119,9650,719267,719386,18
4983,17,9681,133676,133693,18
8037,204,9683,981166,981370,18
2054,148,9704,864642,864790,18
6501,205,9731,981147,981352,18
7609,96,9731,547265,547361,18
8545,2,9734,133772,133774,18
7846,278,9743,1145760,1146038,18
6326,257,9745,1145784,1146041,18
2531,236,9780,1071840,1072076,18
5613,240,9796,1071847,1072087,18
7777,197,9798,981262,981459,18
8515,297,9801,1208474,1208771,18
2708,214,9803,1071906,1072120,18
5850,143,9835,864817,864960,18
6248,95,9835,547470,547565,18
4328,94,9844,547489,547583,18
4296,89,9864,547496,547585,18
4353,226,9872,1071838,1072064,18
4135,218,9880,1071843,1072061,18
1140,28,9881,134056,134084,18
9318,98,9891,547561,547659,18
9328,59,9905,351841,351900,18
4616,101,9936,547547,547648,18
9516,280,9941,1145633,1145913,18
7667,186,9998,981274,981460,18
942,78,155,557434,557512,19
663,104,211,729266,729370,19
370,21,255,143939,143960,19
904,102,311,729171,729273,19
381,4,454,143793,143797,19
277,203,571,990717,990920,19
592,162,587,874258,874420,19
299,77,699,557039,557116,19
179,30,852,143495,143525,19
988,43,866,361207,361250,19
697,163,974,873899,874062,19
3260,213,8019,1073754,1073967,19
1294,238,8029,1073750,1073988,19
6193,265,8048,1147561,1147826,19
2168,116,8058,721637,721753,19
4858,138,8065,866945,867083,19
9381,223,8072,1073776,1073999,19
3804,264,8082,1147547,1147811,19
9429,6,8084,136581,136587,19
4213,93,8093,549929,550022,19
5453,39,8104,354277,354316,19
3835,111,8127,721690,721801,19
2517,157,8128,866958,867115,19
9058,295,8163,1210125,1210420,19
8621,147,8167,866978,867125,19
8294,107,8185,721749,721856,19
3870,27,8198,136697,136724,19
7388,242,8205,1073735,1073977,19
3621,149,8226,866968,867117,19
7331,25,8243,136743,136768,19
3305,57,8248,354371,354428,19
5636,17,8248,136795,136812,19
1342,153,8254,866955,867108,19
3715,118,8259,721788,721906,19
7897,36,8273,354437,354473,19
8659,18,8274,136882,136900,19
5565,9,8291,136883,136892,19
9182,207,8298,983282,983489,19
8360,67,8303,550087,550154,19
5416,282,8319,1147368,1147650,19
3979,249,8331,1147393,1147642,19
3970,66,8339,550121,550187,19
9010,60,8344,354535,354595,19
3304,132,8345,721826,721958,19
8599,101,8346,721858,721959,19
3032,178,8352,983339,983517,19
2623,8,8360,137111,137119,19
7455,67,8366,550197,550264,19
4986,279,8376,1147352,1147631,19
5524,214,8388,1073701,1073915,19
2071,131,8411,721900,722031,19
6646,73,8411,550256,550329,19
5163,123,8428,721915,722038,19
8584,228,8438,1073658,1073886,19
9025,197,8447,983363,983560,19
5726,71,8461,550316,550387,19
9707,260,8463,1147299,1147559,19
4734,162,8470,867082,867244,19
3402,34,8481,354888,354922,19
4440,84,8484,550367,550451,19
4680,6,8488,137407,137413,19
7548,60,8495,354909,354969,19
6312,267,8525,1147252,1147519,19
6349,113,8528,722014,722127,19
3747,259,8532,1147267,1147526,19
7215,146,8538,867114,867260,19
2116,245,8557,1073674,1073919,19
7056,19,8568,137525,137544,19
7159,70,8585,550455,550525,19
1031,53,8595,355035,355088,19
9009,25,8601,137575,137600,19
9601,35,8606,355045,355080,19
8559,248,8610,1147203,1147451,19
4758,229,8614,1073693,1073922,19
8740,135,8616,867156,867291,19
6975,197,8626,983433,983630,19
8120,70,8630,550551,550621,19
3910,287,8637,1209662,1209949,19
1824,278,8642,1147213,1147491,19
1221,65,8657,355228,355293,19
2395,201,8662,983498,983699,19
9249,125,8662,722244,722369,19
9018,4,8676,137877,137881,19
9620,249,8678,1147210,1147459,19
3796,75,8709,550647,550722,19
7184,76,8709,550657,550733,19
7167,210,8723,1073720,1073930,19
8339,193,8732,983533,983726,19
8526,169,8765,867260,867429,19
3057,276,8773,1147119,1147395,19
9354,143,8780,867316,867459,19
2848,95,8782,550765,550860,19
5352,133,8782,722360,722493,19
8432,295,8785,1209517,1209812,19
2729,41,8804,355543,355584,19
9171,147,8808,867333,867480,19
1212,69,8816,550863,550932,19
1819,249,8818,1147144,1147393,19
5564,245,8832,1073728,1073973,19
6357,243,8837,1073761,1074004,19
2077,231,8845,1073789,1074020,19
5050,54,8871,355683,355737,19
5548,125,8878,722508,722633,19
9781,265,8883,1147083,1147348,19
1712,108,8902,722545,722653,19
9495,117,8914,722542,722659,19
8689,195,8922,983625,983820,19
5970,192,8923,983649,983841,19
3794,21,8963,138394,138415,19
4310,16,8998,138380,138396,19
9183,47,9028,355746,355793,19
4051,223,9029,1073667,1073890,19
7952,19,9038,138420,138439,19
7338,71,9044,551013,551084,19
4145,86,9051,551012,551098,19
6398,277,9061,1146925,1147202,19
3717,107,9065,722549,722656,19
7404,290,9076,1209237,1209527,19
7518,116,9094,722563,722679,19
2696,275,9103,1146954,1147229,19
4710,242,9104,1073722,1073964,19
2295,219,9110,1073751,1073970,19
6538,18,9119,138646,138664,19
3301,129,9134,722645,722774,19
3345,20,9151,138664,138684,19
8984,1,9166,138669,138670,19
3548,88,9186,551170,551258,19
2177,240,9197,1073676,1073916,19
2202,230,9204,1073702,1073932,19
6407,267,9221,1146866,1147133,19
2704,56,9233,356051,356107,19
3266,94,9236,551245,551339,19
6304,144,9252,867478,867622,19
8527,186,9256,983671,983857,19
6565,14,9258,138834,138848,19
4978,159,9274,867502,867661,19
2111,12,9276,138862,138874,19
6287,67,9289,551323,551390,19
2409,11,9316,138866,138877,19
6273,22,9327,138866,138888,19
8577,191,9350,983593,983784,19
2941,43,9359,356147,356190,19
1368,42,9361,356156,356198,19
9339,94,9368,551280,551374,19
7339,176,9380,983584,983760,19
7979,166,9388,867485,867651,19
1186,10,9389,139018,139028,19
8166,275,9398,1146711,1146986,19
5891,48,9402,356257,356305,19
2606,129,9406,722753,722882,19
9479,26,9411,139102,139128,19
4793,238,9416,1073589,1073827,19
8554,252,9421,1146718,1146970,19
6796,232,9422,1073652,1073884,19
6705,190,9423,983695,983885,19
7419,266,9453,1146693,1146959,19
8127,38,9456,356417,356455,19
2009,34,9482,356397,356431,19
7645,256,9492,1146675,1146931,19
4558,63,9527,356387,356450,19
4457,186,9532,983680,983866,19
5640,5,9566,139293,139298,19
5244,153,9577,867616,867769,19
5025,207,9589,983639,983846,19
3296,300,9590,1208729,1209029,19
7835,48,9601,356476,356524,19
9930,264,9614,1146603,1146867,19
7875,89,9623,551564,551653,19
7127,121,9641,722933,723054,19
6008,208,9642,1073609,1073817,19
6640,48,9663,356562,356610,19
9351,9,9676,139476,139485,19
1522,102,9677,722954,723056,19
4888,242,9694,1073558,1073800,19
8712,120,9705,722964,723084,19
3539,74,9720,551661,551735,19
4232,238,9723,1073564,1073802,19
7499,277,9735,1146501,1146778,19
4792,73,9760,551698,551771,19
6564,130,9773,722987,723117,19
4925,56,9792,356713,356769,19
5898,269,9794,1146474,1146743,19
9296,153,9795,867705,867858,19
1982,4,9808,139705,139709,19
9824,13,9809,139708,139721,19
7828,95,9843,551725,551820,19
5879,4,9853,139709,139713,19
3141,186,9873,983651,983837,19
5381,44,9878,356783,356827,19
6433,57,9922,356751,356808,19
3720,75,9926,551706,551781,19
6170,135,9926,867629,867764,19
1701,272,9935,1146357,1146629,19
4065,20,9979,139779,139799,19
1914,25,9988,139790,139815,19
8508,46,9997,356800,356846,19
502,111,106,732863,732974,20
194,249,112,1156214,1156463,20
999,77,223,561555,561632,20
548,266,332,1156005,1156271,20
262,148,346,877320,877468,20
111,271,425,1155940,1156211,20
133,182,540,993150,993332,20
879,46,550,366486,366532,20
613,197,592,993115,993312,20
243,134,597,877192,877326,20
975,112,599,732623,732735,20
519,205,604,1082945,1083150,20
590,33,613,366566,366599,20
104,203,616,1082937,1083140,20
350,202,764,1082791,1082993,20
250,197,780,993067,993264,20
130,252,845,1155553,1155805,20
715,192,879,993036,993228,20
785,249,891,1155521,1155770,20
684,46,934,366439,366485,20
582,140,945,877093,877233,20
8254,42,8000,359420,359462,20
6750,288,8005,1210338,1210626,20
2688,160,8009,870074,870234,20
2826,193,8010,986004,986197,20
6151,213,8012,1075655,1075868,20
5478,250,8031,1148430,1148680,20
8532,299,8041,1210314,1210613,20
8648,53,8046,359577,359630,20
8524,51,8054,359591,359642,20
2675,101,8057,725657,725758,20
1779,293,8061,1210317,1210610,20
4747,27,8081,142746,142773,20
8117,243,8089,1148460,1148703,20
9066,250,8094,1148460,1148710,20
9214,95,8119,554498,554593,20
3939,117,8127,725694,725811,20
4910,221,8151,1075713,1075934,20
1473,169,8155,986139,986308,20
2337,53,8155,359766,359819,20
1649,257,8170,1148396,1148653,20
5513,44,8191,359784,359828,20
9414,133,8192,870271,870404,20
7450,214,8193,1075728,1075942,20
8399,58,8198,359854,359912,20
3216,291,8200,1210195,1210486,20
8953,273,8213,1148410,1148683,20
1614,142,8216,870355,870497,20
4177,63,8221,359954,360017,20
9347,166,8223,986219,986385,20
8563,103,8225,725923,726026,20
8835,174,8256,986187,986361,20
6091,131,8257,870396,870527,20
4578,30,8262,143212,143242,20
9654,164,8291,870363,870527,20
7205,293,8313,1210097,1210390,20
7789,117,8321,725970,726087,20
9139,126,8327,725985,726111,20
1272,235,8350,1075695,1075930,20
3738,132,8367,870391,870523,20
7737,136,8367,870393,870529,20
2546,297,8393,1210034,1210331,20
3553,157,8454,870347,870504,20
3569,51,8473,360150,360201,20
6236,38,8477,360166,360204,20
8465,75,8482,554893,554968,20
6251,234,8488,1075628,1075862,20
3752,211,8499,1075650,1075861,20
8500,169,8499,986133,986302,20
6692,18,8503,143466,143484,20
4913,207,8517,1075642,1075849,20
4673,155,8522,870446,870601,20
9545,12,8531,143518,143530,20
2683,26,8538,143523,143549,20
1552,41,8549,360293,360334,20
5935,224,8556,1075609,1075833,20
8700,130,8598,726118,726248,20
3004,300,8608,1209840,1210140,20
8234,125,8612,726172,726297,20
6320,174,8626,986118,986292,20
3157,4,8639,143634,143638,20
1506,135,8650,870448,870583,20
1438,210,8667,1075558,1075768,20
5098,131,8667,870471,870602,20
1111,205,8668,1075566,1075771,20
7674,283,8671,1209801,1210084,20
6662,216,8692,1075583,1075799,20
1389,281,8695,1209784,1210065,20
4395,137,8696,870583,870720,20
3639,159,8732,870554,870713,20
5918,66,8735,555279,555345,20
9848,9,8736,143851,143860,20
4826,58,8739,360593,360651,20
1471,231,8743,1075584,1075815,20
3434,44,8743,360648,360692,20
8217,94,8785,555265,555359,20
8227,71,8796,555285,555356,20
5761,212,8800,1075557,1075769,20
6993,217,8818,1075550,1075767,20
6853,249,8831,1148017,1148266,20
4458,280,8836,1209648,1209928,20
9956,23,8839,144036,144059,20
5536,200,8852,986261,986461,20
5094,112,8858,726499,726611,20
5277,278,8861,1209627,1209905,20
6962,78,8868,555452,555530,20
2533,87,8884,555451,555538,20
5122,28,8885,144168,144196,20
4996,102,8888,726519,726621,20
6799,220,8888,1075607,1075827,20
7240,6,8902,144241,144247,20
6802,25,8903,144246,144271,20
4203,285,8914,1209576,1209861,20
3693,217,8921,1075630,1075847,20
2381,279,8929,1209570,1209849,20
6102,253,8932,1148079,1148332,20
1404,200,8945,986419,986619,20
4962,96,8950,555640,555736,20
2865,89,8955,555668,555757,20
3195,68,8999,555650,555718,20
3313,129,9004,726613,726742,20
4822,96,9013,555674,555770,20
8747,159,9052,870718,870877,20
4148,12,9055,144460,144472,20
2875,165,9072,870727,870892,20
9397,262,9077,1147949,1148211,20
5452,250,9085,1147965,1148215,20
4093,28,9103,144517,144545,20
4061,88,9107,555745,555833,20
8565,195,9123,986348,986543,20
5290,295,9131,1209371,1209666,20
6747,278,9149,1209372,1209650,20
6162,226,9151,1075638,1075864,20
6528,129,9165,726757,726886,20
1740,193,9169,986440,986633,20
5620,169,9179,986458,986627,20
5790,204,9187,1075627,1075831,20
2668,102,9202,726855,726957,20
1683,157,9209,870940,871097,20
5685,68,9210,555997,556065,20
9698,257,9211,1147927,1148184,20
5372,192,9231,986482,986674,20
3860,262,9250,1147907,1148169,20
1469,66,9252,556059,556125,20
1789,98,9279,726920,727018,20
3519,63,9288,361524,361587,20
5824,164,9293,870988,871152,20
7389,262,9293,1147888,1148150,20
3922,281,9300,1209223,1209504,20
6880,205,9313,1075652,1075857,20
7877,260,9348,1147895,1148155,20
7659,296,9351,1209177,1209473,20
4752,7,9356,145036,145043,20
5162,260,9357,1147946,1148206,20
5225,206,9358,1075722,1075928,20
2982,246,9377,1147948,1148194,20
1571,136,9383,871212,871348,20
5475,170,9391,986673,986843,20
4346,292,9392,1209156,1209448,20
3279,229,9394,1075765,1075994,20
7521,208,9399,1075788,1075996,20
6410,223,9408,1075786,1076009,20
7131,294,9419,1209145,1209439,20
3675,228,9443,1075810,1076038,20
9451,4,9457,145283,145287,20
1905,120,9479,727300,727420,20
3371,252,9483,1147926,1148178,20
7169,172,9493,986828,987000,20
1655,62,9517,361967,362029,20
2378,29,9522,145346,145375,20
1502,274,9527,1147896,1148170,20
6302,47,9551,361996,362043,20
4419,203,9565,1075789,1075992,20
5253,192,9577,986823,987015,20
1337,163,9586,871435,871598,20
6706,41,9592,362067,362108,20
2622,143,9599,871455,871598,20
1879,106,9623,727418,727524,20
1548,244,9649,1147810,1148054,20
6960,231,9661,1075732,1075963,20
8457,163,9664,871473,871636,20
4606,206,9665,1075758,1075964,20
4882,168,9673,986862,987030,20
7853,150,9673,871567,871717,20
1410,240,9682,1147783,1148023,20
9763,2,9683,145679,145681,20
4838,284,9690,1208892,1209176,20
2497,280,9696,1208894,1209174,20
7685,32,9696,362325,362357,20
5768,138,9697,871668,871806,20
4847,137,9704,871669,871806,20
7119,206,9711,1075828,1076034,20
4089,11,9714,145836,145847,20
3188,285,9716,1208878,1209163,20
8772,223,9719,1075862,1076085,20
9149,190,9727,987027,987217,20
9059,22,9745,145909,145931,20
3633,263,9753,1147828,1148091,20
7641,184,9753,987062,987246,20
9739,39,9803,362475,362514,20
8623,95,9811,556955,557050,20
6098,50,9820,362498,362548,20
9294,160,9835,871755,871915,20
1398,214,9849,1075791,1076005,20
4471,269,9860,1147746,1148015,20
2494,79,9871,557026,557105,20
1650,150,9873,871817,871967,20
4186,15,9880,146106,146121,20
3453,140,9886,871824,871964,20
3713,31,9893,146139,146170,20
4323,245,9943,1147694,1147939,20
4249,205,9945,1075782,1075987,20
6985,275,9946,1147698,1147973,20
3465,46,9950,362675,362721,20
3108,157,9952,871873,872030,20
7265,37,9956,362716,362753,20
6511,21,9978,146271,146292,20
5152,133,9994,871858,871991,20
687,56,140,372571,372627,21
218,206,147,1085627,1085833,21
958,149,330,881563,881712,21
418,189,367,996687,996876,21
317,258,462,1157226,1157484,21
369,200,510,1085311,1085511,21
178,75,639,566667,566742,21
658,289,698,1217913,1218202,21
506,170,713,996475,996645,21
490,297,733,1217899,1218196,21
977,183,738,996495,996678,21
905,202,757,1085141,1085343,21
970,86,813,566667,566753,21
707,47,879,372230,372277,21
291,151,907,881281,881432,21
559,98,965,737370,737468,21
6977,16,8023,148758,148774,21
9517,9,8044,148753,148762,21
4349,265,8053,1149736,1150001,21
9809,111,8069,730304,730415,21
3632,69,8070,559563,559632,21
4786,78,8074,559567,559645,21
1994,18,8083,148843,148861,21
2758,295,8090,1210571,1210866,21
3877,255,8120,1149740,1149995,21
5073,294,8128,1210560,1210854,21
9288,130,8139,874210,874340,21
6341,183,8140,989291,989474,21
2858,198,8142,1077907,1078105,21
4719,209,8147,1077905,1078114,21
7146,56,8155,365374,365430,21
1630,176,8184,989340,989516,21
9802,148,8187,874302,874450,21
8386,209,8205,1077861,1078070,21
1154,239,8223,1149698,1149937,21
9978,7,8226,149078,149085,21
8021,200,8249,1077867,1078067,21
1234,270,8274,1210440,1210710,21
2754,51,8276,365465,365516,21
9360,161,8291,989389,989550,21
1488,159,8292,874389,874548,21
6333,281,8295,1210421,1210702,21
2840,134,8367,874381,874515,21
2473,172,8372,989344,989516,21
1803,264,8383,1149620,1149884,21
1913,210,8385,1077844,1078054,21
9990,262,8386,1149650,1149912,21
5507,200,8387,1077893,1078093,21
1387,180,8389,989479,989659,21
4311,257,8401,1149666,1149923,21
9049,232,8403,1149690,1149922,21
9933,46,8413,365721,365767,21
4763,30,8415,149376,149406,21
9350,214,8421,1077936,1078150,21
1492,149,8459,874603,874752,21
7048,248,8468,1149626,1149874,21
5068,18,8488,149423,149441,21
8138,288,8513,1210216,1210504,21
8136,19,8520,149439,149458,21
6017,158,8529,874624,874782,21
9526,148,8532,874653,874801,21
3655,175,8541,989522,989697,21
2332,20,8545,149523,149543,21
1201,202,8580,1077868,1078070,21
2418,188,8593,989520,989708,21
1908,180,8602,989539,989719,21
7257,96,8606,730940,731036,21
1833,299,8607,1210142,1210441,21
1852,54,8621,365901,365955,21
1360,85,8624,560218,560303,21
3806,267,8636,1149549,1149816,21
5715,60,8691,365917,365977,21
8618,69,8703,560195,560264,21
1541,182,8707,989524,989706,21
5432,89,8709,560229,560318,21
2722,132,8727,874718,874850,21
2966,158,8728,874723,874881,21
2627,120,8760,730954,731074,21
9513,223,8765,1077762,1077985,21
7615,36,8767,366088,366124,21
1195,26,8769,149829,149855,21
1143,195,8771,989517,989712,21
1395,177,8771,989552,989729,21
9302,7,8773,149911,149918,21
4027,198,8786,1077769,1077967,21
1396,36,8798,366156,366192,21
4939,281,8807,1209973,1210254,21
7921,234,8841,1149417,1149651,21
2779,286,8857,1209936,1210222,21
8110,219,8869,1077797,1078016,21
9882,247,8883,1149415,1149662,21
4387,165,8897,989653,989818,21
5042,47,8902,366244,366291,21
1540,156,8918,874905,875061,21
3838,39,8919,366275,366314,21
7168,15,8928,150093,150108,21
8582,253,8933,1149381,1149634,21
2150,274,8966,1209845,1210119,21
4604,243,8972,1149401,1149644,21
8203,244,8975,1149410,1149654,21
2174,300,9004,1209813,1210113,21
1564,290,9009,1209840,1210130,21
6839,129,9013,875044,875173,21
8137,150,9017,875043,875193,21
7431,83,9042,560628,560711,21
3310,169,9056,989709,989878,21
4961,243,9058,1149414,1149657,21
3648,52,9077,366467,366519,21
9976,219,9101,1077877,1078096,21
2803,245,9103,1149381,1149626,21
7869,233,9124,1149374,1149607,21
8838,164,9124,989790,989954,21
8989,285,9127,1209744,1210029,21
2558,236,9135,1149402,1149638,21
1065,20,9139,150437,150457,21
8501,129,9148,875208,875337,21
8690,116,9149,731516,731632,21
7316,32,9151,366663,366695,21
7978,62,9177,560835,560897,21
8973,96,9182,731506,731602,21
5368,68,9183,560862,560930,21
6723,11,9192,150584,150595,21
7139,45,9200,366709,366754,21
7753,36,9225,366699,366735,21
9229,278,9228,1209660,1209938,21
5985,201,9229,1077953,1078154,21
5494,191,9247,989811,990002,21
6105,40,9248,366775,366815,21
4909,156,9258,875203,875359,21
8588,178,9269,989820,989998,21
6489,63,9271,560941,561004,21
1505,155,9284,875241,875396,21
1713,265,9289,1149290,1149555,21
8091,266,9318,1149295,1149561,21
1503,80,9347,560963,561043,21
6954,139,9365,875257,875396,21
7248,34,9373,366908,366942,21
2835,57,9385,366900,366957,21
5263,30,9385,150882,150912,21
7594,14,9390,150907,150921,21
7474,279,9398,1209500,1209779,21
7109,296,9422,1209487,1209783,21
9795,229,9442,1077890,1078119,21
6898,81,9479,560978,561059,21
8475,153,9515,875222,875375,21
9503,14,9517,150944,150958,21
8773,154,9542,875222,875376,21
8063,138,9546,875246,875384,21
1838,54,9550,366979,367033,21
2551,94,9551,731635,731729,21
8096,205,9563,1077803,1078008,21
5023,291,9567,1209370,1209661,21
6372,66,9576,561093,561159,21
7081,143,9586,875286,875429,21
5230,26,9598,151117,151143,21
8867,122,9616,731670,731792,21
3869,58,9633,367106,367164,21
1309,148,9639,875250,875398,21
6201,239,9644,1149115,1149354,21
5203,58,9649,367180,367238,21
8511,194,9655,989732,989926,21
3897,137,9677,875302,875439,21
8769,267,9683,1149084,1149351,21
2960,249,9687,1149116,1149365,21
6895,275,9699,1209261,1209536,21
3857,74,9705,561257,561331,21
3517,214,9710,1077846,1078060,21
5629,57,9718,367356,367413,21
9384,20,9735,151396,151416,21
6827,281,9741,1209226,1209507,21
6118,79,9742,561297,561376,21
3169,152,9748,875412,875564,21
2886,134,9777,875409,875543,21
4063,65,9787,561334,561399,21
5311,12,9810,151491,151503,21
8858,289,9820,1209160,1209449,21
7145,292,9824,1209177,1209469,21
5907,140,9827,875435,875575,21
2304,84,9832,561389,561473,21
2578,35,9834,367546,367581,21
1894,164,9844,989822,989986,21
8341,154,9851,875459,875613,21
8560,204,9855,1077828,1078032,21
8872,69,9865,561475,561544,21
7724,139,9867,875505,875644,21
4774,289,9879,1209146,1209435,21
5063,273,9880,1209166,1209439,21
3850,249,9916,1149127,1149376,21
6149,26,9954,151749,151775,21
4254,85,9965,561511,561596,21
5411,30,9972,151787,151817,21
3744,91,9995,561505,561596,21
1188,130,9997,875490,875620,21
729,75,70,571494,571569,22
782,285,231,1218828,1219113,22
635,160,239,999610,999770,22
149,138,290,885271,885409,22
461,179,298,999556,999735,22
769,300,435,1270080,1270380,22
181,68,480,571255,571323,22
795,137,534,885109,885246,22
399,36,585,377382,377418,22
419,165,620,999292,999457,22
288,47,659,377345,377392,22
588,233,659,1158481,1158714,22
678,262,791,1218330,1218592,22
465,190,832,1087114,1087304,22
5675,1,8002,154253,154254,22
1163,200,8005,1079942,1080142,22
8305,172,8007,992051,992223,22
1210,141,8024,877832,877973,22
8078,219,8041,1079917,1080136,22
5401,77,8042,563981,564058,22
2755,205,8044,1079944,1080149,22
6713,3,8048,154382,154385,22
6931,97,8059,734465,734562,22
4603,115,8080,734451,734566,22
8980,70,8102,564032,564102,22
6549,241,8103,1151082,1151323,22
1118,141,8104,877870,878011,22
6286,278,8105,1211018,1211296,22
2816,45,8110,370362,370407,22
5793,82,8118,564120,564202,22
1708,121,8123,734529,734650,22
8711,160,8124,992087,992247,22
1083,241,8131,1151107,1151348,22
4188,25,8135,154617,154642,22
1061,244,8136,1151119,1151363,22
8487,111,8140,734639,734750,22
1078,25,8159,154676,154701,22
4999,217,8180,1079964,1080181,22
6837,92,8190,734642,734734,22
4160,137,8191,877967,878104,22
8088,203,8211,1079961,1080164,22
6997,76,8213,564327,564403,22
6760,36,8228,370590,370626,22
2739,138,8236,877970,878108,22
5103,17,8238,154825,154842,22
7001,250,8250,1151025,1151275,22
4916,156,8253,992133,992289,22
9266,171,8272,992115,992286,22
7165,231,8275,1151026,1151257,22
2326,150,8284,878070,878220,22
1720,167,8317,992120,992287,22
6430,291,8344,1210797,1211088,22
6127,131,8362,878086,878217,22
9864,102,8368,734818,734920,22
2698,5,8399,154942,154947,22
6185,97,8412,734786,734883,22
2102,233,8419,1150925,1151158,22
9283,195,8419,1079907,1080102,22
4344,278,8422,1210750,1211028,22
2015,6,8425,155037,155043,22
8192,57,8425,370820,370877,22
8443,40,8435,370838,370878,22
2351,279,8444,1210746,1211025,22
1200,37,8451,370863,370900,22
3233,203,8460,1079942,1080145,22
9754,222,8478,1079938,1080160,22
6879,259,8486,1150939,1151198,22
2644,250,8492,1150968,1151218,22
8036,37,8496,370946,370983,22
3145,31,8519,370931,370962,22
8297,169,8521,992234,992403,22
4157,212,8576,1079943,1080155,22
2084,18,8581,155235,155253,22
4260,257,8581,1150905,1151162,22
1756,199,8596,1079981,1080180,22
1813,228,8618,1150901,1151129,22
1537,286,8621,1210588,1210874,22
5306,188,8621,992318,992506,22
9529,61,8621,564742,564803,22
4214,117,8645,735040,735157,22
1761,21,8653,155384,155405,22
8538,82,8655,564741,564823,22
3499,64,8666,564753,564817,22
9082,110,8666,735046,735156,22
6794,241,8691,1150868,1151109,22
3018,195,8694,1079998,1080193,22
3770,114,8707,735089,735203,22
7390,261,8709,1210526,1210787,22
2249,21,8725,155536,155557,22
8801,257,8732,1150880,1151137,22
5123,171,8742,992366,992537,22
4028,57,8766,371226,371283,22
7533,88,8772,564869,564957,22
3745,141,8777,878340,878481,22
7137,90,8783,564918,565008,22
7626,19,8786,155670,155689,22
3890,119,8794,735154,735273,22
5610,185,8810,992314,992499,22
5546,22,8831,155702,155724,22
6634,216,8844,1079924,1080140,22
7069,212,8848,1079947,1080159,22
9461,186,8865,992357,992543,22
2466,53,8887,371373,371426,22
2839,244,8894,1150751,1150995,22
6316,60,8894,565024,565084,22
6980,261,8894,1210342,1210603,22
9845,79,8899,565051,565130,22
2790,22,8903,155884,155906,22
2122,126,8906,878428,878554,22
2716,79,8909,565092,565171,22
8383,296,8917,1210320,1210616,22
5930,167,8925,992430,992597,22
4623,8,8929,155996,156004,22
2049,9,8932,156001,156010,22
2258,139,8934,878470,878609,22
5216,135,8935,878486,878621,22
3248,114,8938,735391,735505,22
8348,33,8952,371662,371695,22
3495,51,8955,371663,371714,22
7394,29,8955,156132,156161,22
5395,28,8970,156146,156174,22
3596,174,8971,992396,992570,22
9253,132,8983,878484,878616,22
3617,88,8991,565247,565335,22
6628,283,8999,1210274,1210557,22
2485,234,9002,1150771,1151005,22
6631,274,9014,1210282,1210556,22
8414,94,9020,735493,735587,22
1110,149,9027,878549,878698,22
1197,114,9110,735439,735553,22
2430,34,9123,371787,371821,22
6274,288,9132,1210178,1210466,22
1277,203,9138,1079925,1080128,22
3865,5,9153,156339,156344,22
6289,289,9153,1210185,1210474,22
3532,222,9163,1079949,1080171,22
2465,25,9189,156366,156391,22
4525,24,9201,156379,156403,22
6268,185,9204,992420,992605,22
5992,201,9208,1079937,1080138,22
7992,262,9210,1210157,1210419,22
7091,284,9211,1210158,1210442,22
9478,77,9219,565482,565559,22
1869,73,9222,565497,565570,22
6483,46,9227,371988,372034,22
6477,59,9235,371997,372056,22
8130,63,9236,565497,565560,22
4445,185,9239,992517,992702,22
3092,170,9243,992543,992713,22
3583,55,9249,372103,372158,22
7024,289,9253,1210140,1210429,22
2229,86,9262,565568,565654,22
1446,123,9264,878702,878825,22
8027,7,9266,156773,156780,22
7352,267,9292,1210130,1210397,22
5649,147,9296,878704,878851,22
9261,105,9296,735725,735830,22
5458,17,9301,156832,156849,22
4989,115,9304,735732,735847,22
9963,54,9309,372279,372333,22
8173,174,9333,992536,992710,22
9706,86,9345,565698,565784,22
7692,9,9352,156914,156923,22
2801,7,9353,156922,156929,22
6907,73,9358,565712,565785,22
5308,31,9366,372337,372368,22
8034,199,9371,1079926,1080125,22
8467,92,9420,735705,735797,22
5300,165,9430,992492,992657,22
5874,239,9446,1150589,1150828,22
7861,22,9452,157004,157026,22
9348,113,9476,735715,735828,22
3704,183,9480,992486,992669,22
3042,242,9495,1150555,1150797,22
2931,26,9496,157069,157095,22
6007,205,9497,1079880,1080085,22
2524,136,9506,878750,878886,22
9512,68,9523,565840,565908,22
4090,131,9526,878744,878875,22
9353,80,9543,565860,565940,22
2069,179,9556,992506,992685,22
5683,245,9557,1150511,1150756,22
3213,16,9566,157228,157244,22
2108,38,9567,372558,372596,22
4800,221,9589,1079839,1080060,22
1841,141,9592,878786,878927,22
5961,239,9595,1150494,1150733,22
2560,241,9596,1150508,1150749,22
4952,243,9597,1150524,1150767,22
3587,226,9620,1150520,1150746,22
4088,36,9637,372677,372713,22
1088,136,9640,878889,879025,22
4943,70,9640,566063,566133,22
8572,252,9653,1150489,1150741,22
4559,282,9658,1209771,1210053,22
2811,226,9687,1150519,1150745,22
2042,255,9732,1150476,1150731,22
3602,179,9743,992683,992862,22
2687,13,9756,157489,157502,22
2695,174,9756,992694,992868,22
4811,18,9804,157483,157501,22
3863,281,9816,1209635,1209916,22
5382,42,9825,372766,372808,22
2944,212,9872,1079903,1080115,22
5505,165,9875,992662,992827,22
9132,58,9890,372774,372832,22
7510,75,9893,566100,566175,22
7426,220,9899,1079899,1080119,22
7824,236,9910,1150365,1150601,22
7443,135,9921,878985,879120,22
4586,31,9940,372873,372904,22
6043,108,9941,736105,736213,22
7797,90,9945,566188,566278,22
2058,49,9950,372925,372974,22
5705,74,9954,566210,566284,22
2307,48,9964,372961,373009,22
6817,7,9967,157773,157780,22
1865,104,9972,736092,736196,22
8283,245,9989,1150298,1150543,22
912,148,50,888906,889054,23
300,69,111,576162,576231,23
632,125,161,888825,888950,23
138,2,193,167696,167698,23
914,194,278,1089627,1089821,23
222,233,306,1160009,1160242,23
403,251,367,1159964,1160215,23
788,3,439,167536,167539,23
606,196,473,1089511,1089707,23
704,176,554,1002232,1002408,23
560,164,718,1002094,1002258,23
374,59,726,575769,575828,23
302,105,782,745579,745684,23
625,53,849,382475,382528,23
4602,237,8011,1152354,1152591,23
9735,81,8016,568541,568622,23
9849,201,8017,1082014,1082215,23
3965,292,8029,1262498,1262790,23
2570,3,8035,160223,160226,23
2436,108,8038,738434,738542,23
1040,174,8057,994868,995042,23
1014,212,8064,1082019,1082231,23
7836,153,8095,994887,995040,23
2120,48,8110,375471,375519,23
8864,81,8114,568647,568728,23
4765,114,8125,738461,738575,23
5375,194,8125,1081987,1082181,23
8982,76,8133,568712,568788,23
5576,202,8137,1081986,1082188,23
6793,159,8143,994908,995067,23
8821,287,8174,1211342,1211629,23
8323,123,8188,881317,881440,23
3765,142,8200,881310,881452,23
4772,156,8209,994884,995040,23
6571,10,8221,160460,160470,23
6944,149,8227,881339,881488,23
9528,96,8229,738632,738728,23
4123,198,8246,1081930,1082128,23
9664,212,8250,1081941,1082153,23
8957,75,8265,568899,568974,23
7013,82,8282,568900,568982,23
5544,259,8287,1211264,1211523,23
4707,47,8304,375790,375837,23
8942,215,8328,1081926,1082141,23
2588,73,8341,568926,568999,23
8947,188,8353,1081933,1082121,23
6441,42,8374,375826,375868,23
7857,188,8376,1081915,1082103,23
7185,218,8379,1152111,1152329,23
7545,208,8402,1081928,1082136,23
7698,77,8439,568964,569041,23
1022,234,8440,1152051,1152285,23
4654,87,8476,568977,569064,23
4995,15,8482,160713,160728,23
8965,276,8495,1211063,1211339,23
2459,80,8501,569012,569092,23
3777,124,8515,881402,881526,23
5312,95,8537,738674,738769,23
3124,66,8543,569053,569119,23
8196,4,8546,160804,160808,23
7879,237,8549,1151994,1152231,23
6906,140,8551,881404,881544,23
7090,281,8557,1211025,1211306,23
1952,63,8576,569119,569182,23
8558,294,8584,1261947,1262241,23
1790,166,8600,994928,995094,23
6930,277,8601,1211046,1211323,23
6496,28,8607,160943,160971,23
7569,134,8608,881497,881631,23
9449,290,8608,1261929,1262219,23
7102,223,8626,1152077,1152300,23
1225,100,8642,738856,738956,23
1917,251,8647,1152062,1152313,23
2159,172,8649,995027,995199,23
2388,295,8672,1261867,1262162,23
5235,165,8696,995035,995200,23
1887,207,8698,1081997,1082204,23
5109,226,8708,1152070,1152296,23
6423,67,8715,569376,569443,23
3823,66,8735,569366,569432,23
7010,155,8755,995057,995212,23
8291,47,8761,376352,376399,23
7203,1,8762,161208,161209,23
4930,144,8793,881616,881760,23
1610,130,8795,881640,881770,23
8450,203,8796,1081957,1082160,23
1160,104,8797,739024,739128,23
9432,199,8812,1081961,1082160,23
8046,183,8825,995058,995241,23
5190,141,8840,881703,881844,23
7826,136,8847,881719,881855,23
2916,47,8856,376508,376555,23
8794,77,8859,569521,569598,23
2293,196,8868,1081921,1082117,23
9755,200,8894,1081908,1082108,23
1754,21,8895,161412,161433,23
3458,127,8908,881740,881867,23
6384,18,8910,161446,161464,23
6119,1,8918,161456,161457,23
2805,181,8933,995049,995230,23
4506,76,8938,569582,569658,23
4972,231,8965,1151822,1152053,23
1821,80,8974,569595,569675,23
3689,277,8977,1210767,1211044,23
2981,93,8981,739167,739260,23
8845,161,8982,995097,995258,23
7860,108,8993,739192,739300,23
5285,151,9036,995054,995205,23
3565,93,9047,739190,739283,23
7121,8,9051,161604,161612,23
3586,285,9055,1210714,1210999,23
7574,170,9062,995062,995232,23
6972,193,9067,1081854,1082047,23
7135,62,9067,569795,569857,23
4743,202,9085,1081846,1082048,23
8894,125,9106,881839,881964,23
4732,109,9111,739287,739396,23
2847,166,9113,995097,995263,23
2970,215,9139,1081811,1082026,23
4420,71,9156,569861,569932,23
6308,252,9197,1151674,1151926,23
9862,176,9235,995057,995233,23
3845,220,9245,1151661,1151881,23
3209,11,9257,161770,161781,23
8506,172,9261,995090,995262,23
2866,232,9281,1151628,1151860,23
8517,130,9281,881895,882025,23
6330,75,9282,569929,570004,23
3874,134,9291,881897,882031,23
7400,252,9292,1151632,1151884,23
4396,283,9296,1210506,1210789,23
9265,36,9314,377055,377091,23
6791,202,9318,1081834,1082036,23
8231,300,9319,1261227,1261527,23
4949,181,9327,995211,995392,23
8892,158,9357,995212,995370,23
1058,270,9358,1210511,1210781,23
9507,40,9367,377155,377195,23
4049,131,9407,882021,882152,23
2925,157,9411,995199,995356,23
8959,189,9423,1081816,1082005,23
9585,112,9425,739584,739696,23
4195,270,9433,1210454,1210724,23
6612,129,9458,882079,882208,23
1019,257,9459,1210446,1210703,23
6124,192,9462,1081851,1082043,23
4544,71,9463,570246,570317,23
2590,156,9464,995285,995441,23
5339,242,9493,1151641,1151883,23
8116,189,9495,1081861,1082050,23
4991,5,9514,162252,162257,23
8016,183,9519,995302,995485,23
4362,64,9529,570314,570378,23
9324,121,9539,882201,882322,23
6830,103,9549,739764,739867,23
7561,196,9562,1081800,1081996,23
8135,264,9567,1210343,1210607,23
6482,183,9571,995349,995532,23
4735,113,9576,739846,739959,23
8958,45,9581,377533,377578,23
3544,267,9590,1210332,1210599,23
9558,25,9597,162454,162479,23
2270,36,9610,377550,377586,23
9031,162,9620,995366,995528,23
8607,112,9622,739888,740000,23
3119,279,9629,1210308,1210587,23
9532,260,9634,1210330,1210590,23
6757,262,9647,1210325,1210587,23
3502,152,9649,995448,995600,23
9879,299,9650,1260908,1261207,23
7651,23,9658,162642,162665,23
6658,279,9669,1210349,1210628,23
4778,212,9714,1081899,1082111,23
7516,232,9727,1151677,1151909,23
7021,266,9729,1210316,1210582,23
8275,191,9757,1081953,1082144,23
1659,145,9766,882457,882602,23
9943,196,9766,1081952,1082148,23
9682,100,9773,740134,740234,23
3121,288,9784,1210275,1210563,23
4280,208,9808,1081957,1082165,23
1298,270,9817,1210278,1210548,23
3429,80,9822,570778,570858,23
9548,136,9828,882550,882686,23
2616,186,9831,1081993,1082179,23
9817,173,9835,995627,995800,23
4631,178,9838,995647,995825,23
3978,231,9847,1151677,1151908,23
8423,230,9865,1151673,1151903,23
9107,89,9890,740309,740398,23
7114,45,9895,378027,378072,23
5398,41,9919,378020,378061,23
7155,190,9921,1081974,1082164,23
9152,98,9923,740309,740407,23
2877,246,9941,1151610,1151856,23
2166,8,9950,163045,163053,23
3142,130,9952,882668,882798,23
7534,220,9955,1151625,1151845,23
7273,100,9984,740352,740452,23
207,287,64,1270514,1270801,24
965,66,135,580909,580975,24
897,16,196,172945,172961,24
417,133,239,892460,892593,24
198,300,392,1270194,1270494,24
348,30,411,387828,387858,24
346,81,427,580686,580767,24
876,177,472,1005275,1005452,24
522,13,485,172807,172820,24
593,92,513,749959,750051,24
476,76,561,580636,580712,24
994,195,647,1091395,1091590,24
437,14,649,172737,172751,24
692,188,712,1091348,1091536,24
570,298,808,1269799,1270097,24
695,59,824,580481,580540,24
566,99,851,749719,749818,24
156,291,972,1269654,1269945,24
1122,259,8019,1212242,1212501,24
2596,80,8057,573339,573419,24
9042,143,8073,884862,885005,24
8884,5,8075,165541,165546,24
2008,32,8080,380526,380558,24
6076,265,8083,1212193,1212458,24
2930,228,8087,1153707,1153935,24
1394,43,8102,380565,380608,24
6967,52,8124,380559,380611,24
6117,130,8155,884871,885001,24
8093,215,8159,1153653,1153868,24
4219,280,8178,1262460,1262740,24
5795,83,8178,573417,573500,24
1144,68,8197,573426,573494,24
2440,156,8201,997866,998022,24
3347,10,8204,165714,165724,24
3159,299,8214,1262425,1262724,24
4736,268,8214,1212153,1212421,24
6078,144,8216,884981,885125,24
7572,150,8217,997925,998075,24
2800,74,8219,573562,573636,24
3494,236,8226,1153693,1153929,24
7007,10,8230,165860,165870,24
3985,155,8321,997858,998013,24
1422,269,8330,1212061,1212330,24
1323,7,8339,165815,165822,24
1895,5,8339,165822,165827,24
2407,44,8353,380747,380791,24
5029,61,8394,573493,573554,24
5264,12,8432,165788,165800,24
4501,138,8433,884918,885056,24
2506,257,8442,1211974,1212231,24
7041,19,8448,165838,165857,24
8964,62,8464,573487,573549,24
9743,270,8468,1211961,1212231,24
9954,24,8469,165890,165914,24
8766,123,8482,884955,885078,24
7195,78,8484,573532,573610,24
2305,29,8486,380827,380856,24
1921,280,8496,1262163,1262443,24
8943,21,8503,165988,166009,24
5687,140,8506,884971,885111,24
1126,205,8507,1084026,1084231,24
3262,168,8527,997822,997990,24
7819,209,8539,1084022,1084231,24
9611,62,8542,573642,573704,24
7493,216,8562,1153519,1153735,24
2347,250,8566,1211924,1212174,24
6447,258,8577,1211919,1212177,24
3636,169,8587,997913,998082,24
1434,103,8621,742834,742937,24
1437,125,8656,885064,885189,24
5327,161,8663,997861,998022,24
6084,264,8665,1211845,1212109,24
7981,296,8665,1261995,1262291,24
3387,140,8666,885158,885298,24
2252,298,8669,1262008,1262306,24
5241,172,8670,997966,998138,24
6633,93,8678,743006,743099,24
4733,126,8695,885217,885343,24
2879,285,8708,1261988,1262273,24
2563,115,8716,885239,885354,24
8613,82,8718,573937,574019,24
6214,123,8721,885235,885358,24
2895,154,8734,997961,998115,24
5552,109,8737,743106,743215,24
2411,137,8742,885254,885391,24
5061,254,8744,1211891,1212145,24
1222,6,8753,166488,166494,24
2344,116,8760,885290,885406,24
6230,37,8763,381364,381401,24
7927,78,8767,574089,574167,24
8189,78,8771,574108,574186,24
5421,116,8772,885280,885396,24
4767,274,8777,1211868,1212142,24
5771,291,8812,1261890,1262181,24
5593,138,8816,885300,885438,24
8464,135,8817,885323,885458,24
1940,222,8820,1153573,1153795,24
9537,229,8829,1153576,1153805,24
2796,14,8882,166662,166676,24
4000,38,8887,381502,381540,24
7761,246,8891,1211819,1212065,24
1327,286,8899,1261815,1262101,24
3716,186,8902,1084153,1084339,24
9747,297,8904,1261817,1262114,24
7578,253,8907,1211875,1212128,24
3273,72,8910,574340,574412,24
6051,130,8938,885440,885570,24
4675,251,8963,1211828,1212079,24
7506,295,8974,1261765,1262060,24
7564,48,8975,381677,381725,24
1572,39,8976,381697,381736,24
3147,29,9009,381676,381705,24
4200,55,9018,381669,381724,24
5835,39,9024,381691,381730,24
8562,3,9028,166935,166938,24
3962,284,9043,1261712,1261996,24
7899,118,9074,885413,885531,24
5088,25,9082,166938,166963,24
3856,265,9093,1211775,1212040,24
9123,289,9108,1261652,1261941,24
5166,260,9109,1211815,1212075,24
1056,157,9126,998090,998247,24
9057,2,9134,167019,167021,24
4589,242,9166,1153598,1153840,24
2536,231,9173,1153623,1153854,24
4152,291,9179,1261591,1261882,24
4892,36,9187,381792,381828,24
5964,205,9193,1084234,1084439,24
8490,136,9204,885535,885671,24
1117,54,9214,381830,381884,24
2191,12,9219,167125,167137,24
7123,59,9228,574445,574504,24
6500,66,9235,574442,574508,24
6537,197,9269,1084186,1084383,24
6666,104,9275,743493,743597,24
9799,40,9303,381880,381920,24
2256,152,9310,998078,998230,24
1986,144,9315,885508,885652,24
8366,191,9326,1084149,1084340,24
5026,136,9362,885522,885658,24
8627,128,9419,885487,885615,24
3191,229,9443,1153408,1153637,24
8162,235,9452,1153418,1153653,24
9481,26,9463,167217,167243,24
5763,158,9488,998003,998161,24
1229,7,9508,167225,167232,24
9803,237,9527,1153368,1153605,24
7889,103,9542,743516,743619,24
3560,218,9544,1153378,1153596,24
4418,122,9545,885530,885652,24
9077,202,9548,1084073,1084275,24
5319,12,9568,167307,167319,24
8338,94,9573,743594,743688,24
1963,286,9579,1261203,1261489,24
8458,160,9589,998043,998203,24
5247,186,9601,1084078,1084264,24
2490,119,9607,885600,885719,24
8877,130,9610,885602,885732,24
9730,179,9613,1084075,1084254,24
5076,297,9623,1261166,1261463,24
4789,247,9624,1211421,1211668,24
7466,195,9634,1084122,1084317,24
8131,215,9657,1153375,1153590,24
5287,242,9660,1153377,1153619,24
5822,141,9662,885752,885893,24
2296,142,9668,885773,885915,24
7745,103,9672,743895,743998,24
5464,72,9683,574875,574947,24
9091,196,9686,1084154,1084350,24
3640,194,9687,1084172,1084366,24
1845,53,9703,382361,382414,24
8870,98,9704,743942,744040,24
4006,240,9710,1153359,1153599,24
8535,178,9710,1084199,1084377,24
4454,21,9717,167764,167785,24
4875,46,9722,382452,382498,24
7163,108,9732,743988,744096,24
2935,202,9740,1084170,1084372,24
4613,122,9758,885866,885988,24
8949,148,9758,998273,998421,24
4686,50,9772,382533,382583,24
5696,47,9783,382545,382592,24
4246,153,9803,998231,998384,24
3200,53,9823,382553,382606,24
3154,68,9824,575041,575109,24
7228,52,9834,382596,382648,24
1129,289,9837,1260970,1261259,24
2529,195,9850,1084118,1084313,24
5633,230,9855,1153278,1153508,24
3597,65,9872,575093,575158,24
6748,252,9877,1211206,1211458,24
9285,187,9900,1084152,1084339,24
4711,1,9912,168049,168050,24
7513,26,9913,168049,168075,24
3570,34,9922,382701,382735,24
8531,182,9946,1084116,1084298,24
9633,201,9959,1084108,1084309,24
4428,45,9965,382721,382766,24
2908,299,9969,1260848,1261147,24
6239,70,9972,575148,575218,24
196,213,69,1163159,1163372,25
894,202,108,1094054,1094256,25
907,230,114,1163124,1163354,25
297,152,131,1008265,1008417,25
713,161,133,1008275,1008436,25
935,292,147,1270699,1270991,25
618,216,232,1163066,1163282,25
330,272,292,1270576,1270848,25
144,236,341,1163003,1163239,25
986,276,347,1270523,1270799,25
513,186,348,1094037,1094223,25
449,65,395,585050,585115,25
141,161,438,1008177,1008338,25
314,76,480,585005,585081,25
992,1,569,177945,177946,25
264,69,654,584854,584923,25
428,150,689,1007947,1008097,25
766,196,767,1093633,1093829,25
640,254,791,1220445,1220699,25
231,57,862,584746,584803,25
8643,2,8002,170643,170645,25
3073,186,8004,1086453,1086639,25
4319,179,8013,1086459,1086638,25
4448,181,8026,1086454,1086635,25
2719,80,8030,577666,577746,25
5093,8,8031,170720,170728,25
5813,112,8031,888455,888567,25
3584,76,8033,577718,577794,25
7093,42,8063,385373,385415,25
8024,156,8076,1000725,1000881,25
4828,120,8105,888413,888533,25
1692,250,8111,1213143,1213393,25
4394,91,8115,746630,746721,25
4812,4,8118,170823,170827,25
4942,65,8135,577751,577816,25
5996,59,8135,577763,577822,25
7900,298,8147,1262729,1263027,25
4479,291,8150,1262754,1263045,25
9061,222,8150,1155392,1155614,25
1622,166,8163,1000778,1000944,25
4835,75,8184,577832,577907,25
9622,271,8189,1262736,1263007,25
6648,4,8208,170945,170949,25
3843,279,8212,1262714,1262993,25
3291,103,8223,746706,746809,25
1775,31,8254,385576,385607,25
3416,190,8254,1086428,1086618,25
3325,128,8260,888508,888636,25
6810,32,8264,385625,385657,25
9213,30,8287,385608,385638,25
6144,92,8294,746715,746807,25
4521,178,8303,1086398,1086576,25
3696,151,8311,1000780,1000931,25
6022,101,8324,746754,746855,25
8991,178,8343,1086365,1086543,25
6583,161,8385,1000748,1000909,25
9372,8,8398,171097,171105,25
9438,98,8398,746758,746856,25
4287,277,8425,1262510,1262787,25
6459,19,8426,171129,171148,25
7336,195,8450,1086297,1086492,25
4316,82,8469,746762,746844,25
5164,195,8470,1086301,1086496,25
5153,292,8481,1262461,1262753,25
9440,294,8490,1262474,1262768,25
8692,241,8514,1212992,1213233,25
5693,23,8529,171201,171224,25
1073,198,8569,1086322,1086520,25
8373,138,8579,888537,888675,25
4131,294,8580,1262408,1262702,25
2136,295,8585,1262427,1262722,25
2419,244,8618,1212961,1213205,25
7488,4,8621,171262,171266,25
4860,65,8647,578063,578128,25
8307,106,8663,746830,746936,25
5772,277,8670,1262367,1262644,25
6779,52,8677,385816,385868,25
8489,58,8677,578101,578159,25
8100,87,8680,746867,746954,25
4330,195,8700,1086346,1086541,25
8723,119,8709,888585,888704,25
7243,286,8720,1262324,1262610,25
2933,113,8734,888599,888712,25
6577,11,8744,171403,171414,25
2218,220,8749,1155175,1155395,25
4071,23,8753,171431,171454,25
2984,100,8766,746932,747032,25
1507,129,8780,888586,888715,25
5070,90,8782,746964,747054,25
4881,231,8808,1155133,1155364,25
2528,208,8810,1155159,1155367,25
6178,41,8820,386023,386064,25
8280,169,8830,1000820,1000989,25
2434,6,8831,171558,171564,25
5707,252,8835,1212820,1213072,25
7070,112,8838,888667,888779,25
9668,293,8838,1262222,1262515,25
3976,55,8868,578335,578390,25
2789,256,8869,1212836,1213092,25
7538,37,8873,386147,386184,25
9100,182,8881,1086413,1086595,25
9037,154,8889,1000914,1001068,25
3967,274,8896,1262187,1262461,25
8369,20,8902,171727,171747,25
5775,108,8916,747129,747237,25
1260,239,8920,1212839,1213078,25
9556,284,8920,1262167,1262451,25
2568,47,8923,386270,386317,25
8691,162,8925,1000985,1001147,25
5249,222,8945,1155227,1155449,25
7055,17,8949,171856,171873,25
2062,160,8964,1000999,1001159,25
2943,125,8979,888828,888953,25
2248,211,8984,1155207,1155418,25
9680,20,9013,171887,171907,25
7161,24,9020,171900,171924,25
1717,235,9021,1155178,1155413,25
9951,169,9040,1001005,1001174,25
2076,273,9049,1262052,1262325,25
9644,279,9051,1262053,1262332,25
8017,159,9086,1001050,1001209,25
2924,217,9089,1155208,1155425,25
6809,88,9097,747352,747440,25
2782,298,9101,1262012,1262310,25
5288,174,9119,1086506,1086680,25
5337,16,9128,172050,172066,25
3496,112,9131,888961,889073,25
3001,25,9134,172086,172111,25
5431,187,9147,1086481,1086668,25
4430,151,9152,1001127,1001278,25
9886,120,9166,888988,889108,25
6602,40,9183,386517,386557,25
6570,107,9186,747444,747551,25
9189,190,9200,1086444,1086634,25
5095,58,9213,578748,578806,25
1412,155,9231,1001090,1001245,25
8354,123,9246,888978,889101,25
9594,108,9273,747470,747578,25
9224,258,9275,1212623,1212881,25
3272,161,9285,1001082,1001243,25
3289,132,9302,888995,889127,25
9048,199,9304,1086391,1086590,25
9215,241,9331,1212589,1212830,25
8561,31,9342,386669,386700,25
1959,7,9354,172307,172314,25
8431,148,9365,1001085,1001233,25
5175,159,9367,1001091,1001250,25
8652,23,9367,172353,172376,25
7540,219,9421,1154989,1155208,25
6172,200,9423,1086364,1086564,25
4697,198,9429,1086387,1086585,25
3369,215,9441,1154985,1155200,25
7403,248,9445,1212480,1212728,25
5611,102,9456,747662,747764,25
1414,35,9485,386747,386782,25
5129,295,9498,1261643,1261938,25
9693,249,9512,1212459,1212708,25
4531,134,9523,889126,889260,25
8108,148,9533,1001161,1001309,25
7762,194,9534,1086437,1086631,25
5062,62,9569,578985,579047,25
1601,29,9575,386828,386857,25
1159,259,9583,1212401,1212660,25
7329,298,9628,1261538,1261836,25
3888,295,9639,1261555,1261850,25
4914,184,9639,1086451,1086635,25
4134,25,9678,172533,172558,25
1461,299,9700,1261519,1261818,25
6896,40,9703,386838,386878,25
3471,156,9721,1001167,1001323,25
2127,149,9726,1001178,1001327,25
4317,299,9733,1261515,1261814,25
2818,274,9749,1261528,1261802,25
5055,72,9750,579065,579137,25
8498,213,9758,1154977,1155190,25
3771,47,9781,386936,386983,25
9418,185,9793,1086438,1086623,25
9606,253,9800,1212377,1212630,25
8321,95,9830,747802,747897,25
3531,289,9859,1261422,1261711,25
3503,54,9861,579113,579167,25
6586,203,9883,1086426,1086629,25
7244,127,9883,889270,889397,25
9311,6,9891,172761,172767,25
9885,149,9891,1001239,1001388,25
2938,286,9899,1261401,1261687,25
8601,54,9910,579177,579231,25
2446,47,9918,387090,387137,25
2278,12,9933,172829,172841,25
8768,240,9935,1212327,1212567,25
4685,246,9941,1212325,1212571,25
4985,43,9961,387122,387165,25
6731,147,9967,1001265,1001412,25
7575,63,9977,579195,579258,25
4248,19,9998,172906,172925,25
6590,70,9999,579183,579253,25
840,34,114,397068,397102,26
453,217,139,1164778,1164995,26
359,74,141,589087,589161,26
376,201,157,1164781,1164982,26
822,4,157,182892,182896,26
871,175,195,1096310,1096485,26
957,74,217,589088,589162,26
783,19,309,182794,182813,26
336,119,340,899071,899190,26
915,232,349,1221935,1222167,26
313,78,384,588998,589076,26
492,231,514,1221774,1222005,26
115,223,569,1164438,1164661,26
744,269,643,1270682,1270951,26
928,172,658,1095981,1096153,26
446,262,690,1270643,1270905,26
411,14,712,182610,182624,26
526,65,866,588678,588743,26
324,44,874,396681,396725,26
615,38,877,396697,396735,26
808,26,905,396682,396708,26
303,4,954,182482,182486,26
2026,236,8046,1214311,1214547,26
4741,52,8046,581539,581591,26
2968,187,8058,1088650,1088837,26
5802,283,8080,1263254,1263537,26
4689,266,8098,1263258,1263524,26
7391,93,8115,750158,750251,26
8855,227,8139,1157055,1157282,26
6778,77,8142,581579,581656,26
1130,159,8143,1003521,1003680,26
1742,160,8158,1003530,1003690,26
4833,39,8180,389668,389707,26
8779,130,8184,891617,891747,26
8922,40,8186,389702,389742,26
7198,11,8195,175570,175581,26
5514,282,8211,1263150,1263432,26
5106,48,8230,389699,389747,26
3197,238,8243,1214221,1214459,26
8478,126,8246,891637,891763,26
3866,263,8257,1263125,1263388,26
4565,241,8263,1214244,1214485,26
9692,18,8293,175633,175651,26
6033,86,8308,750232,750318,26
1382,86,8333,750215,750301,26
4441,23,8345,175649,175672,26
5678,119,8356,891605,891724,26
8416,229,8363,1214157,1214386,26
8179,65,8374,581697,581762,26
5320,124,8403,891600,891724,26
3066,257,8411,1214110,1214367,26
8421,280,8419,1262965,1263245,26
5550,88,8434,750262,750350,26
9776,147,8438,1003485,1003632,26
5415,118,8454,891654,891772,26
6360,6,8464,175778,175784,26
3021,183,8477,1088563,1088746,26
4092,237,8478,1214105,1214342,26
7014,175,8489,1088600,1088775,26
1196,108,8500,891707,891815,26
5984,274,8502,1262901,1263175,26
9199,12,8527,175846,175858,26
3568,54,8536,581846,581900,26
6545,139,8537,1003518,1003657,26
6264,24,8561,175874,175898,26
5542,191,8576,1088554,1088745,26
5572,195,8579,1088577,1088772,26
2056,93,8590,750396,750489,26
9081,148,8591,1003528,1003676,26
2539,70,8592,581928,581998,26
9043,117,8595,891759,891876,26
8058,21,8598,176011,176032,26
9391,95,8600,750457,750552,26
2749,232,8623,1214002,1214234,26
8429,281,8624,1262792,1263073,26
4895,32,8640,390118,390150,26
7353,189,8644,1088604,1088793,26
1862,141,8673,1003549,1003690,26
1292,14,8684,176096,176110,26
1179,195,8693,1088579,1088774,26
8003,231,8709,1213953,1214184,26
7197,125,8715,891824,891949,26
6823,109,8721,891837,891946,26
5394,31,8723,390198,390229,26
1291,98,8731,750567,750665,26
6101,202,8734,1156875,1157077,26
5074,185,8735,1088629,1088814,26
9599,54,8744,582146,582200,26
3136,175,8745,1088639,1088814,26
3344,291,8750,1262686,1262977,26
6558,30,8754,390329,390359,26
4144,71,8755,582192,582263,26
4517,5,8760,176359,176364,26
3238,166,8786,1088639,1088805,26
9086,275,8802,1262664,1262939,26
9732,33,8802,390364,390397,26
4153,241,8810,1213921,1214162,26
6197,68,8811,582237,582305,26
8978,243,8815,1213929,1214172,26
9557,183,8822,1088697,1088880,26
3449,40,8826,390452,390492,26
2610,102,8830,750740,750842,26
1326,240,8834,1213925,1214165,26
3160,232,8844,1213927,1214159,26
4139,59,8852,582348,582407,26
2844,64,8858,582350,582414,26
2458,4,8878,176571,176575,26
4034,216,8915,1156892,1157108,26
5021,19,8963,176515,176534,26
8079,233,9021,1213754,1213987,26
9336,69,9068,582207,582276,26
9270,206,9104,1156755,1156961,26
3417,75,9107,582213,582288,26
9289,36,9110,390443,390479,26
2234,258,9134,1213646,1213904,26
3757,11,9156,176491,176502,26
9272,181,9158,1088565,1088746,26
5004,142,9160,1003608,1003750,26
8415,32,9183,390459,390491,26
5469,229,9213,1213597,1213826,26
1556,91,9215,750631,750722,26
9695,284,9237,1262243,1262527,26
1924,255,9256,1213588,1213843,26
9323,160,9294,1003571,1003731,26
5121,252,9297,1213574,1213826,26
3385,61,9323,582264,582325,26
3630,294,9323,1262180,1262474,26
8764,230,9327,1213601,1213831,26
1746,101,9329,750698,750799,26
1797,240,9329,1213601,1213841,26
6838,61,9331,582374,582435,26
3336,12,9334,176699,176711,26
9467,264,9337,1262199,1262463,26
8391,223,9354,1156803,1157026,26
4309,64,9361,582408,582472,26
1207,196,9385,1088633,1088829,26
1208,147,9397,1003703,1003850,26
6761,112,9402,892000,892112,26
6126,142,9415,1003697,1003839,26
1176,298,9421,1304525,1304823,26
8913,51,9432,390737,390788,26
7805,231,9466,1213542,1213773,26
9980,60,9471,582473,582533,26
3555,44,9502,390745,390789,26
4998,256,9519,1213492,1213748,26
7063,188,9522,1088620,1088808,26
7295,269,9527,1262046,1262315,26
5916,98,9529,750857,750955,26
5334,37,9535,390835,390872,26
6321,287,9536,1262045,1262332,26
5904,260,9541,1213564,1213824,26
1076,161,9555,1003774,1003935,26
8400,141,9569,1003786,1003927,26
3824,286,9571,1262036,1262322,26
1580,200,9573,1156835,1157035,26
2641,181,9582,1088738,1088919,26
2315,268,9590,1262042,1262310,26
8092,33,9594,390996,391029,26
9021,172,9609,1088758,1088930,26
4110,228,9615,1156829,1157057,26
1804,42,9657,390993,391035,26
4293,57,9674,582657,582714,26
4698,247,9680,1213523,1213770,26
8491,124,9687,892214,892338,26
7489,300,9699,1304250,1304550,26
4415,297,9709,1304245,1304542,26
3872,258,9710,1213578,1213836,26
3409,106,9712,751114,751220,26
9587,268,9722,1261985,1262253,26
4230,139,9724,1003967,1004106,26
1669,26,9732,391169,391195,26
5146,64,9734,582819,582883,26
8216,10,9741,177304,177314,26
8600,10,9741,177314,177324,26
7448,239,9745,1213606,1213845,26
1232,180,9750,1088841,1089021,26
9711,172,9754,1088852,1089024,26
4953,251,9772,1213590,1213841,26
3455,251,9778,1213607,1213858,26
1057,276,9789,1261925,1262201,26
5619,167,9794,1088912,1089079,26
8013,296,9795,1304161,1304457,26
6093,248,9800,1213674,1213922,26
4683,289,9808,1261955,1262244,26
5008,199,9822,1157038,1157237,26
3522,44,9825,391389,391433,26
3497,296,9827,1304130,1304426,26
5479,87,9829,751417,751504,26
1586,66,9838,583079,583145,26
7849,214,9839,1157056,1157270,26
5492,279,9864,1261961,1262240,26
9551,234,9866,1213727,1213961,26
3710,161,9873,1004272,1004433,26
5677,242,9874,1213725,1213967,26
5846,9,9891,177674,177683,26
7847,47,9897,391544,391591,26
3328,184,9898,1089089,1089273,26
2537,257,9906,1213707,1213964,26
2882,113,9922,892693,892806,26
5043,204,9929,1157112,1157316,26
3373,11,9935,177764,177775,26
5612,154,9941,1004350,1004504,26
4128,135,9949,892731,892866,26
8315,13,9950,177810,177823,26
3542,87,9976,751587,751674,26
1560,220,9986,1157063,1157283,26
9406,36,9990,391681,391717,26
173,193,77,1167003,1167196,27
742,29,137,401571,401600,27
113,196,140,1166944,1167140,27
779,180,184,1098981,1099161,27
510,110,206,902620,902730,27
793,106,266,902568,902674,27
726,129,311,902527,902656,27
186,65,350,593091,593156,27
888,229,382,1223268,1223497,27
939,205,415,1166707,1166912,27
165,38,418,401495,401533,27
893,80,446,761373,761453,27
775,17,459,187677,187694,27
270,266,483,1271369,1271635,27
921,37,564,401413,401450,27
867,146,603,1013916,1014062,27
245,100,618,761260,761360,27
368,86,693,761210,761296,27
961,189,898,1098378,1098567,27
884,90,923,761018,761108,27
700,234,952,1222739,1222973,27
261,178,959,1098377,1098555,27
1839,207,8005,1159195,1159402,27
4228,123,8007,895082,895205,27
7157,218,8051,1159167,1159385,27
1290,49,8070,394170,394219,27
4338,96,8073,754018,754114,27
4220,72,8084,585763,585835,27
8537,42,8093,394222,394264,27
2545,13,8095,180442,180455,27
5155,300,8099,1305869,1306169,27
1035,101,8115,754024,754125,27
4830,111,8116,895050,895161,27
8625,295,8119,1305864,1306159,27
9719,83,8139,754080,754163,27
7686,204,8158,1159151,1159355,27
5178,136,8204,1006563,1006699,27
1017,239,8208,1215561,1215800,27
1830,228,8212,1215576,1215804,27
2679,235,8241,1215555,1215790,27
4754,5,8243,180547,180552,27
2575,235,8253,1215558,1215793,27
1281,204,8262,1159186,1159390,27
5766,290,8264,1305729,1306019,27
9363,185,8268,1091417,1091602,27
6183,103,8278,895177,895280,27
4871,289,8306,1305692,1305981,27
7613,148,8316,1006689,1006837,27
2762,17,8320,180643,180660,27
6732,72,8328,585984,586056,27
5315,196,8335,1159190,1159386,27
4190,180,8337,1091434,1091614,27
3619,32,8339,394494,394526,27
1514,119,8362,895206,895325,27
3830,197,8370,1159162,1159359,27
5142,75,8377,586062,586137,27
2549,285,8404,1263594,1263879,27
5858,31,8409,394532,394563,27
7207,68,8439,586052,586120,27
7586,122,8459,895182,895304,27
5878,97,8462,754251,754348,27
3490,16,8485,180783,180799,27
1289,255,8501,1263530,1263785,27
7302,118,8508,895181,895299,27
3894,128,8532,895173,895301,27
4382,122,8537,895194,895316,27
2141,186,8539,1091343,1091529,27
5396,147,8541,1006656,1006803,27
3436,286,8552,1305450,1305736,27
8859,266,8576,1263491,1263757,27
2499,195,8580,1159084,1159279,27
8453,278,8582,1263499,1263777,27
4920,2,8586,180938,180940,27
1962,133,8624,1006706,1006839,27
6179,46,8630,394668,394714,27
8201,144,8641,1006692,1006836,27
4746,81,8665,754394,754475,27
9751,121,8679,895296,895417,27
2775,238,8700,1215350,1215588,27
2327,212,8735,1158997,1159209,27
5829,300,8735,1305268,1305568,27
5702,282,8743,1263397,1263679,27
7543,259,8759,1263411,1263670,27
3694,53,8762,586294,586347,27
3680,293,8777,1305241,1305534,27
4156,250,8777,1215419,1215669,27
2828,199,8807,1159103,1159302,27
7767,133,8815,1006764,1006897,27
5531,55,8844,586320,586375,27
9945,100,8849,754486,754586,27
1217,78,8852,754508,754586,27
3051,29,8861,394859,394888,27
4487,92,8917,754446,754538,27
4095,51,8955,586293,586344,27
1883,236,9000,1215226,1215462,27
7247,106,9000,895274,895380,27
8425,207,9001,1158950,1159157,27
2672,160,9005,1091324,1091484,27
9499,222,9022,1215220,1215442,27
6042,97,9038,754477,754574,27
2431,21,9041,181133,181154,27
6235,26,9045,394880,394906,27
5526,210,9046,1158954,1159164,27
7961,236,9061,1215183,1215419,27
1032,208,9063,1158989,1159197,27
4288,62,9069,586415,586477,27
6300,185,9086,1091364,1091549,27
7544,228,9088,1215172,1215400,27
1148,108,9091,895411,895519,27
2869,243,9097,1215171,1215414,27
9697,119,9158,895378,895497,27
3672,175,9164,1091372,1091547,27
3354,227,9191,1215100,1215327,27
2469,210,9197,1158967,1159177,27
1447,29,9200,395027,395056,27
5733,261,9204,1263006,1263267,27
7933,53,9207,586524,586577,27
4459,126,9223,895442,895568,27
3307,228,9228,1215102,1215330,27
4699,41,9232,395100,395141,27
1718,277,9253,1262966,1263243,27
4785,149,9276,1006770,1006919,27
2741,248,9292,1215078,1215326,27
4866,233,9292,1215106,1215339,27
2402,90,9295,754728,754818,27
4618,172,9314,1091448,1091620,27
4508,3,9335,181460,181463,27
1511,185,9355,1091420,1091605,27
5928,211,9376,1158964,1159175,27
2823,213,9377,1158985,1159198,27
7583,205,9387,1158999,1159204,27
2783,19,9391,181503,181522,27
6531,129,9408,895561,895690,27
9893,271,9417,1262827,1263098,27
1145,245,9421,1215022,1215267,27
3817,128,9433,895619,895747,27
5884,35,9438,395261,395296,27
6319,25,9470,395240,395265,27
4899,51,9476,586675,586726,27
3761,124,9480,895598,895722,27
2346,258,9483,1262780,1263038,27
6402,125,9486,895642,895767,27
5436,261,9487,1262782,1263043,27
8699,225,9511,1215021,1215246,27
6225,87,9520,754896,754983,27
3194,125,9525,895682,895807,27
7309,173,9528,1091513,1091686,27
6417,193,9551,1159006,1159199,27
2740,3,9554,181743,181746,27
6901,53,9582,586805,586858,27
4469,179,9585,1091500,1091679,27
7813,67,9587,586830,586897,27
4084,40,9592,395444,395484,27
1235,125,9598,895716,895841,27
9111,37,9637,395440,395477,27
8169,176,9648,1091457,1091633,27
2123,131,9666,1006863,1006994,27
5958,235,9671,1214866,1215101,27
7693,50,9678,586861,586911,27
8049,156,9680,1006879,1007035,27
7956,182,9689,1091463,1091645,27
8378,242,9704,1214848,1215090,27
1220,274,9724,1262554,1262828,27
6546,193,9732,1158922,1159115,27
8669,246,9754,1214852,1215098,27
4664,167,9755,1091540,1091707,27
6638,23,9794,181914,181937,27
7993,278,9796,1262504,1262782,27
8661,109,9810,895835,895944,27
6219,276,9814,1262512,1262788,27
8875,86,9841,755073,755159,27
1947,147,9868,1006949,1007096,27
7305,224,9868,1214828,1215052,27
8603,290,9883,1304143,1304433,27
1383,146,9894,1006998,1007144,27
3475,87,9906,755127,755214,27
9705,66,9912,587044,587110,27
6541,183,9922,1091501,1091684,27
2735,122,9923,895897,896019,27
1710,68,9936,587089,587157,27
5242,219,9941,1158872,1159091,27
1558,38,9952,395763,395801,27
6978,88,9954,755172,755260,27
7077,284,9958,1262425,1262709,27
6606,117,9982,895914,896031,27
4519,65,9989,587159,587224,27
916,94,109,765087,765181,28
598,222,142,1224630,1224852,28
547,46,150,405728,405774,28
651,183,168,1168743,1168926,28
271,142,188,1016868,1017010,28
455,53,235,597031,597084,28
340,217,358,1224424,1224641,28
527,18,379,191969,191987,28
136,29,416,405581,405610,28
920,37,445,405558,405595,28
373,208,503,1168439,1168647,28
747,116,577,905473,905589,28
797,283,683,1313358,1313641,28
597,269,709,1271747,1272016,28
378,134,727,1016458,1016592,28
320,296,730,1313319,1313615,28
655,168,760,1100956,1101124,28
108,16,802,191771,191787,28
106,80,826,764678,764758,28
578,38,834,405375,405413,28
614,293,868,1313202,1313495,28
948,59,927,596595,596654,28
599,22,943,191738,191760,28
3203,218,8027,1216884,1217102,28
5053,299,8028,1306060,1306359,28
5186,288,8036,1306076,1306364,28
3714,151,8039,1009323,1009474,28
7029,150,8043,1009345,1009495,28
1053,88,8070,757598,757686,28
8578,228,8072,1216907,1217135,28
5037,41,8074,398366,398407,28
3245,159,8078,1093798,1093957,28
2319,47,8091,398391,398438,28
5299,100,8093,898326,898426,28
3460,123,8101,898320,898443,28
6819,181,8108,1093774,1093955,28
9120,60,8118,589691,589751,28
4277,283,8135,1305990,1306273,28
5197,86,8136,757704,757790,28
1679,125,8147,898353,898478,28
6645,72,8170,589727,589799,28
4744,82,8191,757689,757771,28
1733,61,8204,589743,589804,28
5865,288,8233,1305900,1306188,28
4865,4,8238,184948,184952,28
6690,17,8240,184950,184967,28
2595,264,8250,1264424,1264688,28
2066,62,8260,589751,589813,28
3909,258,8290,1264405,1264663,28
3164,29,8325,398517,398546,28
3253,241,8330,1216789,1217030,28
3329,119,8331,898304,898423,28
7451,241,8331,1216817,1217058,28
4432,148,8350,1009315,1009463,28
5233,113,8376,898334,898447,28
4041,293,8405,1305741,1306034,28
3728,244,8407,1264335,1264579,28
9833,79,8408,757742,757821,28
2974,47,8437,398603,398650,28
4292,283,8438,1305726,1306009,28
3855,10,8460,185069,185079,28
5268,44,8462,398626,398670,28
3896,100,8478,898328,898428,28
6563,157,8503,1093668,1093825,28
6846,85,8506,757729,757814,28
6086,107,8533,898302,898409,28
9740,3,8555,185099,185102,28
5200,168,8561,1093614,1093782,28
9929,138,8563,1009265,1009403,28
1858,17,8564,185139,185156,28
5385,37,8574,398679,398716,28
8709,28,8586,398681,398709,28
1931,124,8591,898307,898431,28
7322,63,8600,589851,589914,28
3671,37,8602,398718,398755,28
2914,189,8609,1160869,1161058,28
8407,174,8611,1093608,1093782,28
9858,148,8613,1009284,1009432,28
1516,117,8618,898387,898504,28
6905,164,8629,1093611,1093775,28
8901,285,8641,1305531,1305816,28
5208,34,8642,398836,398870,28
5943,300,8643,1305539,1305839,28
8156,81,8670,757864,757945,28
2561,31,8685,398852,398883,28
2589,162,8685,1093624,1093786,28
1694,160,8700,1093618,1093778,28
3924,126,8712,1009348,1009474,28
3133,299,8717,1305490,1305789,28
3681,228,8720,1216643,1216871,28
7038,35,8720,398945,398980,28
3236,96,8750,757923,758019,28
5262,17,8758,185468,185485,28
3900,95,8769,757928,758023,28
1682,122,8774,898466,898588,28
6704,94,8778,757968,758062,28
7619,195,8789,1160816,1161011,28
6516,17,8803,185532,185549,28
1688,76,8827,757967,758043,28
7892,92,8835,757963,758055,28
9679,120,8847,898444,898564,28
1623,50,8855,590137,590187,28
7460,132,8859,1009286,1009418,28
4325,100,8867,898473,898573,28
2682,276,8885,1305346,1305622,28
5231,177,8887,1093554,1093731,28
7842,292,8902,1305330,1305622,28
5910,257,8925,1264010,1264267,28
6142,263,8948,1264001,1264264,28
7722,72,8953,590217,590289,28
1371,204,8966,1160772,1160976,28
4050,128,8975,1009345,1009473,28
2518,1,8985,185689,185690,28
3913,36,8997,399136,399172,28
2541,60,9011,590234,590294,28
1815,111,9018,898513,898624,28
6601,128,9034,1009289,1009417,28
6672,247,9034,1263935,1264182,28
9722,117,9040,898558,898675,28
7117,295,9049,1305200,1305495,28
5179,213,9051,1216514,1216727,28
6619,156,9068,1093600,1093756,28
6850,134,9072,1009366,1009500,28
9421,298,9072,1305197,1305495,28
3389,128,9074,1009401,1009529,28
4846,10,9083,185868,185878,28
7395,72,9089,590419,590491,28
1357,202,9090,1160790,1160992,28
6774,206,9098,1160802,1161008,28
4968,279,9100,1305192,1305471,28
6065,97,9102,758314,758411,28
6488,260,9112,1263957,1264217,28
5274,230,9124,1216535,1216765,28
2554,279,9131,1305165,1305444,28
4550,177,9142,1093732,1093909,28
4621,8,9149,186019,186027,28
4692,268,9168,1263950,1264218,28
5566,218,9170,1216569,1216787,28
9536,112,9194,898828,898940,28
9852,279,9197,1305103,1305382,28
1250,146,9203,1009555,1009701,28
5048,283,9218,1305086,1305369,28
5329,64,9224,590659,590723,28
9714,254,9228,1263979,1264233,28
6067,97,9229,758498,758595,28
6052,49,9246,590704,590753,28
9267,70,9250,590702,590772,28
4662,50,9257,590718,590768,28
3791,261,9271,1263947,1264208,28
9489,9,9275,186200,186209,28
2843,81,9297,758481,758562,28
3068,197,9307,1160917,1161114,28
5165,134,9307,1009584,1009718,28
9274,291,9312,1305000,1305291,28
4467,115,9319,898933,899048,28
9625,87,9333,758558,758645,28
2176,177,9340,1093790,1093967,28
6391,214,9346,1216554,1216768,28
6947,49,9347,590856,590905,28
7987,230,9349,1216553,1216783,28
3352,36,9351,399827,399863,28
8737,253,9359,1263909,1264162,28
2584,191,9377,1160982,1161173,28
5100,37,9386,399853,399890,28
7755,156,9418,1093852,1094008,28
9764,33,9423,399854,399887,28
2659,5,9424,186428,186433,28
5648,75,9433,758629,758704,28
4375,275,9436,1263842,1264117,28
7233,37,9436,399899,399936,28
3151,93,9438,758653,758746,28
8085,150,9450,1009674,1009824,28
8604,46,9456,399941,399987,28
9590,208,9473,1160925,1161133,28
2143,66,9501,590929,590995,28
5443,251,9524,1263786,1264037,28
4018,284,9531,1304797,1305081,28
9405,158,9534,1093855,1094013,28
3012,240,9538,1216506,1216746,28
9387,194,9541,1160973,1161167,28
4001,94,9542,758752,758846,28
9816,70,9550,591049,591119,28
6383,146,9560,1009757,1009903,28
2936,71,9588,591059,591130,28
2193,26,9598,400086,400112,28
2100,164,9611,1093841,1094005,28
1946,81,9617,758751,758832,28
7858,31,9634,400101,400132,28
1654,229,9649,1216423,1216652,28
5956,35,9651,400116,400151,28
6408,101,9652,899076,899177,28
5932,278,9653,1304684,1304962,28
9834,9,9653,186779,186788,28
8255,283,9664,1304676,1304959,28
1590,68,9676,591145,591213,28
6345,181,9682,1093868,1094049,28
5650,152,9712,1009766,1009918,28
9160,244,9730,1263684,1263928,28
4651,28,9737,400210,400238,28
5989,292,9755,1304593,1304885,28
3911,218,9761,1216452,1216670,28
2428,221,9763,1216456,1216677,28
8330,146,9770,1009847,1009993,28
5913,206,9781,1160955,1161161,28
6929,258,9787,1263660,1263918,28
6922,156,9809,1093943,1094099,28
3750,176,9812,1093943,1094119,28
9044,279,9836,1304529,1304808,28
5836,102,9856,899253,899355,28
2179,170,9870,1093937,1094107,28
4688,53,9893,591299,591352,28
8622,200,9896,1160924,1161124,28
7566,126,9908,1009926,1010052,28
4628,16,9916,186985,187001,28
2342,285,9919,1304450,1304735,28
4630,103,9924,899297,899400,28
5538,149,9930,1009933,1010082,28
5156,78,9931,759044,759122,28
8159,151,9970,1009917,1010068,28
542,264,56,1273479,1273743,29
649,2,74,196980,196982,29
122,18,222,196834,196852,29
801,229,275,1226084,1226313,29
720,209,278,1226106,1226315,29
379,215,397,1225992,1226207,29
361,217,462,1225938,1226155,29
672,199,520,1170500,1170699,29
491,293,527,1313862,1314155,29
864,60,546,600997,601057,29
671,290,628,1313789,1314079,29
524,294,661,1313781,1314075,29
974,138,702,1019459,1019597,29
855,103,714,908830,908933,29
402,60,721,600933,600993,29
944,149,722,1103418,1103567,29
863,212,724,1225779,1225991,29
158,146,742,1019491,1019637,29
743,169,757,1103413,1103582,29
716,283,851,1313620,1313903,29
626,81,860,768550,768631,29
564,226,897,1225644,1225870,29
7648,12,8010,189482,189494,29
9836,27,8010,402859,402886,29
2511,143,8031,1012309,1012452,29
6374,296,8032,1306457,1306753,29
2813,215,8042,1218551,1218766,29
4410,154,8079,1096225,1096379,29
1744,164,8083,1096228,1096392,29
3483,292,8083,1306437,1306729,29
5211,300,8084,1341705,1342005,29
9079,5,8085,189595,189600,29
4667,187,8107,1163227,1163414,29
7410,234,8125,1218539,1218773,29
2802,87,8158,761514,761601,29
4729,272,8160,1306419,1306691,29
5940,46,8161,593940,593986,29
6744,254,8173,1265640,1265894,29
9096,34,8175,402998,403032,29
2999,32,8181,403004,403036,29
2298,61,8189,593937,593998,29
1896,86,8190,761550,761636,29
6387,112,8196,901799,901911,29
8589,77,8205,761577,761654,29
8007,251,8220,1265613,1265864,29
1515,231,8221,1218563,1218794,29
4431,218,8237,1218574,1218792,29
1062,4,8244,189771,189775,29
6285,295,8253,1306333,1306628,29
6937,11,8262,189779,189790,29
6821,272,8271,1306345,1306617,29
1286,159,8280,1096356,1096515,29
7799,127,8298,1012497,1012624,29
8357,73,8298,761667,761740,29
8539,32,8310,403161,403193,29
6502,294,8323,1306300,1306594,29
7567,84,8330,761664,761748,29
9523,94,8343,761666,761760,29
1871,272,8369,1306283,1306555,29
2670,47,8379,594123,594170,29
9441,214,8384,1218561,1218775,29
3906,248,8408,1265566,1265814,29
3117,300,8411,1341381,1341681,29
3132,153,8421,1096367,1096520,29
1409,15,8424,189936,189951,29
4278,20,8433,189942,189962,29
8830,27,8434,403254,403281,29
6675,177,8476,1163247,1163424,29
3309,139,8485,1012506,1012645,29
2743,182,8503,1163222,1163404,29
7511,132,8511,1012526,1012658,29
6358,140,8521,1012528,1012668,29
2694,135,8525,1012544,1012679,29
3006,67,8556,594188,594255,29
6525,261,8559,1265460,1265721,29
6261,232,8563,1218482,1218714,29
6957,91,8571,761788,761879,29
7823,237,8571,1265475,1265712,29
5112,27,8577,403369,403396,29
6847,67,8577,594285,594352,29
9721,161,8589,1096345,1096506,29
4518,189,8590,1163229,1163418,29
6876,3,8593,190154,190157,29
7128,19,8598,190152,190171,29
3399,205,8603,1218500,1218705,29
4574,250,8610,1265439,1265689,29
2182,195,8625,1163266,1163461,29
1097,140,8659,1012641,1012781,29
5859,62,8661,594367,594429,29
9561,95,8676,902065,902160,29
1901,171,8703,1096357,1096528,29
8272,51,8707,594386,594437,29
1407,163,8714,1096370,1096533,29
4335,19,8727,190240,190259,29
1509,150,8736,1096364,1096514,29
5229,113,8744,902076,902189,29
5020,16,8769,190261,190277,29
5260,26,8778,403495,403521,29
6689,101,8781,902058,902159,29
4366,22,8784,190306,190328,29
5069,24,8804,403496,403520,29
4058,251,8808,1265257,1265508,29
5807,63,8821,594398,594461,29
7473,141,8834,1012594,1012735,29
1944,178,8838,1163102,1163280,29
7196,300,8854,1340941,1341241,29
1091,41,8858,403559,403600,29
1263,23,8867,403569,403592,29
3885,207,8883,1218311,1218518,29
6475,187,8890,1163111,1163298,29
8741,179,8910,1163103,1163282,29
1900,283,8941,1305782,1306065,29
8298,135,8965,1012646,1012781,29
6765,119,8979,902101,902220,29
2856,299,8988,1340810,1341109,29
9019,47,8997,594480,594527,29
4740,84,9000,761981,762065,29
7526,81,9013,761983,762064,29
1463,52,9014,594513,594565,29
1423,205,9027,1218230,1218435,29
2535,247,9031,1265144,1265391,29
7562,91,9033,762025,762116,29
6431,197,9045,1163088,1163285,29
5543,17,9070,190548,190565,29
9939,234,9078,1218210,1218444,29
1850,195,9092,1163092,1163287,29
8140,44,9100,403728,403772,29
2873,244,9138,1265050,1265294,29
5326,175,9166,1096329,1096504,29
4512,64,9182,594544,594608,29
4676,66,9187,594558,594624,29
6580,127,9192,1012650,1012777,29
5032,55,9194,594596,594651,29
9841,218,9197,1218151,1218369,29
9184,123,9203,1012673,1012796,29
5857,233,9210,1218152,1218385,29
6369,27,9210,403847,403874,29
6903,19,9216,190705,190724,29
9927,200,9222,1163069,1163269,29
2884,290,9230,1305543,1305833,29
2349,149,9241,1096394,1096543,29
5599,263,9286,1264943,1265206,29
6432,34,9308,403846,403880,29
7864,150,9310,1096355,1096505,29
3679,186,9316,1163058,1163244,29
6380,156,9318,1096378,1096534,29
7075,8,9339,190777,190785,29
5757,71,9353,762127,762198,29
8770,224,9378,1218073,1218297,29
7246,55,9380,594708,594763,29
2658,47,9386,594712,594759,29
5468,177,9414,1163000,1163177,29
1616,84,9425,762107,762191,29
2065,56,9454,594694,594750,29
7397,73,9460,762087,762160,29
3533,117,9482,902169,902286,29
9511,63,9496,594711,594774,29
2261,67,9505,594720,594787,29
4046,255,9515,1264743,1264998,29
2164,64,9516,594755,594819,29
8222,134,9524,1012652,1012786,29
8157,29,9536,404021,404050,29
5503,199,9543,1162902,1163101,29
3244,138,9547,1012670,1012808,29
3446,91,9554,762122,762213,29
1198,272,9558,1305240,1305512,29
5962,181,9563,1162935,1163116,29
5007,248,9568,1264742,1264990,29
8924,272,9576,1305229,1305501,29
9250,156,9583,1096346,1096502,29
4859,214,9599,1217992,1218206,29
7452,155,9604,1096362,1096517,29
9376,15,9607,191067,191082,29
3320,37,9617,404177,404214,29
5490,272,9628,1305184,1305456,29
7634,263,9633,1264753,1265016,29
1656,72,9653,762270,762342,29
1676,20,9659,191118,191138,29
9498,295,9661,1305158,1305453,29
1719,88,9676,762275,762363,29
2477,258,9687,1264759,1265017,29
4080,190,9709,1162998,1163188,29
8756,236,9721,1264749,1264985,29
7721,149,9729,1096413,1096562,29
9655,49,9746,595024,595073,29
5743,205,9750,1218001,1218206,29
7470,191,9752,1163028,1163219,29
2837,254,9785,1264687,1264941,29
4047,149,9786,1096442,1096591,29
2138,201,9788,1163037,1163238,29
1978,260,9792,1264700,1264960,29
3651,2,9795,191288,191290,29
9445,236,9797,1264721,1264957,29
2567,24,9814,404386,404410,29
9370,206,9814,1218028,1218234,29
4829,114,9817,902533,902647,29
5405,296,9820,1305029,1305325,29
5709,189,9820,1163147,1163336,29
1427,168,9832,1096566,1096734,29
2571,130,9862,1013048,1013178,29
3112,10,9890,191371,191381,29
7862,135,9893,1013027,1013162,29
1806,29,9896,404467,404496,29
8849,166,9907,1096512,1096678,29
7251,229,9911,1217963,1218192,29
7031,37,9921,404495,404532,29
8198,195,9929,1163081,1163276,29
4393,154,9933,1096561,1096715,29
8568,39,9933,404544,404583,29
9880,61,9934,595272,595333,29
3886,121,9942,1013101,1013222,29
9504,216,9952,1217947,1218163,29
7199,106,9953,902703,902809,29
8485,269,9962,1304918,1305187,29
8918,30,9996,404613,404643,29
321,30,91,414527,414557,30
148,251,112,1274479,1274730,30
184,265,124,1314770,1315035,30
226,21,179,201463,201484,30
367,132,254,1022901,1023033,30
962,249,278,1274369,1274618,30
637,155,368,1106276,1106431,30
205,36,390,414347,414383,30
142,146,523,1106135,1106281,30
278,195,529,1172650,1172845,30
185,74,563,772228,772302,30
919,93,600,912273,912366,30
591,7,788,201043,201050,30
643,15,837,201001,201016,30
721,171,856,1172350,1172521,30
631,210,894,1227142,1227352,30
819,150,895,1105849,1105999,30
573,186,960,1172277,1172463,30
6485,161,8000,1098780,1098941,30
5567,58,8005,597637,597695,30
9105,30,8014,406958,406988,30
9814,254,8027,1266644,1266898,30
4446,243,8036,1266664,1266907,30
2421,250,8042,1266676,1266926,30
6614,37,8045,407002,407039,30
2228,285,8048,1306856,1307141,30
3257,54,8075,597674,597728,30
9563,29,8086,407021,407050,30
2514,192,8096,1165271,1165463,30
7664,268,8101,1306833,1307101,30
4797,215,8103,1220092,1220307,30
7831,240,8120,1266683,1266923,30
9892,151,8135,1098881,1099032,30
1675,279,8144,1306803,1307082,30
7412,31,8146,407101,407132,30
3627,226,8147,1266701,1266927,30
9505,19,8166,194149,194168,30
7988,215,8175,1220126,1220341,30
2213,260,8199,1306772,1307032,30
3487,284,8201,1306775,1307059,30
7602,95,8227,905124,905219,30
9176,276,8237,1306768,1307044,30
8061,73,8242,765085,765158,30
2513,126,8243,1015553,1015679,30
5635,9,8249,194232,194241,30
6231,90,8254,765104,765194,30
9033,54,8269,597836,597890,30
2479,126,8280,1015527,1015653,30
5977,63,8287,597852,597915,30
8806,215,8331,1220076,1220291,30
9910,132,8331,1015513,1015645,30
8907,23,8339,407226,407249,30
1642,159,8344,1098871,1099030,30
1450,251,8345,1266594,1266845,30
5154,258,8345,1306681,1306939,30
5355,238,8348,1266647,1266885,30
7505,279,8355,1306674,1306953,30
7701,132,8355,1015636,1015768,30
1269,62,8370,597973,598035,30
1439,279,8397,1306656,1306935,30
5637,259,8399,1306678,1306937,30
6437,30,8414,407351,407381,30
1343,66,8434,597974,598040,30
5725,129,8434,1015626,1015755,30
8726,158,8436,1098959,1099117,30
1569,280,8455,1306626,1306906,30
5195,158,8469,1098970,1099128,30
1898,94,8480,905301,905395,30
1133,253,8501,1266627,1266880,30
4442,103,8505,905305,905408,30
7822,146,8548,1098935,1099081,30
4678,279,8567,1306539,1306818,30
8396,87,8567,765295,765382,30
1440,113,8575,905298,905411,30
9151,51,8585,598099,598150,30
6152,215,8595,1220092,1220307,30
5373,20,8599,194542,194562,30
1860,191,8601,1165350,1165541,30
2901,202,8637,1220069,1220271,30
4070,267,8642,1306488,1306755,30
8893,24,8656,407492,407516,30
5027,192,8659,1165371,1165563,30
3166,38,8660,407513,407551,30
1362,286,8666,1306476,1306762,30
3652,23,8676,407536,407559,30
4553,178,8678,1165404,1165582,30
5817,297,8721,1341090,1341387,30
1355,293,8738,1341084,1341377,30
6004,216,8748,1220080,1220296,30
5384,27,8753,407549,407576,30
5808,83,8754,765393,765476,30
1903,10,8760,194695,194705,30
4619,12,8780,194685,194697,30
2824,253,8786,1266520,1266773,30
4540,79,8792,765396,765475,30
7406,297,8802,1341027,1341324,30
4485,48,8805,598209,598257,30
9281,276,8808,1306458,1306734,30
9916,129,8818,1015750,1015879,30
3311,95,8838,905408,905503,30
8296,263,8847,1306440,1306703,30
8757,34,8849,407657,407691,30
8439,203,8864,1220100,1220303,30
5016,52,8870,598264,598316,30
5608,204,8873,1220098,1220302,30
9006,59,8898,598268,598327,30
9412,252,8920,1266504,1266756,30
3521,51,8924,598281,598332,30
1633,184,8925,1165447,1165631,30
2004,228,8933,1266518,1266746,30
4079,208,8940,1220097,1220305,30
4360,293,8951,1340889,1341182,30
3557,63,8953,598352,598415,30
7053,191,8957,1165515,1165706,30
9752,91,8961,905515,905606,30
8968,256,8963,1306363,1306619,30
4036,157,8976,1099160,1099317,30
9056,27,8984,407865,407892,30
5786,202,8999,1220108,1220310,30
8974,47,9018,598422,598469,30
6460,215,9024,1220089,1220304,30
6238,43,9025,407896,407939,30
8929,282,9027,1306300,1306582,30
1258,140,9049,1015897,1016037,30
3008,133,9081,1015890,1016023,30
2460,249,9085,1266459,1266708,30
7176,126,9087,1015928,1016054,30
6579,197,9108,1220082,1220279,30
1639,147,9128,1099159,1099306,30
4713,279,9141,1306213,1306492,30
9857,108,9142,905635,905743,30
7774,93,9146,905649,905742,30
5873,131,9148,1015956,1016087,30
5979,60,9149,598571,598631,30
2355,274,9156,1306222,1306496,30
5877,291,9157,1340690,1340981,30
8411,50,9204,598579,598629,30
2183,281,9209,1306219,1306500,30
6048,21,9222,195200,195221,30
6578,17,9222,195221,195238,30
9993,57,9240,598573,598630,30
6395,143,9261,1099140,1099283,30
3361,172,9270,1165505,1165677,30
6961,22,9287,408074,408096,30
1615,58,9295,598578,598636,30
3983,294,9297,1340555,1340849,30
2236,264,9315,1306170,1306434,30
7310,267,9319,1306175,1306442,30
6409,165,9328,1099183,1099348,30
5086,202,9330,1220064,1220266,30
1324,251,9341,1266437,1266688,30
4465,253,9353,1266451,1266704,30
2386,87,9361,765824,765911,30
9987,94,9372,905751,905845,30
3500,189,9385,1165562,1165751,30
5551,256,9447,1306059,1306315,30
6812,41,9457,408169,408210,30
9867,70,9488,765790,765860,30
3887,139,9496,1015988,1016127,30
3088,20,9503,195356,195376,30
4238,99,9509,905693,905792,30
8228,230,9515,1266347,1266577,30
3541,260,9516,1305991,1306251,30
7901,290,9522,1340338,1340628,30
1328,10,9527,195436,195446,30
8031,177,9544,1165536,1165713,30
9753,205,9546,1220028,1220233,30
4857,268,9549,1305994,1306262,30
8243,250,9564,1266393,1266643,30
2747,35,9565,408301,408336,30
8504,108,9574,905812,905920,30
6355,110,9614,905790,905900,30
8286,8,9614,195506,195514,30
2851,20,9628,195500,195520,30
4161,47,9636,598781,598828,30
4924,110,9636,905788,905898,30
2867,254,9646,1266336,1266590,30
5922,102,9659,905810,905912,30
3635,124,9668,1016048,1016172,30
2870,151,9670,1099216,1099367,30
6816,224,9672,1219998,1220222,30
9147,190,9684,1165545,1165735,30
8242,157,9739,1099211,1099368,30
1891,167,9742,1099224,1099391,30
1716,266,9761,1305795,1306061,30
5506,244,9768,1266273,1266517,30
5137,97,9797,905884,905981,30
4820,163,9800,1099246,1099409,30
4632,215,9822,1219934,1220149,30
1528,90,9831,766051,766141,30
3205,151,9855,1099240,1099391,30
6154,257,9893,1305674,1305931,30
3690,185,9896,1165467,1165652,30
1089,272,9903,1305666,1305938,30
4247,228,9906,1266214,1266442,30
9430,108,9921,905942,906050,30
9578,40,9923,408485,408525,30
3093,269,9924,1305662,1305931,30
7441,177,9932,1165532,1165709,30
4250,253,9944,1266209,1266462,30
4799,67,9957,766165,766232,30
1836,272,9970,1305630,1305902,30
5997,245,9976,1266235,1266480,30
6158,225,9983,1219995,1220220,30
344,218,168,1276072,1276290,31
552,133,227,1026048,1026181,31
706,145,430,1108977,1109122,31
979,106,465,915642,915748,31
636,7,522,205336,205343,31
423,288,597,1349278,1349566,31
180,280,771,1349117,1349397,31
470,81,948,775388,775469,31
469,41,986,417743,417784,31
8269,207,8012,1222087,1222294,31
9434,250,8015,1307672,1307922,31
9826,36,8020,410772,410808,31
5420,215,8055,1222091,1222306,31
4554,232,8074,1268255,1268487,31
1643,199,8077,1222124,1222323,31
9392,268,8101,1307591,1307859,31
7935,165,8103,1167732,1167897,31
5722,202,8119,1222121,1222323,31
8808,155,8127,1101550,1101705,31
3314,146,8143,1101554,1101700,31
2666,219,8150,1268224,1268443,31
4945,78,8151,768456,768534,31
8727,76,8166,768456,768532,31
8750,56,8171,601336,601392,31
9020,258,8200,1307515,1307773,31
5150,174,8210,1167710,1167884,31
9121,43,8210,601356,601399,31
7370,114,8213,1018485,1018599,31
3222,79,8235,768469,768548,31
1367,193,8239,1222071,1222264,31
3319,231,8243,1268163,1268394,31
1496,214,8253,1222090,1222304,31
7611,234,8257,1268164,1268398,31
1402,176,8261,1167780,1167956,31
4679,215,8268,1222129,1222344,31
4039,265,8271,1307457,1307722,31
4541,266,8272,1307476,1307742,31
7019,243,8289,1268208,1268451,31
4057,266,8290,1307479,1307745,31
5631,18,8325,198220,198238,31
2121,253,8331,1307459,1307712,31
2889,196,8333,1222231,1222427,31
5314,106,8335,908464,908570,31
7642,115,8345,1018657,1018772,31
2045,265,8349,1307449,1307714,31
3127,151,8354,1101770,1101921,31
2255,285,8373,1341520,1341805,31
3473,131,8375,1018707,1018838,31
6498,294,8389,1341514,1341808,31
3469,86,8393,768764,768850,31
7456,47,8402,601650,601697,31
4695,180,8408,1167918,1168098,31
1317,77,8418,768785,768862,31
8113,231,8422,1268247,1268478,31
3508,120,8452,1018726,1018846,31
6481,218,8454,1268230,1268448,31
6442,297,8459,1341463,1341760,31
9798,29,8461,411271,411300,31
9550,194,8464,1222276,1222470,31
6371,59,8469,601743,601802,31
3395,143,8483,1101839,1101982,31
5818,155,8501,1101829,1101984,31
4265,87,8512,908643,908730,31
4426,281,8517,1341427,1341708,31
6332,25,8524,411343,411368,31
6088,202,8529,1222245,1222447,31
1536,260,8533,1307405,1307665,31
1625,154,8537,1101891,1102045,31
6075,66,8554,768939,769005,31
7172,120,8564,1018849,1018969,31
7772,151,8566,1101881,1102032,31
9163,192,8568,1222248,1222440,31
1567,185,8579,1167982,1168167,31
3372,237,8599,1268174,1268411,31
9161,105,8601,908771,908876,31
8452,13,8667,198596,198609,31
4026,205,8688,1222160,1222365,31
2130,237,8695,1268099,1268336,31
3256,149,8697,1101896,1102045,31
9101,118,8698,1018900,1019018,31
3654,99,8707,908780,908879,31
3315,81,8708,769041,769122,31
7011,105,8710,908790,908895,31
4867,297,8715,1341235,1341532,31
9988,43,8738,601976,602019,31
3076,33,8760,411511,411544,31
7020,299,8761,1341211,1341510,31
8051,118,8761,1018895,1019013,31
7002,217,8764,1268109,1268326,31
3946,140,8775,1101910,1102050,31
3687,260,8781,1307232,1307492,31
7790,284,8781,1341215,1341499,31
5136,139,8783,1101959,1102098,31
1582,107,8810,908901,909008,31
2907,246,8847,1307211,1307457,31
6621,293,8847,1341158,1341451,31
3901,32,8878,411616,411648,31
5463,132,8881,1018958,1019090,31
7440,19,8887,198829,198848,31
5273,273,8892,1307197,1307470,31
1704,183,8912,1167970,1168153,31
8260,27,8919,411650,411677,31
1151,297,8944,1341079,1341376,31
8134,89,8949,908927,909016,31
6882,238,8954,1268094,1268332,31
2013,11,8975,198880,198891,31
6176,214,8975,1222198,1222412,31
7125,127,8990,1018996,1019123,31
2609,79,8992,769235,769314,31
7051,99,8997,908954,909053,31
6069,159,9010,1101918,1102077,31
8900,49,9016,602162,602211,31
4233,296,9032,1341013,1341309,31
2625,193,9070,1222157,1222350,31
2470,230,9072,1268027,1268257,31
8273,245,9074,1268039,1268284,31
8975,277,9104,1340962,1341239,31
4361,268,9108,1307099,1307367,31
8995,34,9108,411783,411817,31
1974,121,9118,1019060,1019181,31
2453,19,9131,199015,199034,31
2360,292,9154,1340914,1341206,31
9211,63,9182,602180,602243,31
8829,280,9207,1340878,1341158,31
4411,9,9217,199008,199017,31
6296,136,9226,1101934,1102070,31
4693,295,9244,1340846,1341141,31
8856,249,9247,1307073,1307322,31
8215,276,9253,1340857,1341133,31
6213,147,9261,1101978,1102125,31
6920,252,9303,1307051,1307303,31
4987,191,9327,1222185,1222376,31
3265,90,9339,909033,909123,31
7284,156,9344,1101959,1102115,31
3418,190,9383,1222132,1222322,31
3683,78,9398,769328,769406,31
6519,193,9407,1222110,1222303,31
5132,241,9461,1267913,1268154,31
4094,27,9463,411799,411826,31
7550,61,9482,602210,602271,31
4562,209,9485,1222065,1222274,31
7885,142,9503,1101925,1102067,31
1322,220,9510,1267889,1268109,31
2732,296,9519,1340592,1340888,31
6063,95,9521,909047,909142,31
1010,23,9543,411852,411875,31
3476,135,9548,1019066,1019201,31
3168,148,9595,1101892,1102040,31
4295,251,9611,1306780,1307031,31
9174,152,9626,1101900,1102052,31
1801,265,9649,1306748,1307013,31
4444,211,9650,1222033,1222244,31
3192,255,9662,1306755,1307010,31
1030,32,9664,411881,411913,31
5664,16,9667,199147,199163,31
7542,123,9706,1019083,1019206,31
6160,136,9719,1101902,1102038,31
3410,286,9724,1340408,1340694,31
2752,120,9728,1019124,1019244,31
2939,185,9754,1167879,1168064,31
7224,182,9755,1167902,1168084,31
2432,104,9766,909123,909227,31
6925,216,9775,1221987,1222203,31
4429,46,9781,602371,602417,31
3322,122,9798,1019139,1019261,31
6445,263,9819,1306638,1306901,31
7929,103,9823,909156,909259,31
8702,106,9832,909164,909270,31
9595,149,9841,1101911,1102060,31
3605,149,9870,1101896,1102045,31
5498,36,9883,411989,412025,31
6782,168,9884,1167848,1168016,31
9104,264,9885,1306590,1306854,31
6677,227,9895,1267711,1267938,31
9307,25,9903,412048,412073,31
5044,53,9910,602445,602498,31
2945,13,9920,199330,199343,31
4714,195,9923,1221951,1222146,31
9588,249,9937,1306557,1306806,31
1661,29,9948,412071,412100,31
7605,155,9981,1101929,1102084,31
2846,32,9996,412053,412085,31
8230,30,9996,412065,412095,31
477,145,56,1111880,1112025,32
268,156,165,1177689,1177845,32
541,60,288,612189,612249,32
751,196,288,1231629,1231825,32
349,72,289,779303,779375,32
394,168,296,1177586,1177754,32
757,14,299,209198,209212,32
708,172,375,1177521,1177693,32
545,141,377,1111675,1111816,32
188,237,397,1316111,1316348,32
293,63,505,779187,779250,32
861,212,551,1277132,1277344,32
900,68,630,779087,779155,32
224,187,682,1231305,1231492,32
471,1,682,208962,208963,32
803,171,684,1177308,1177479,32
283,265,714,1349440,1349705,32
821,70,724,779067,779137,32
201,285,886,1349269,1349554,32
561,175,897,1177164,1177339,32
971,129,902,1028589,1028718,32
2878,215,8012,1269732,1269947,32
5141,236,8015,1308553,1308789,32
9895,170,8015,1170119,1170289,32
6862,27,8025,414487,414514,32
8395,170,8031,1170119,1170289,32
4493,58,8038,604880,604938,32
9321,285,8042,1342134,1342419,32
3226,75,8081,771896,771971,32
4576,15,8084,201827,201842,32
2709,81,8103,771889,771970,32
3537,131,8117,1104247,1104378,32
5423,76,8127,771908,771984,32
4059,283,8133,1342064,1342347,32
6919,254,8143,1308484,1308738,32
3660,72,8161,771934,772006,32
8905,28,8166,414554,414582,32
8304,161,8167,1170077,1170238,32
2131,117,8189,1021542,1021659,32
7631,67,8201,771950,772017,32
3390,7,8203,201913,201920,32
9426,223,8217,1269647,1269870,32
9821,94,8226,911561,911655,32
7476,219,8250,1269630,1269849,32
3437,142,8251,1104240,1104382,32
1794,91,8291,911554,911645,32
3443,86,8291,911563,911649,32
3562,155,8295,1170008,1170163,32
8566,177,8332,1169972,1170149,32
3270,113,8343,1021520,1021633,32
9603,291,8357,1341859,1342150,32
4870,59,8367,605011,605070,32
9713,113,8376,1021519,1021632,32
6572,185,8394,1223870,1224055,32
1690,286,8406,1341837,1342123,32
7666,9,8417,201972,201981,32
3574,52,8460,605001,605053,32
4902,154,8481,1104148,1104302,32
9522,77,8509,771957,772034,32
1587,15,8510,201945,201960,32
9254,126,8510,1021465,1021591,32
3060,236,8519,1308185,1308421,32
4273,183,8519,1223804,1223987,32
5006,294,8519,1341746,1342040,32
9571,214,8568,1269436,1269650,32
2629,36,8575,414654,414690,32
8639,284,8583,1341712,1341996,32
8803,55,8602,605040,605095,32
5040,111,8615,1021501,1021612,32
4937,199,8618,1223789,1223988,32
4164,85,8634,911592,911677,32
1460,202,8650,1223776,1223978,32
8359,213,8652,1269387,1269600,32
3540,39,8666,414720,414759,32
6130,44,8675,605088,605132,32
9960,8,8691,202064,202072,32
1557,14,8706,202057,202071,32
1482,32,8717,414709,414741,32
9382,246,8740,1308023,1308269,32
3323,160,8762,1169877,1170037,32
7782,164,8767,1169878,1170042,32
1739,169,8770,1169885,1170054,32
1246,148,8772,1104182,1104330,32
5575,125,8772,1021542,1021667,32
1484,227,8780,1269293,1269520,32
2029,12,8782,202147,202159,32
9424,230,8811,1269282,1269512,32
3718,286,8812,1341503,1341789,32
3000,31,8815,414804,414835,32
8641,25,8821,414810,414835,32
5974,252,8824,1307979,1308231,32
3891,139,8826,1104247,1104386,32
6555,294,8830,1341507,1341801,32
1105,56,8848,605172,605228,32
1152,42,8871,605166,605208,32
5005,87,8902,911649,911736,32
7141,123,8906,1021572,1021695,32
4975,64,8921,772112,772176,32
6314,256,8955,1307894,1308150,32
5917,76,8971,772088,772164,32
7834,235,9008,1269220,1269455,32
9208,135,9037,1104121,1104256,32
2376,139,9046,1104118,1104257,32
1987,269,9055,1341312,1341581,32
1421,132,9068,1104131,1104263,32
2586,172,9091,1169787,1169959,32
9282,105,9098,911642,911747,32
9905,178,9129,1169767,1169945,32
3593,260,9132,1307767,1308027,32
7833,11,9179,202199,202210,32
2148,210,9182,1269130,1269340,32
9039,162,9199,1169773,1169935,32
6598,206,9200,1223572,1223778,32
4133,135,9204,1104148,1104283,32
7148,43,9207,605211,605254,32
8081,194,9208,1223590,1223784,32
4504,109,9216,1021616,1021725,32
1876,245,9217,1307707,1307952,32
6376,237,9233,1307701,1307938,32
9673,111,9235,1021649,1021760,32
2041,67,9250,772221,772288,32
1332,175,9261,1169823,1169998,32
4402,110,9271,1021643,1021753,32
3096,187,9272,1223594,1223781,32
7032,300,9278,1370280,1370580,32
3932,59,9283,605349,605408,32
7237,46,9287,605365,605411,32
4262,114,9291,1021676,1021790,32
8292,265,9292,1341110,1341375,32
3303,290,9303,1341100,1341390,32
8150,239,9311,1307712,1307951,32
3342,243,9315,1307712,1307955,32
1851,192,9316,1223692,1223884,32
3269,40,9355,605430,605470,32
2841,171,9362,1169925,1170096,32
1989,283,9393,1341036,1341319,32
1155,203,9396,1223651,1223854,32
9475,123,9413,1021755,1021878,32
9028,57,9415,605455,605512,32
1226,103,9443,911895,911998,32
4425,2,9474,202485,202487,32
6708,148,9474,1104234,1104382,32
4880,76,9481,772349,772425,32
9947,224,9488,1269051,1269275,32
2971,191,9497,1223600,1223791,32
6950,45,9525,605468,605513,32
2996,219,9529,1269027,1269246,32
4551,292,9535,1340913,1341205,32
3444,110,9565,1021741,1021851,32
9935,45,9574,605488,605533,32
9906,206,9576,1223586,1223792,32
4405,195,9592,1223596,1223791,32
1741,89,9596,911947,912036,32
5438,169,9598,1169914,1170083,32
1985,88,9612,911961,912049,32
2040,24,9631,415266,415290,32
4439,178,9637,1169890,1170068,32
7324,228,9642,1268954,1269182,32
5755,114,9652,1021779,1021893,32
1101,54,9663,605573,605627,32
6745,4,9669,202653,202657,32
3827,74,9670,772462,772536,32
6247,254,9681,1307412,1307666,32
8843,58,9682,605611,605669,32
9914,108,9684,1021780,1021888,32
9344,100,9695,911999,912099,32
4944,79,9708,772504,772583,32
1721,116,9717,1021750,1021866,32
9689,222,9743,1268902,1269124,32
5969,227,9748,1268912,1269139,32
4022,27,9749,415413,415440,32
7303,93,9752,912029,912122,32
2169,239,9761,1307351,1307590,32
8345,98,9763,912052,912150,32
8902,265,9775,1340701,1340966,32
8178,148,9777,1104300,1104448,32
3020,64,9782,772625,772689,32
8553,207,9795,1223570,1223777,32
5172,139,9820,1104301,1104440,32
4547,41,9821,605785,605826,32
7216,113,9838,1021808,1021921,32
6755,221,9841,1268895,1269116,32
9071,265,9845,1340632,1340897,32
2413,228,9855,1268923,1269151,32
3005,186,9857,1223616,1223802,32
6379,106,9859,1021891,1021997,32
6767,225,9883,1268916,1269141,32
5585,199,9893,1223613,1223812,32
7171,296,9922,1369642,1369938,32
7622,165,9934,1169981,1170146,32
3271,215,9938,1268907,1269122,32
3074,189,9946,1223633,1223822,32
2367,24,9967,415623,415647,32
767,291,122,1379456,1379747,33
688,58,151,782592,782650,33
722,298,532,1379055,1379353,33
555,102,624,1031322,1031424,33
234,152,644,1179391,1179543,33
383,149,770,1179270,1179419,33
654,222,951,1277965,1278187,33
9570,240,8005,1309264,1309504,33
2636,221,8015,1270952,1271173,33
5527,251,8026,1309258,1309509,33
9788,176,8029,1225723,1225899,33
3070,186,8035,1225721,1225907,33
3346,280,8048,1342529,1342809,33
9419,83,8053,914414,914497,33
9230,221,8060,1270984,1271205,33
6484,25,8066,417815,417840,33
9635,30,8077,417811,417841,33
1589,31,8092,417808,417839,33
5646,166,8134,1172108,1172274,33
9979,47,8211,607971,608018,33
5473,159,8213,1172048,1172207,33
2795,219,8223,1270844,1271063,33
5727,163,8226,1172072,1172235,33
1766,122,8243,1024027,1024149,33
1714,6,8269,205097,205103,33
4365,274,8275,1342329,1342603,33
7690,239,8354,1309012,1309251,33
7523,26,8357,417708,417734,33
3393,162,8377,1171987,1172149,33
4241,297,8377,1371226,1371523,33
7202,33,8423,417688,417721,33
4223,167,8437,1171967,1172134,33
1888,40,8440,607932,607972,33
3849,173,8458,1225468,1225641,33
8513,273,8459,1342195,1342468,33
1657,160,8464,1172010,1172170,33
7035,10,8469,205101,205111,33
2206,112,8470,1024006,1024118,33
8247,82,8471,914331,914413,33
3706,59,8499,774833,774892,33
6908,282,8504,1342170,1342452,33
7700,240,8508,1308956,1309196,33
9333,213,8508,1270742,1270955,33
5159,94,8510,914362,914456,33
6110,143,8517,1106518,1106661,33
6335,38,8519,608076,608114,33
7786,163,8522,1172040,1172203,33
3046,257,8530,1342173,1342430,33
1796,94,8535,914419,914513,33
2281,1,8539,205257,205258,33
4548,122,8546,1024080,1024202,33
6100,138,8555,1106548,1106686,33
6510,28,8568,417919,417947,33
7318,106,8579,1024092,1024198,33
8701,135,8579,1106539,1106674,33
5135,7,8581,205306,205313,33
1870,199,8583,1270709,1270908,33
1397,102,8598,1024125,1024227,33
8585,143,8599,1106555,1106698,33
8257,228,8600,1308907,1309135,33
6890,278,8607,1342100,1342378,33
6350,247,8610,1308928,1309175,33
7232,257,8628,1342104,1342361,33
3297,210,8631,1270770,1270980,33
3425,32,8631,418056,418088,33
7376,123,8634,1024229,1024352,33
5440,237,8656,1308932,1309169,33
8878,93,8659,914619,914712,33
7193,6,8673,205437,205443,33
5213,45,8683,608273,608318,33
2107,109,8698,1024211,1024320,33
5800,204,8712,1270728,1270932,33
6249,237,8716,1308884,1309121,33
5734,300,8739,1370879,1371179,33
9934,19,8747,418106,418125,33
8591,20,8753,418101,418121,33
3645,82,8766,914615,914697,33
4023,257,8792,1341973,1342230,33
1341,285,8796,1370840,1371125,33
6329,237,8806,1308890,1309127,33
1928,36,8810,418122,418158,33
8161,242,8818,1308890,1309132,33
3940,208,8825,1270783,1270991,33
2203,16,8826,205542,205558,33
6878,159,8829,1172149,1172308,33
7296,126,8842,1106692,1106818,33
3161,28,8852,418174,418202,33
6679,28,8886,418150,418178,33
9514,43,8899,608305,608348,33
3139,87,8917,914622,914709,33
3422,44,8922,608308,608352,33
4977,231,8949,1308776,1309007,33
6935,164,8953,1172062,1172226,33
2602,55,8965,608312,608367,33
8606,283,8981,1370658,1370941,33
3144,244,8999,1308760,1309004,33
2550,22,9024,418174,418196,33
8556,13,9047,205571,205584,33
6206,87,9051,914585,914672,33
3277,104,9088,1024152,1024256,33
5900,99,9091,914576,914675,33
6262,20,9097,418162,418182,33
2794,166,9104,1171978,1172144,33
1765,207,9106,1270593,1270800,33
9388,150,9107,1172019,1172169,33
7258,201,9125,1270583,1270784,33
9881,179,9130,1225447,1225626,33
3285,248,9135,1308643,1308891,33
6858,161,9145,1172059,1172220,33
9113,271,9159,1341668,1341939,33
6829,82,9168,914696,914778,33
5515,111,9171,1024257,1024368,33
6346,189,9180,1225456,1225645,33
3620,195,9194,1225459,1225654,33
3208,50,9211,608424,608474,33
1370,201,9221,1270544,1270745,33
4433,9,9223,205732,205741,33
9262,122,9250,1024258,1024380,33
9026,9,9268,205714,205723,33
6899,161,9280,1172038,1172199,33
8716,255,9280,1341565,1341820,33
9069,176,9307,1225421,1225597,33
5301,110,9314,1024285,1024395,33
5125,137,9316,1106653,1106790,33
9539,31,9318,418323,418354,33
4304,22,9323,418331,418353,33
3392,77,9338,775298,775375,33
3801,54,9352,608456,608510,33
4463,265,9372,1341475,1341740,33
3062,42,9373,608472,608514,33
2830,143,9378,1106629,1106772,33
9008,172,9381,1172026,1172198,33
8743,225,9398,1270424,1270649,33
8065,294,9408,1370232,1370526,33
7040,239,9438,1308475,1308714,33
5672,175,9469,1225367,1225542,33
9235,45,9473,608497,608542,33
3953,176,9478,1225361,1225537,33
9547,102,9480,1024336,1024438,33
3611,282,9487,1341401,1341683,33
7143,93,9487,914821,914914,33
2706,173,9501,1225368,1225541,33
1185,92,9507,914838,914930,33
1757,250,9510,1308445,1308695,33
3134,31,9538,418462,418493,33
5681,3,9538,205921,205924,33
8039,152,9543,1172089,1172241,33
3367,158,9559,1172078,1172236,33
5994,244,9566,1308414,1308658,33
8983,31,9566,418504,418535,33
4180,89,9568,914879,914968,33
5764,145,9599,1106716,1106861,33
3163,10,9610,205960,205970,33
4845,167,9610,1172063,1172230,33
5659,31,9645,418495,418526,33
8265,14,9655,205961,205975,33
8628,276,9658,1341259,1341535,33
4805,106,9664,1024361,1024467,33
1354,112,9728,1024303,1024415,33
1955,206,9751,1270260,1270466,33
2855,12,9756,205946,205958,33
4264,123,9757,1024309,1024432,33
6989,270,9757,1341183,1341453,33
8793,160,9777,1171991,1172151,33
4333,46,9784,608594,608640,33
4029,129,9791,1106666,1106795,33
6871,20,9807,418517,418537,33
1114,78,9822,775422,775500,33
1935,17,9831,206009,206026,33
7484,112,9841,1024317,1024429,33
8926,123,9846,1024324,1024447,33
2415,8,9875,206018,206026,33
4455,117,9876,1024317,1024434,33
1149,295,9877,1369775,1370070,33
2364,142,9879,1106608,1106750,33
2090,90,9888,914900,914990,33
2167,8,9896,206077,206085,33
1141,195,9912,1225114,1225309,33
8361,177,9916,1225133,1225310,33
8226,273,9932,1341054,1341327,33
4314,48,9934,608673,608721,33
5657,179,9934,1225146,1225325,33
9800,164,9935,1171971,1172135,33
9476,194,9963,1225124,1225318,33
8703,12,9992,206115,206127,33
1376,22,9996,418596,418618,33
786,137,170,1116486,1116623,34
213,152,174,1181781,1181933,34
607,127,362,1116337,1116464,34
648,49,382,618355,618404,34
272,66,394,785186,785252,34
837,78,406,924593,924671,34
956,215,490,1279619,1279834,34
953,61,666,784966,785027,34
364,277,691,1378986,1379263,34
139,297,706,1378978,1379275,34
650,96,707,1033824,1033920,34
282,185,957,1234235,1234420,34
799,174,957,1234256,1234430,34
7359,94,8011,917118,917212,34
6174,84,8028,917121,917205,34
6491,276,8036,1371675,1371951,34
4530,42,8040,610939,610981,34
6933,288,8040,1371677,1371965,34
6805,125,8051,1108819,1108944,34
5158,156,8054,1174081,1174237,34
2738,267,8071,1343058,1343325,34
8762,39,8072,610990,611029,34
7467,55,8081,777798,777853,34
5863,242,8085,1310171,1310413,34
9399,175,8106,1227217,1227392,34
3903,186,8112,1227222,1227408,34
1092,17,8124,208455,208472,34
8776,227,8124,1310159,1310386,34
9883,190,8131,1272186,1272376,34
7262,128,8135,1108904,1109032,34
5993,277,8138,1371597,1371874,34
3957,21,8140,420997,421018,34
6991,221,8152,1310170,1310391,34
1432,117,8164,1026698,1026815,34
3428,93,8168,917285,917378,34
8019,12,8186,208546,208558,34
9782,19,8213,420982,421001,34
2456,297,8216,1371526,1371823,34
1902,149,8239,1174128,1174277,34
2553,84,8239,917275,917359,34
6776,215,8245,1272151,1272366,34
5741,71,8248,777912,777983,34
5914,98,8249,1026701,1026799,34
1735,78,8251,917315,917393,34
4097,3,8254,208626,208629,34
5071,243,8259,1342951,1343194,34
4748,19,8293,421048,421067,34
9144,232,8293,1310089,1310321,34
9674,258,8305,1342906,1343164,34
2117,138,8318,1108916,1109054,34
8015,44,8335,611149,611193,34
8405,239,8338,1310088,1310327,34
9090,103,8344,1026719,1026822,34
6883,47,8361,611170,611217,34
2119,80,8367,917329,917409,34
2640,175,8372,1227234,1227409,34
9952,228,8408,1310042,1310270,34
4014,49,8411,611189,611238,34
1975,211,8413,1272139,1272350,34
8614,269,8415,1342812,1343081,34
8514,68,8428,778009,778077,34
5456,247,8432,1342822,1343069,34
2991,1,8433,208739,208740,34
3836,160,8441,1174175,1174335,34
4900,170,8443,1227274,1227444,34
5735,112,8460,1026765,1026877,34
2474,275,8474,1371295,1371570,34
2020,177,8475,1227273,1227450,34
4257,193,8477,1272175,1272368,34
4100,207,8487,1272169,1272376,34
7498,238,8487,1310057,1310295,34
6718,252,8505,1342782,1343034,34
1366,263,8508,1342789,1343052,34
3871,219,8511,1310110,1310329,34
1950,42,8513,611386,611428,34
3023,94,8539,917499,917593,34
8865,150,8545,1174307,1174457,34
3988,134,8557,1109089,1109223,34
9574,161,8568,1174294,1174455,34
3435,31,8621,421280,421311,34
8880,277,8643,1371131,1371408,34
6103,81,8660,917482,917563,34
1108,62,8663,778148,778210,34
3691,165,8684,1227252,1227417,34
9815,112,8709,1026819,1026931,34
8018,65,8710,778149,778214,34
7887,10,8739,208825,208835,34
4505,189,8744,1227193,1227382,34
9568,12,8752,208839,208851,34
4490,231,8755,1309897,1310128,34
1268,197,8756,1272074,1272271,34
4709,300,8771,1395261,1395561,34
8954,207,8792,1272072,1272279,34
4412,182,8799,1227263,1227445,34
7604,25,8802,421329,421354,34
6682,116,8807,1026870,1026986,34
9435,195,8810,1272072,1272267,34
8969,98,8816,1026904,1027002,34
3215,32,8838,421355,421387,34
1475,106,8839,1026884,1026990,34
5369,275,8854,1370956,1371231,34
9955,120,8855,1109061,1109181,34
1532,167,8862,1227268,1227435,34
4072,29,8876,421404,421433,34
7189,246,8878,1342524,1342770,34
4546,4,8879,208996,209000,34
2495,30,8887,421423,421453,34
4009,79,8888,917597,917676,34
1452,37,8905,611476,611513,34
3287,39,8908,611475,611514,34
3984,246,8917,1342489,1342735,34
7497,8,8935,209029,209037,34
3036,174,8964,1227219,1227393,34
6453,203,8972,1271994,1272197,34
2617,145,9005,1174238,1174383,34
4122,227,9009,1309767,1309994,34
6973,65,9014,778256,778321,34
5298,81,9022,917573,917654,34
1033,251,9035,1342375,1342626,34
7297,98,9036,1026918,1027016,34
7784,135,9044,1109059,1109194,34
2594,53,9048,611529,611582,34
3439,86,9058,917607,917693,34
6910,155,9058,1174238,1174393,34
7208,91,9072,917626,917717,34
2392,26,9075,421554,421580,34
3240,82,9076,917639,917721,34
1843,280,9109,1370706,1370986,34
5499,144,9161,1174174,1174318,34
1125,266,9166,1342281,1342547,34
9485,65,9171,778330,778395,34
2106,283,9173,1370652,1370935,34
5955,226,9177,1309719,1309945,34
2681,218,9182,1309725,1309943,34
4534,290,9182,1370656,1370946,34
6914,60,9189,778403,778463,34
2336,81,9191,917679,917760,34
8915,72,9198,778420,778492,34
6385,201,9204,1271984,1272185,34
9245,248,9209,1342318,1342566,34
7270,54,9219,611699,611753,34
3590,157,9234,1174273,1174430,34
8493,167,9237,1227231,1227398,34
1262,186,9241,1227230,1227416,34
2215,297,9249,1370609,1370906,34
1445,266,9254,1342307,1342573,34
8888,293,9295,1370590,1370883,34
2199,249,9309,1342304,1342553,34
8836,84,9309,917757,917841,34
4297,3,9319,209282,209285,34
4115,56,9325,778511,778567,34
2211,185,9326,1227267,1227452,34
3740,186,9328,1227286,1227472,34
8087,283,9338,1370570,1370853,34
8908,62,9347,778551,778613,34
8955,162,9365,1174375,1174537,34
2569,23,9374,421786,421809,34
4681,33,9379,421787,421820,34
8644,266,9380,1342268,1342534,34
6613,222,9387,1309739,1309961,34
9465,73,9387,778579,778652,34
1846,107,9392,1027093,1027200,34
7785,285,9392,1370529,1370814,34
6996,271,9403,1370533,1370804,34
8212,91,9426,917839,917930,34
6863,178,9443,1227318,1227496,34
7908,179,9446,1227329,1227508,34
8052,138,9452,1109290,1109428,34
3185,200,9459,1272001,1272201,34
3075,226,9460,1309727,1309953,34
8719,286,9483,1370454,1370740,34
6711,128,9494,1109338,1109466,34
9723,78,9497,917932,918010,34
5345,294,9505,1370448,1370742,34
8977,183,9505,1227385,1227568,34
6393,182,9517,1227392,1227574,34
9085,37,9528,612017,612054,34
6448,227,9544,1309708,1309935,34
1491,123,9596,1109339,1109462,34
1847,125,9600,1109341,1109466,34
9312,2,9601,209513,209515,34
3552,262,9608,1342176,1342438,34
9572,282,9616,1370361,1370643,34
1467,223,9636,1309682,1309905,34
2949,38,9639,612022,612060,34
4416,222,9639,1309687,1309909,34
8351,270,9657,1342175,1342445,34
2012,25,9679,422007,422032,34
7890,275,9705,1370284,1370559,34
8992,265,9711,1342177,1342442,34
5250,221,9733,1309681,1309902,34
1579,196,9751,1272032,1272228,34
8239,280,9784,1370210,1370490,34
3625,38,9793,612004,612042,34
8608,113,9821,1027226,1027339,34
2475,239,9834,1309613,1309852,34
6668,54,9844,611994,612048,34
7898,68,9846,778739,778807,34
2634,275,9850,1370154,1370429,34
5522,50,9862,612033,612083,34
6517,126,9906,1109319,1109445,34
3457,275,9922,1370087,1370362,34
6607,261,9930,1342065,1342326,34
2890,198,9936,1271984,1272182,34
7630,197,9945,1271984,1272181,34
6419,142,9952,1174506,1174648,34
1131,128,9970,1109379,1109507,34
215,151,106,1184361,1184512,35
200,295,133,1403913,1404208,35
634,135,164,1184344,1184479,35
771,257,326,1351726,1351983,35
533,45,331,621786,621831,35
223,165,350,1237058,1237223,35
628,67,353,788504,788571,35
734,126,416,1119060,1119186,35
497,153,438,1184118,1184271,35
529,267,455,1379599,1379866,35
644,111,478,1036958,1037069,35
789,93,495,1036962,1037055,35
551,6,560,219190,219196,35
140,242,750,1351355,1351597,35
702,207,752,1318914,1319121,35
669,27,801,431474,431501,35
600,237,900,1351216,1351453,35
412,243,969,1351153,1351396,35
159,89,985,927278,927367,35
829,187,987,1281134,1281321,35
1334,186,8000,1274128,1274314,35
6884,259,8014,1372049,1372308,35
7004,235,8042,1344119,1344354,35
6294,261,8060,1372004,1372265,35
9153,177,8073,1229584,1229761,35
2917,285,8078,1371989,1372274,35
9746,18,8081,424375,424393,35
6406,216,8110,1311714,1311930,35
2833,90,8173,920269,920359,35
5408,259,8183,1371911,1372170,35
4476,101,8202,1029531,1029632,35
7800,290,8210,1395845,1396135,35
8667,251,8212,1344061,1344312,35
2037,116,8217,1111648,1111764,35
4468,285,8228,1371895,1372180,35
5927,6,8244,211864,211870,35
4570,135,8252,1176715,1176850,35
4851,214,8273,1311666,1311880,35
1609,2,8328,211818,211820,35
7953,298,8340,1395719,1396017,35
1595,91,8366,1029525,1029616,35
1025,296,8369,1395702,1395998,35
4170,198,8406,1274028,1274226,35
6836,25,8446,424250,424275,35
2025,99,8456,1029478,1029577,35
3797,137,8459,1176602,1176739,35
8188,45,8478,614281,614326,35
7226,267,8488,1371718,1371985,35
9310,245,8497,1343904,1344149,35
8182,229,8500,1311552,1311781,35
9619,289,8501,1395580,1395869,35
7976,26,8524,424300,424326,35
3029,261,8530,1371713,1371974,35
6227,156,8533,1176647,1176803,35
3776,164,8542,1229496,1229660,35
5983,291,8550,1395534,1395825,35
4388,213,8564,1311590,1311803,35
4231,235,8565,1343931,1344166,35
7405,5,8566,211886,211891,35
2067,5,8574,211883,211888,35
2986,149,8589,1176706,1176855,35
3317,114,8595,1111671,1111785,35
1995,249,8605,1343895,1344144,35
9099,58,8606,781141,781199,35
7968,187,8614,1274063,1274250,35
9972,300,8625,1395464,1395764,35
8447,298,8628,1395475,1395773,35
3915,52,8633,781178,781230,35
2486,127,8637,1111720,1111847,35
3968,38,8646,614467,614505,35
6867,94,8652,1029669,1029763,35
7557,140,8657,1176746,1176886,35
5558,298,8664,1395451,1395749,35
8213,108,8667,1029700,1029808,35
2204,274,8670,1371688,1371962,35
8729,118,8691,1111748,1111866,35
5221,244,8695,1343931,1344175,35
6474,37,8704,614540,614577,35
5036,17,8705,424537,424554,35
5825,236,8705,1343934,1344170,35
8997,152,8728,1176774,1176926,35
2598,230,8750,1311620,1311850,35
1619,289,8769,1395358,1395647,35
9936,271,8784,1371618,1371889,35
7343,70,8803,781256,781326,35
3413,137,8807,1176783,1176920,35
4172,130,8815,1111785,1111915,35
8993,180,8821,1229561,1229741,35
5090,289,8846,1395284,1395573,35
2194,71,8866,920536,920607,35
4020,90,8870,920533,920623,35
5530,283,8880,1371563,1371846,35
3624,265,8906,1371562,1371827,35
3793,91,8910,1029769,1029860,35
9994,180,8913,1229565,1229745,35
9251,216,8934,1311591,1311807,35
9134,277,8936,1371539,1371816,35
7808,283,8944,1371550,1371833,35
4240,223,8953,1311635,1311858,35
6375,242,8957,1343876,1344118,35
4728,151,8993,1176831,1176982,35
4347,278,8997,1371522,1371800,35
4392,271,9025,1371514,1371785,35
9050,216,9040,1311644,1311860,35
7607,223,9072,1311623,1311846,35
9375,139,9088,1176846,1176985,35
9608,239,9089,1343809,1344048,35
6622,224,9094,1311645,1311869,35
9463,38,9109,614661,614699,35
6298,66,9125,781390,781456,35
1980,193,9138,1274121,1274314,35
9758,150,9147,1176862,1177012,35
4279,249,9151,1343755,1344004,35
7922,227,9194,1311590,1311817,35
5870,31,9195,424643,424674,35
3916,178,9210,1229628,1229806,35
1545,76,9245,920618,920694,35
7457,214,9247,1311559,1311773,35
3442,186,9252,1274095,1274281,35
5936,123,9254,1111915,1112038,35
3308,64,9262,781439,781503,35
8891,32,9264,424691,424723,35
9201,298,9277,1394856,1395154,35
8124,292,9280,1394865,1395157,35
7442,211,9282,1311585,1311796,35
7994,2,9282,212220,212222,35
6714,176,9289,1229691,1229867,35
1106,171,9311,1229689,1229860,35
3951,252,9318,1343660,1343912,35
1245,133,9322,1111991,1112124,35
7704,110,9322,1029967,1030077,35
5169,137,9325,1176954,1177091,35
1036,11,9345,212255,212266,35
6283,52,9348,781537,781589,35
2087,233,9350,1343649,1343882,35
5810,234,9356,1343645,1343879,35
3350,241,9373,1343631,1343872,35
5811,238,9382,1343632,1343870,35
3516,222,9404,1311599,1311821,35
1273,263,9409,1371199,1371462,35
2591,248,9415,1343633,1343881,35
1832,264,9417,1371196,1371460,35
1968,97,9420,1030078,1030175,35
3274,94,9423,1030082,1030176,35
3128,16,9426,212361,212377,35
6060,140,9432,1177035,1177175,35
4374,181,9452,1274201,1274382,35
3086,186,9471,1274183,1274369,35
2318,174,9474,1229805,1229979,35
4078,210,9501,1311597,1311807,35
2516,267,9517,1371102,1371369,35
9969,232,9521,1343598,1343830,35
6940,206,9531,1311624,1311830,35
6986,211,9531,1311625,1311836,35
6377,186,9543,1274242,1274428,35
8833,2,9565,212398,212400,35
6828,291,9568,1394583,1394874,35
3722,48,9573,614958,615006,35
1448,273,9578,1371078,1371351,35
4643,211,9604,1311610,1311821,35
4580,294,9640,1394516,1394810,35
7116,266,9660,1371039,1371305,35
6195,160,9666,1229895,1230055,35
1001,204,9682,1274234,1274438,35
7134,224,9683,1311589,1311813,35
6826,120,9690,1112239,1112359,35
9030,149,9702,1177163,1177312,35
7009,59,9710,781746,781805,35
4044,47,9713,615013,615060,35
5000,255,9720,1343508,1343763,35
9922,225,9739,1311578,1311803,35
4312,142,9748,1177179,1177321,35
10000,118,9752,1112274,1112392,35
7281,239,9753,1343499,1343738,35
7838,254,9766,1343494,1343748,35
9335,109,9766,1030289,1030398,35
8252,298,9768,1394396,1394694,35
5686,68,9775,781841,781909,35
8695,146,9803,1177202,1177348,35
6979,66,9813,781839,781905,35
9395,54,9815,781852,781906,35
7369,131,9830,1112291,1112422,35
3558,5,9839,212542,212547,35
1967,293,9849,1394327,1394620,35
2158,275,9883,1370880,1371155,35
2859,135,9892,1177172,1177307,35
6797,267,9931,1370849,1371116,35
3733,205,9946,1274219,1274424,35
2827,42,9958,615106,615148,35
2657,65,9964,781820,781885,35
2420,122,9993,1112258,1112380,35
9460,15,9994,212520,212535,35
442,48,56,625055,625103,36
539,107,67,1122201,1122308,36
849,116,88,1122182,1122298,36
514,253,206,1380595,1380848,36
305,160,251,1239609,1239769,36
870,170,361,1239511,1239681,36
478,157,601,1239293,1239450,36
733,215,606,1320922,1321137,36
565,292,618,1403578,1403870,36
652,194,647,1283624,1283818,36
653,277,679,1403536,1403813,36
241,211,687,1320911,1321122,36
646,185,715,1283627,1283812,36
290,57,888,791148,791205,36
1709,174,8011,1276345,1276519,36
6228,248,8013,1372849,1373097,36
6597,128,8023,1179360,1179488,36
9454,248,8023,1372841,1373089,36
7855,169,8028,1232082,1232251,36
6999,176,8031,1276376,1276552,36
1802,272,8040,1372826,1373098,36
5954,255,8047,1372845,1373100,36
6644,21,8047,427365,427386,36
1585,116,8052,1114607,1114723,36
6240,210,8058,1313656,1313866,36
3312,206,8067,1313662,1313868,36
5926,286,8069,1396150,1396436,36
7299,30,8096,427386,427416,36
4008,134,8098,1179463,1179597,36
9791,245,8116,1345494,1345739,36
2978,117,8135,1114640,1114757,36
6547,298,8137,1396095,1396393,36
1783,300,8143,1396114,1396414,36
3122,10,8172,214852,214862,36
1577,280,8174,1396110,1396390,36
8631,222,8180,1345533,1345755,36
7300,233,8182,1345533,1345766,36
3146,293,8219,1396072,1396365,36
7317,148,8222,1179501,1179649,36
8654,268,8258,1372778,1373046,36
7829,42,8266,617474,617516,36
9456,131,8271,1179496,1179627,36
1844,240,8274,1345506,1345746,36
3214,65,8304,784191,784256,36
6589,22,8306,427431,427453,36
3404,259,8309,1372749,1373008,36
8428,250,8312,1372759,1373009,36
3741,67,8314,923460,923527,36
6218,154,8326,1232196,1232350,36
7241,207,8347,1313693,1313900,36
2263,186,8353,1276467,1276653,36
5897,138,8366,1179538,1179676,36
9198,227,8391,1345461,1345688,36
9748,77,8391,923479,923556,36
4520,212,8422,1313655,1313867,36
7294,294,8434,1395877,1396171,36
5746,119,8446,1114740,1114859,36
6773,160,8452,1232191,1232351,36
4443,259,8453,1372649,1372908,36
9657,118,8482,1114760,1114878,36
2433,245,8498,1345413,1345658,36
9543,209,8500,1313669,1313878,36
5406,144,8510,1179560,1179704,36
4593,38,8511,617597,617635,36
3224,215,8514,1313669,1313884,36
9290,128,8519,1179591,1179719,36
2059,287,8524,1395808,1396095,36
2603,219,8534,1313694,1313913,36
1048,39,8539,617644,617683,36
9484,117,8544,1114858,1114975,36
5075,160,8563,1232230,1232390,36
3545,292,8567,1395779,1396071,36
3356,94,8569,1032899,1032993,36
8449,232,8587,1345401,1345633,36
8868,213,8606,1313696,1313909,36
9760,275,8608,1395757,1396032,36
1588,69,8609,923652,923721,36
2648,141,8612,1179654,1179795,36
3396,230,8617,1345409,1345639,36
3772,185,8625,1276546,1276731,36
5580,139,8634,1179691,1179830,36
7577,61,8644,784480,784541,36
6722,24,8655,427681,427705,36
5280,52,8660,784477,784529,36
7033,169,8661,1232282,1232451,36
3063,262,8669,1372527,1372789,36
4329,241,8669,1345393,1345634,36
8278,243,8672,1345411,1345654,36
2118,197,8681,1313764,1313961,36
9604,216,8710,1313737,1313953,36
3853,126,8717,1115012,1115138,36
1840,44,8734,617814,617858,36
8685,223,8737,1345369,1345592,36
4810,139,8738,1179754,1179893,36
7122,175,8745,1276584,1276759,36
5760,69,8769,923761,923830,36
1349,106,8771,1115042,1115148,36
8144,21,8772,427797,427818,36
3414,19,8789,427786,427805,36
8146,84,8791,923761,923845,36
9937,115,8792,1115022,1115137,36
4839,138,8809,1179718,1179856,36
6253,179,8809,1276524,1276703,36
7601,35,8824,617890,617925,36
2581,96,8829,1033068,1033164,36
7378,243,8846,1345263,1345506,36
8053,192,8849,1276516,1276708,36
1336,199,8874,1313644,1313843,36
4397,136,8892,1179735,1179871,36
6875,161,8897,1232320,1232481,36
3488,242,8906,1345226,1345468,36
5265,202,8913,1313634,1313836,36
4318,250,8972,1372240,1372490,36
2380,37,8987,617884,617921,36
5697,281,8992,1395375,1395656,36
2322,158,8995,1232327,1232485,36
9332,278,8996,1395379,1395657,36
1134,293,9008,1395372,1395665,36
5987,43,9010,617935,617978,36
9352,249,9083,1372214,1372463,36
2313,252,9122,1372178,1372430,36
4622,226,9139,1345171,1345397,36
1348,65,9152,784565,784630,36
7355,177,9157,1276469,1276646,36
9756,220,9157,1313572,1313792,36
4472,40,9163,617896,617936,36
8820,189,9202,1276454,1276643,36
6594,244,9205,1345111,1345355,36
3573,161,9213,1232326,1232487,36
8797,112,9215,1115071,1115183,36
6888,115,9248,1115045,1115160,36
2713,166,9253,1232299,1232465,36
3862,241,9258,1345082,1345323,36
6788,212,9266,1313538,1313750,36
6800,181,9266,1276480,1276661,36
3507,109,9283,1115104,1115213,36
4121,215,9290,1313531,1313746,36
8637,59,9292,784676,784735,36
3348,228,9297,1345064,1345292,36
5781,296,9301,1395099,1395395,36
7584,260,9358,1371975,1372235,36
1817,264,9368,1371979,1372243,36
1929,66,9368,784683,784749,36
8343,168,9394,1232360,1232528,36
5596,236,9397,1345050,1345286,36
6781,41,9397,617994,618035,36
3398,224,9399,1345064,1345288,36
5017,171,9405,1232415,1232586,36
3934,295,9411,1395012,1395307,36
2412,95,9441,1033207,1033302,36
6000,138,9454,1179843,1179981,36
4885,275,9459,1394986,1395261,36
2425,170,9468,1232421,1232591,36
1932,202,9488,1313553,1313755,36
8101,218,9490,1313558,1313776,36
5238,71,9494,923969,924040,36
4413,6,9496,215368,215374,36
5089,62,9498,784787,784849,36
7907,51,9502,784797,784848,36
8574,45,9509,618096,618141,36
4717,98,9517,1033241,1033339,36
3135,34,9523,618113,618147,36
2461,288,9525,1394922,1395210,36
2751,257,9531,1371915,1372172,36
9286,178,9536,1276532,1276710,36
3276,104,9539,1033292,1033396,36
8270,256,9540,1371917,1372173,36
9453,230,9541,1345056,1345286,36
4635,143,9564,1179943,1180086,36
4272,56,9583,784863,784919,36
3078,55,9604,784850,784905,36
5181,123,9616,1115216,1115339,36
5701,116,9617,1115233,1115349,36
7234,44,9627,618199,618243,36
3840,152,9632,1232440,1232592,36
8507,290,9641,1394821,1395111,36
7332,224,9647,1344986,1345210,36
4542,250,9658,1371836,1372086,36
5541,277,9663,1394816,1395093,36
7752,202,9672,1313599,1313801,36
9080,50,9682,784923,784973,36
9989,186,9687,1276556,1276742,36
6026,123,9725,1115283,1115406,36
5252,266,9734,1371791,1372057,36
7926,92,9757,1033373,1033465,36
9108,189,9787,1276495,1276684,36
2872,45,9788,618255,618300,36
9671,121,9790,1115278,1115399,36
8857,199,9791,1313512,1313711,36
6208,50,9821,784912,784962,36
6566,158,9821,1232462,1232620,36
2819,210,9847,1313460,1313670,36
9865,137,9865,1179923,1180060,36
6083,230,9867,1344848,1345078,36
3814,191,9871,1276501,1276692,36
9702,166,9876,1232486,1232652,36
7191,17,9884,428231,428248,36
7066,176,9893,1276499,1276675,36
1021,37,9905,618322,618359,36
4452,278,9907,1394576,1394854,36
7687,81,9908,924149,924230,36
7433,103,9915,1033442,1033545,36
9533,29,9919,428278,428307,36
8825,208,9924,1313448,1313656,36
4030,222,9930,1344821,1345043,36
6021,85,9930,924199,924284,36
5925,87,9945,1033470,1033557,36
4120,239,9985,1344768,1345007,36
5831,136,9986,1179989,1180125,36
9792,218,9986,1313449,1313667,36
8681,246,9993,1344779,1345025,36
7616,99,9999,1033498,1033597,36
857,10,53,225642,225652,37
577,110,70,1125335,1125445,37
639,258,234,1381350,1381608,37
749,10,336,225397,225407,37
647,73,369,933933,934006,37
772,200,477,1323040,1323240,37
774,91,507,1043066,1043157,37
485,117,656,1124800,1124917,37
296,207,756,1322776,1322983,37
309,80,759,933626,933706,37
216,193,797,1322757,1322950,37
874,130,871,1189249,1189379,37
202,222,888,1353946,1354168,37
4178,51,8001,787266,787317,37
5410,254,8007,1373601,1373855,37
9349,84,8012,1035686,1035770,37
8714,108,8022,1117552,1117660,37
1487,67,8028,926483,926550,37
6926,257,8039,1373589,1373846,37
4340,241,8043,1373608,1373849,37
2777,147,8068,1234657,1234804,37
7490,106,8091,1117552,1117658,37
3225,105,8093,1117557,1117662,37
2601,144,8112,1234620,1234764,37
2103,39,8125,620666,620705,37
9820,126,8132,1182125,1182251,37
9187,223,8140,1346782,1347005,37
8472,10,8147,217918,217928,37
4597,78,8149,926511,926589,37
8205,268,8180,1396321,1396589,37
6492,19,8186,430575,430594,37
2036,296,8196,1416209,1416505,37
7060,171,8203,1278600,1278771,37
7896,71,8204,926526,926597,37
2697,279,8206,1396330,1396609,37
3698,174,8206,1278629,1278803,37
2170,29,8212,430629,430658,37
3591,195,8223,1315531,1315726,37
7628,38,8229,620732,620770,37
1300,32,8230,620740,620772,37
6770,278,8235,1396320,1396598,37
6861,227,8244,1346792,1347019,37
7264,293,8258,1416156,1416449,37
1079,27,8269,430677,430704,37
2673,200,8273,1315563,1315763,37
3766,53,8292,787389,787442,37
3041,95,8295,1035768,1035863,37
5948,227,8321,1346758,1346985,37
9075,248,8325,1373463,1373711,37
4615,227,8330,1346792,1347019,37
2559,113,8338,1117638,1117751,37
6855,85,8350,1035804,1035889,37
7152,142,8364,1234680,1234822,37
1534,118,8407,1117603,1117721,37
5254,235,8410,1373392,1373627,37
4266,266,8419,1396181,1396447,37
6464,143,8434,1234656,1234799,37
7959,73,8458,926605,926678,37
5598,28,8464,430705,430733,37
6138,116,8464,1117625,1117741,37
3234,259,8465,1373364,1373623,37
7292,35,8504,620773,620808,37
9228,272,8510,1396096,1396368,37
5975,256,8535,1373345,1373601,37
1826,129,8536,1182169,1182298,37
7740,125,8578,1182137,1182262,37
5193,72,8594,926588,926660,37
8520,187,8602,1315441,1315628,37
8261,273,8626,1395992,1396265,37
7894,70,8628,926600,926670,37
3898,255,8634,1373294,1373549,37
1998,287,8654,1395977,1396264,37
6710,197,8655,1315462,1315659,37
8782,43,8662,620797,620840,37
9602,98,8662,1035801,1035899,37
6532,220,8669,1346671,1346891,37
8413,118,8676,1117650,1117768,37
4035,232,8698,1346653,1346885,37
3378,238,8704,1373271,1373509,37
2129,197,8714,1315487,1315684,37
6322,256,8719,1373260,1373516,37
3466,224,8737,1346687,1346911,37
1729,263,8741,1395917,1396180,37
6963,159,8748,1234675,1234834,37
3811,230,8752,1346712,1346942,37
3520,3,8787,218086,218089,37
1081,80,8796,926692,926772,37
5064,134,8797,1182218,1182352,37
6175,57,8802,787533,787590,37
7854,6,8808,218110,218116,37
9652,198,8811,1315498,1315696,37
8999,183,8818,1278650,1278833,37
6721,295,8832,1415588,1415883,37
3534,19,8835,430828,430847,37
6769,137,8845,1182248,1182385,37
3972,222,8852,1346658,1346880,37
9768,297,8854,1415574,1415871,37
3668,203,8863,1315531,1315734,37
1907,126,8895,1182279,1182405,37
1493,82,8918,1035924,1036006,37
9736,29,8941,430817,430846,37
6171,247,8946,1373133,1373380,37
4737,208,8958,1315478,1315686,37
1039,112,8959,1117766,1117878,37
1015,185,8960,1278667,1278852,37
4614,179,8968,1278682,1278861,37
8005,197,8983,1315476,1315673,37
5002,192,9008,1315463,1315655,37
2403,31,9024,620929,620960,37
9640,113,9033,1117785,1117898,37
8805,67,9038,926792,926859,37
1276,244,9039,1373053,1373297,37
1084,281,9046,1395669,1395950,37
6560,146,9083,1234689,1234835,37
9789,93,9109,1035944,1036037,37
5105,5,9112,218162,218167,37
2998,122,9113,1182257,1182379,37
2282,10,9118,218175,218185,37
7764,88,9126,1035959,1036047,37
1430,182,9142,1278617,1278799,37
9041,40,9162,620937,620977,37
5297,299,9165,1415273,1415572,37
6804,81,9173,1035958,1036039,37
6995,205,9208,1315342,1315547,37
8620,6,9221,218166,218172,37
3763,277,9233,1395530,1395807,37
9965,48,9247,787593,787641,37
4817,133,9276,1182181,1182314,37
2266,68,9296,926755,926823,37
7290,198,9304,1315290,1315488,37
2652,213,9307,1346366,1346579,37
1524,201,9341,1315290,1315491,37
7802,145,9348,1234584,1234729,37
1966,252,9378,1372802,1373054,37
8398,219,9394,1346308,1346527,37
2642,229,9400,1346312,1346541,37
7697,247,9413,1372785,1373032,37
9991,71,9438,926763,926834,37
9396,164,9444,1278565,1278729,37
1722,256,9454,1372757,1373013,37
7000,114,9465,1117747,1117861,37
6363,62,9480,787601,787663,37
9159,211,9505,1346277,1346488,37
5798,188,9508,1315283,1315471,37
9734,29,9537,430836,430865,37
9408,4,9541,218132,218136,37
1818,204,9556,1315238,1315442,37
6684,49,9569,787580,787629,37
3492,38,9572,620922,620960,37
5627,76,9593,926725,926801,37
5652,140,9598,1182146,1182286,37
3441,119,9611,1117696,1117815,37
7754,106,9628,1117699,1117805,37
1060,61,9630,787591,787652,37
5120,255,9638,1372595,1372850,37
6970,99,9645,1035886,1035985,37
5460,278,9651,1395129,1395407,37
7787,159,9657,1234522,1234681,37
6932,182,9665,1278484,1278666,37
9524,200,9683,1315178,1315378,37
5595,170,9692,1278500,1278670,37
4941,209,9706,1315170,1315379,37
4599,284,9708,1395090,1395374,37
1374,204,9714,1315210,1315414,37
4608,37,9744,620999,621036,37
6865,100,9745,1117769,1117869,37
5198,104,9758,1117757,1117861,37
4217,190,9762,1315181,1315371,37
8174,183,9785,1278507,1278690,37
2973,276,9801,1395021,1395297,37
6749,223,9807,1346077,1346300,37
6983,93,9829,1035987,1036080,37
2082,281,9875,1394963,1395244,37
6132,209,9884,1315136,1315345,37
7633,256,9886,1372472,1372728,37
9491,129,9925,1182176,1182305,37
7818,297,9972,1414478,1414775,37
9364,94,9981,1035943,1036037,37
4276,46,9987,787641,787687,37
9567,293,9989,1414471,1414764,37
2197,151,9990,1234538,1234689,37
7087,225,9992,1346006,1346231,37
9999,104,9994,1117766,1117870,37
1707,81,9996,1036018,1036099,37
439,179,195,1324955,1325134,38
718,146,254,1244336,1244482,38
667,282,267,1424213,1424495,38
817,133,277,1244348,1244481,38
677,127,359,1191923,1192050,38
475,271,382,1404570,1404841,38
109,146,410,1244237,1244383,38
431,53,442,797387,797440,38
354,219,514,1355559,1355778,38
532,135,568,1244114,1244249,38
227,21,606,440493,440514,38
847,300,744,1423745,1424045,38
543,18,763,440358,440376,38
432,192,804,1324442,1324634,38
263,233,845,1381674,1381907,38
776,133,863,1243885,1244018,38
549,294,989,1423527,1423821,38
4482,235,8002,1374553,1374788,38
4174,164,8013,1280691,1280855,38
4182,219,8038,1348152,1348371,38
1767,34,8046,623281,623315,38
2000,159,8081,1280656,1280815,38
6199,241,8082,1374486,1374727,38
2021,284,8084,1416453,1416737,38
9641,81,8085,1038295,1038376,38
6783,81,8098,1038288,1038369,38
3790,270,8106,1396948,1397218,38
9074,163,8136,1280673,1280836,38
6010,178,8141,1317283,1317461,38
6064,225,8148,1374489,1374714,38
5251,183,8182,1317268,1317451,38
7064,298,8203,1416345,1416643,38
8935,3,8215,220410,220413,38
6420,52,8223,789953,790005,38
4832,54,8225,789961,790015,38
8158,232,8244,1374421,1374653,38
3577,146,8246,1236797,1236943,38
4136,290,8295,1416278,1416568,38
5451,172,8299,1280652,1280824,38
9628,171,8300,1280670,1280841,38
5626,167,8303,1280685,1280852,38
5409,86,8304,1038304,1038390,38
5501,166,8316,1280686,1280852,38
1764,144,8318,1236844,1236988,38
3243,203,8331,1348048,1348251,38
2034,288,8343,1416247,1416535,38
6159,8,8353,220444,220452,38
1082,38,8363,623331,623369,38
2200,276,8382,1416223,1416499,38
7350,84,8385,1038324,1038408,38
5417,87,8390,1038328,1038415,38
6676,194,8391,1317205,1317399,38
1147,152,8394,1236864,1237016,38
4907,277,8416,1416192,1416469,38
9062,15,8419,433253,433268,38
5246,86,8420,1038364,1038450,38
4652,157,8428,1280697,1280854,38
2993,222,8448,1348008,1348230,38
9688,201,8452,1348028,1348229,38
6653,232,8470,1374305,1374537,38
7471,26,8475,433269,433295,38
3711,280,8482,1416130,1416410,38
8728,295,8488,1416131,1416426,38
7714,126,8489,1184628,1184754,38
2651,95,8492,1120172,1120267,38
4852,270,8493,1396766,1397036,38
2618,211,8517,1348062,1348273,38
7999,296,8520,1416121,1416417,38
7107,145,8546,1236942,1237087,38
4067,77,8571,1038440,1038517,38
2484,124,8574,1184637,1184761,38
7095,111,8590,1120171,1120282,38
5837,157,8593,1280712,1280869,38
9047,112,8600,1120198,1120310,38
4715,245,8622,1374263,1374508,38
2254,173,8637,1280694,1280867,38
8583,65,8639,929360,929425,38
3501,44,8647,790159,790203,38
8697,257,8652,1396656,1396913,38
6824,20,8667,433342,433362,38
9958,201,8667,1347997,1348198,38
5245,75,8672,929368,929443,38
9835,143,8677,1236929,1237072,38
5937,109,8692,1120220,1120329,38
2051,102,8698,1120230,1120332,38
1173,88,8707,1038504,1038592,38
6647,294,8733,1415931,1416225,38
3467,137,8756,1236882,1237019,38
9341,102,8758,1120217,1120319,38
1372,136,8759,1236884,1237020,38
8934,14,8761,433395,433409,38
3196,267,8767,1396577,1396844,38
6573,279,8776,1415909,1416188,38
3725,90,8786,1038546,1038636,38
9637,171,8799,1280662,1280833,38
6400,247,8814,1374194,1374441,38
3338,229,8815,1374218,1374447,38
5356,154,8831,1280692,1280846,38
2921,246,8834,1374206,1374452,38
8928,111,8838,1120298,1120409,38
8047,9,8848,220646,220655,38
7108,160,8876,1280670,1280830,38
3518,2,8892,220624,220626,38
8026,187,8899,1317130,1317317,38
6209,62,8928,929452,929514,38
9783,168,8944,1280631,1280799,38
8624,296,8959,1415732,1416028,38
1305,218,8971,1347864,1348082,38
8128,235,9003,1374086,1374321,38
2881,290,9005,1415709,1415999,38
5690,72,9011,929458,929530,38
8225,281,9013,1415718,1415999,38
4749,252,9016,1396452,1396704,38
3090,152,9038,1236945,1237097,38
7080,197,9038,1317141,1317338,38
2885,280,9043,1415696,1415976,38
8220,33,9055,623580,623613,38
6551,101,9081,1120301,1120402,38
6681,116,9093,1184690,1184806,38
6049,248,9099,1396400,1396648,38
1916,118,9102,1184705,1184823,38
8175,229,9113,1374114,1374343,38
2187,123,9117,1184716,1184839,38
3176,84,9129,1038650,1038734,38
2692,262,9135,1396365,1396627,38
5217,75,9140,929564,929639,38
9355,283,9150,1415596,1415879,38
1345,54,9161,790351,790405,38
9645,254,9161,1396380,1396634,38
3821,223,9175,1374134,1374357,38
5812,183,9178,1317184,1317367,38
5553,192,9179,1317191,1317383,38
1728,218,9180,1347939,1348157,38
9738,28,9186,623695,623723,38
3072,163,9187,1280777,1280940,38
4406,107,9196,1120441,1120548,38
7170,103,9206,1120445,1120548,38
6728,272,9226,1396322,1396594,38
5101,102,9232,1120448,1120550,38
8946,143,9277,1236999,1237142,38
5933,49,9287,790413,790462,38
9818,76,9289,1038733,1038809,38
1910,282,9290,1415466,1415748,38
5461,41,9356,623661,623702,38
7728,154,9372,1280646,1280800,38
5336,3,9375,220689,220692,38
4967,89,9379,1038680,1038769,38
2156,153,9390,1236939,1237092,38
7424,230,9394,1373966,1374196,38
7110,104,9399,1120385,1120489,38
1249,268,9400,1396199,1396467,38
8070,207,9403,1347832,1348039,38
3936,258,9404,1396216,1396474,38
9007,11,9447,220711,220722,38
3859,260,9452,1396179,1396439,38
4403,214,9455,1347837,1348051,38
9164,221,9459,1347849,1348070,38
4127,256,9474,1396170,1396426,38
5371,207,9492,1347863,1348070,38
6306,175,9493,1280724,1280899,38
4002,53,9494,790469,790522,38
9455,60,9506,929691,929751,38
6258,153,9513,1237047,1237200,38
8402,295,9518,1415247,1415542,38
3783,194,9523,1317163,1317357,38
9509,31,9524,623792,623823,38
2457,240,9531,1373962,1374202,38
1651,228,9541,1373970,1374198,38
4873,27,9544,433635,433662,38
5700,93,9576,1038803,1038896,38
4557,271,9591,1396088,1396359,38
9920,274,9592,1415195,1415469,38
8040,150,9593,1237114,1237264,38
9361,98,9607,1120511,1120609,38
6439,223,9628,1373939,1374162,38
8899,109,9630,1120512,1120621,38
2600,143,9643,1237103,1237246,38
4189,1,9663,220805,220806,38
1038,227,9686,1373882,1374109,38
1672,192,9686,1317157,1317349,38
9494,261,9693,1396036,1396297,38
6820,9,9723,220785,220794,38
1265,192,9752,1317131,1317323,38
1660,74,9768,929720,929794,38
3688,49,9826,790452,790501,38
5949,87,9840,1038755,1038842,38
4889,216,9844,1347712,1347928,38
2022,277,9854,1414934,1415211,38
3365,29,9865,623740,623769,38
9459,265,9888,1395881,1396146,38
9842,286,9908,1414884,1415170,38
2711,270,9920,1395893,1396163,38
4761,249,9922,1395914,1396163,38
7381,169,9959,1280654,1280823,38
3808,32,9966,623716,623748,38
4706,76,9967,1038766,1038842,38
3010,268,9971,1395867,1396135,38
4973,115,9986,1184758,1184873,38
6025,191,9988,1317073,1317264,38
1864,74,9997,929711,929785,38
8104,22,9997,433602,433624,38
809,132,60,1246978,1247110,39
217,13,71,443551,443564,39
276,205,82,1357647,1357852,39
238,107,206,1194606,1194713,39
199,95,248,1130255,1130350,39
150,184,362,1326747,1326931,39
501,39,400,633434,633473,39
168,26,408,633440,633466,39
763,240,420,1405452,1405692,39
723,58,518,939306,939364,39
251,31,580,633297,633328,39
931,225,716,1383068,1383293,39
352,5,767,230141,230146,39
810,215,839,1382960,1383175,39
433,255,847,1405031,1405286,39
341,216,852,1382976,1383192,39
569,261,865,1423954,1424215,39
981,193,870,1357015,1357208,39
430,215,894,1382964,1383179,39
240,155,966,1289926,1290081,39
966,19,999,442845,442864,39
8732,269,8031,1416790,1417059,39
4682,17,8086,435778,435795,39
5991,85,8096,1040952,1041037,39
5510,23,8097,435785,435808,39
1706,187,8112,1319214,1319401,39
2607,172,8116,1319232,1319404,39
2370,259,8152,1397797,1398056,39
5269,84,8154,1040960,1041044,39
8393,97,8181,1122582,1122679,39
8990,292,8182,1432739,1433031,39
8370,281,8204,1416653,1416934,39
7307,118,8216,1186902,1187020,39
6581,126,8223,1239163,1239289,39
5425,2,8233,222932,222934,39
3148,84,8244,1040969,1041053,39
2212,299,8251,1432677,1432976,39
1494,75,8281,1040963,1041038,39
8460,206,8336,1349693,1349899,39
1535,57,8356,931840,931897,39
1303,45,8363,792598,792643,39
4874,171,8394,1319071,1319242,39
5864,269,8406,1416499,1416768,39
9518,35,8408,625853,625888,39
1344,177,8423,1319070,1319247,39
9961,145,8450,1282684,1282829,39
9457,5,8479,222820,222825,39
5353,114,8484,1186780,1186894,39
7255,236,8488,1397586,1397822,39
8587,104,8502,1122487,1122591,39
6674,168,8507,1319020,1319188,39
6389,153,8525,1282652,1282805,39
7250,99,8531,1122511,1122610,39
5747,120,8538,1186792,1186912,39
2079,129,8555,1239013,1239142,39
8827,58,8604,931787,931845,39
3769,288,8618,1432324,1432612,39
9368,259,8624,1397477,1397736,39
6574,60,8629,931798,931858,39
1318,287,8636,1432309,1432596,39
5915,177,8656,1318940,1319117,39
2190,89,8680,1122482,1122571,39
9646,73,8688,1040867,1040940,39
2423,56,8707,931790,931846,39
4187,168,8715,1318893,1319061,39
3405,227,8727,1375376,1375603,39
6736,199,8730,1349456,1349655,39
3002,14,8736,435677,435691,39
4007,30,8754,625825,625855,39
7058,114,8762,1186735,1186849,39
6948,106,8770,1186736,1186842,39
8753,146,8817,1282516,1282662,39
6965,294,8819,1432128,1432422,39
1011,161,8822,1282534,1282695,39
2239,260,8823,1416170,1416430,39
5556,185,8825,1318874,1319059,39
9145,13,8830,435689,435702,39
7644,56,8832,931827,931883,39
6717,32,8837,625859,625891,39
5794,76,8856,1040872,1040948,39
6288,53,8857,792605,792658,39
7073,78,8865,1040869,1040947,39
4466,97,8871,1122473,1122570,39
2214,273,8878,1416116,1416389,39
1983,273,8887,1416121,1416394,39
5402,271,8888,1416134,1416405,39
3647,87,8899,1040911,1040998,39
2154,129,8900,1238973,1239102,39
6686,18,8905,435758,435776,39
9971,48,8907,792674,792722,39
7230,239,8925,1397351,1397590,39
9334,233,8932,1375332,1375565,39
8752,89,8940,1122522,1122611,39
7971,118,8953,1186763,1186881,39
3895,2,8970,222898,222900,39
1386,151,8984,1282536,1282687,39
7717,30,9004,625909,625939,39
4611,268,9008,1416026,1416294,39
6403,119,9012,1186755,1186874,39
6237,162,9015,1282533,1282695,39
3037,285,9019,1416024,1416309,39
1315,15,9020,435792,435807,39
4210,288,9043,1431913,1432201,39
4343,74,9044,1040970,1041044,39
3407,155,9059,1282549,1282704,39
5908,171,9066,1318829,1319000,39
3579,173,9069,1318832,1319005,39
7563,70,9074,931939,932009,39
5783,133,9086,1238992,1239125,39
7396,104,9091,1122571,1122675,39
7345,211,9109,1375250,1375461,39
4705,47,9119,792741,792788,39
7729,91,9125,1122572,1122663,39
1157,64,9159,931934,931998,39
5256,49,9169,792729,792778,39
8536,78,9185,1040952,1041030,39
1831,272,9186,1415909,1416181,39
5067,79,9196,1040966,1041045,39
6265,23,9211,435812,435835,39
2705,240,9222,1397159,1397399,39
9359,281,9240,1415868,1416149,39
4642,131,9243,1238924,1239055,39
2092,212,9257,1375175,1375387,39
2454,292,9265,1431694,1431986,39
4450,27,9272,625996,626023,39
2291,250,9274,1397163,1397413,39
4831,210,9291,1349298,1349508,39
5215,274,9298,1415858,1416132,39
3180,187,9303,1318804,1318991,39
1274,280,9307,1415864,1416144,39
3217,178,9311,1318840,1319018,39
4284,143,9317,1239017,1239160,39
6267,119,9338,1186842,1186961,39
6096,299,9395,1431571,1431870,39
2919,238,9408,1397120,1397358,39
8427,120,9435,1186797,1186917,39
2980,152,9438,1282517,1282669,39
3022,181,9444,1318764,1318945,39
8523,122,9504,1186781,1186903,39
6104,196,9507,1349197,1349393,39
9770,72,9522,1040989,1041061,39
3697,293,9535,1431445,1431738,39
8009,287,9543,1431445,1431732,39
8284,159,9550,1282497,1282656,39
1976,208,9552,1349207,1349415,39
8646,70,9553,931998,932068,39
9540,91,9557,1122594,1122685,39
9996,292,9561,1431429,1431721,39
2893,122,9565,1186851,1186973,39
7444,136,9575,1238978,1239114,39
7156,283,9578,1415718,1416001,39
3386,168,9584,1318772,1318940,39
4381,173,9584,1318775,1318948,39
9859,66,9586,932093,932159,39
1023,115,9596,1186913,1187028,39
9237,257,9597,1397035,1397292,39
6129,189,9611,1349238,1349427,39
9238,121,9616,1186941,1187062,39
3828,110,9619,1186954,1187064,39
6066,225,9620,1375078,1375303,39
5894,268,9622,1415698,1415966,39
7635,266,9636,1415693,1415959,39
3228,171,9649,1318828,1318999,39
8788,225,9657,1375104,1375329,39
4033,104,9662,1122781,1122885,39
8733,94,9666,1122794,1122888,39
3969,100,9689,1122778,1122878,39
5404,288,9693,1431304,1431592,39
7432,151,9707,1282628,1282779,39
9206,49,9714,792974,793023,39
7393,287,9727,1431273,1431560,39
4103,183,9738,1318811,1318994,39
8948,9,9763,223031,223040,39
7325,256,9772,1396983,1397239,39
9017,73,9774,1041232,1041305,39
3181,4,9778,223049,223053,39
5731,100,9783,1122787,1122887,39
5634,142,9788,1239077,1239219,39
6116,29,9797,626187,626216,39
3775,176,9811,1318778,1318954,39
1024,199,9827,1349185,1349384,39
8499,87,9838,1041239,1041326,39
7699,7,9852,223051,223058,39
7256,207,9866,1349158,1349365,39
5110,212,9869,1374979,1375191,39
4803,278,9882,1415506,1415784,39
1527,226,9887,1374987,1375213,39
6915,206,9888,1349225,1349431,39
4721,258,9892,1396910,1397168,39
5433,288,9894,1431108,1431396,39
1393,18,9895,436023,436041,39
6224,101,9905,1122858,1122959,39
3893,35,9914,626228,626263,39
3854,99,9938,1122839,1122938,39
9797,118,9938,1187020,1187138,39
1069,135,9959,1239104,1239239,39
8258,201,9981,1349197,1349398,39
9483,121,9993,1187016,1187137,39
183,37,67,802964,803001,40
889,181,149,1359054,1359235,40
252,254,203,1425244,1425498,40
833,124,209,1248931,1249055,40
908,150,221,1292443,1292593,40
887,261,249,1425207,1425468,40
902,45,301,802801,802846,40
620,32,409,635906,635938,40
792,166,478,1328393,1328559,40
995,245,525,1406387,1406632,40
670,143,577,1292162,1292305,40
538,71,609,1050839,1050910,40
192,12,619,445541,445553,40
528,172,649,1328254,1328426,40
748,114,812,1196382,1196496,40
924,77,857,1050629,1050706,40
405,105,994,1196216,1196321,40
7034,197,8001,1351273,1351470,40
4605,134,8003,1241278,1241412,40
6527,143,8004,1284783,1284926,40
5571,19,8011,438234,438253,40
9064,88,8012,1125093,1125181,40
5938,198,8031,1351264,1351462,40
9212,59,8034,934523,934582,40
1666,293,8036,1432984,1433277,40
2334,59,8039,934542,934601,40
8102,79,8052,1043558,1043637,40
4655,237,8053,1398907,1399144,40
8148,137,8076,1284779,1284916,40
8824,12,8087,438262,438274,40
8996,142,8087,1284770,1284912,40
3464,62,8089,934561,934623,40
3536,97,8107,1125090,1125187,40
6317,208,8143,1376922,1377130,40
3762,17,8151,438247,438264,40
7383,296,8157,1432886,1433182,40
8960,286,8167,1432902,1433188,40
9701,130,8177,1241293,1241423,40
7776,12,8185,438255,438267,40
5643,210,8187,1376934,1377144,40
6795,19,8192,438261,438280,40
5555,122,8195,1241308,1241430,40
4960,216,8199,1376934,1377150,40
6198,286,8202,1432883,1433169,40
9277,52,8208,934589,934641,40
2205,242,8213,1398835,1399077,40
4484,289,8251,1432850,1433139,40
6595,294,8253,1432867,1433161,40
1199,121,8257,1241347,1241468,40
4984,100,8270,1189307,1189407,40
6310,72,8290,1043606,1043678,40
8786,132,8295,1241314,1241446,40
2088,186,8296,1351263,1351449,40
8244,78,8301,1043634,1043712,40
6344,284,8328,1432816,1433100,40
7653,61,8354,934595,934656,40
1067,94,8356,1125129,1125223,40
3098,39,8369,795344,795383,40
1238,51,8392,934583,934634,40
7924,232,8397,1398744,1398976,40
2007,190,8412,1351201,1351391,40
8611,207,8414,1376875,1377082,40
3905,17,8426,438287,438304,40
8657,272,8426,1432732,1433004,40
9634,155,8427,1284737,1284892,40
6356,157,8428,1320891,1321048,40
3364,187,8445,1351226,1351413,40
2274,218,8468,1376853,1377071,40
4183,64,8472,934624,934688,40
6046,279,8473,1432687,1432966,40
7707,93,8483,1125168,1125261,40
5847,69,8491,1043649,1043718,40
7612,280,8507,1432662,1432942,40
3535,167,8518,1320887,1321054,40
3106,46,8523,795403,795449,40
2962,274,8532,1432647,1432921,40
5792,210,8546,1376864,1377074,40
5902,17,8563,438324,438341,40
8375,100,8567,1189300,1189400,40
9227,107,8573,1189296,1189403,40
9941,193,8585,1351207,1351400,40
4117,250,8602,1417145,1417395,40
4379,292,8617,1432566,1432858,40
4294,63,8627,934663,934726,40
4199,274,8631,1432574,1432848,40
7660,99,8634,1189316,1189415,40
6719,245,8650,1398670,1398915,40
6984,17,8684,438317,438334,40
7115,205,8688,1376826,1377031,40
1539,209,8693,1376828,1377037,40
1418,290,8703,1432506,1432796,40
3928,273,8712,1432517,1432790,40
6027,147,8779,1284745,1284892,40
7638,262,8784,1417068,1417330,40
2997,272,8795,1432437,1432709,40
7279,270,8796,1417098,1417368,40
9303,93,8813,1125190,1125283,40
9325,291,8813,1432421,1432712,40
1007,292,8824,1432431,1432723,40
7554,176,8832,1320921,1321097,40
4582,199,8834,1376859,1377058,40
6157,100,8838,1189347,1189447,40
6421,296,8839,1432438,1432734,40
7200,53,8864,934709,934762,40
3064,190,8874,1351265,1351455,40
5615,244,8884,1398652,1398896,40
5047,189,8891,1351284,1351473,40
6842,155,8916,1284840,1284995,40
5295,45,8920,795450,795495,40
5906,21,8920,438339,438360,40
6632,198,8929,1351259,1351457,40
8940,84,8929,1125273,1125357,40
1504,25,8937,628609,628634,40
2849,235,8976,1398583,1398818,40
9471,166,8979,1320942,1321108,40
1934,121,8980,1241405,1241526,40
3798,125,9002,1241388,1241513,40
2478,175,9028,1320904,1321079,40
3578,295,9051,1432252,1432547,40
5400,39,9052,795439,795478,40
4918,289,9065,1432263,1432552,40
3120,136,9074,1284822,1284958,40
7703,198,9074,1351202,1351400,40
2468,279,9082,1432265,1432544,40
4806,40,9096,795454,795494,40
4966,266,9121,1416948,1417214,40
2180,283,9127,1432229,1432512,40
8720,114,9136,1189375,1189489,40
3175,246,9168,1416947,1417193,40
7461,71,9187,1043709,1043780,40
7267,184,9188,1351198,1351382,40
2988,40,9190,795448,795488,40
9643,25,9201,628594,628619,40
2498,172,9226,1320894,1321066,40
2216,13,9269,438288,438301,40
3982,168,9278,1320859,1321027,40
2372,9,9281,225305,225314,40
7793,135,9290,1241337,1241472,40
5349,107,9293,1189324,1189431,40
3263,250,9299,1416817,1417067,40
6569,281,9319,1432050,1432331,40
1405,38,9339,795387,795425,40
9973,88,9342,1125220,1125308,40
8090,80,9347,1043683,1043763,40
5804,111,9350,1189312,1189423,40
9357,81,9353,1043708,1043789,40
2312,133,9358,1241326,1241459,40
7682,187,9358,1351080,1351267,40
5072,44,9377,795435,795479,40
1178,83,9381,1125239,1125322,40
9452,208,9393,1376554,1376762,40
6424,234,9394,1398371,1398605,40
1653,67,9400,1043757,1043824,40
4625,151,9407,1284750,1284901,40
5525,185,9415,1351078,1351263,40
3283,136,9448,1284745,1284881,40
1364,12,9466,438333,438345,40
2674,41,9483,795435,795476,40
8313,230,9492,1398286,1398516,40
3800,180,9529,1350995,1351175,40
2614,293,9535,1431845,1432138,40
9887,262,9539,1416632,1416894,40
9923,127,9556,1241335,1241462,40
4447,39,9575,795418,795457,40
6815,159,9633,1320727,1320886,40
5963,115,9640,1189269,1189384,40
1638,201,9641,1376408,1376609,40
7503,229,9648,1398187,1398416,40
9366,217,9676,1376399,1376616,40
2838,70,9694,1043673,1043743,40
9718,227,9707,1398136,1398363,40
4081,224,9711,1398138,1398362,40
4750,229,9738,1398114,1398343,40
6200,66,9739,1043681,1043747,40
8987,257,9744,1416444,1416701,40
7268,265,9757,1416443,1416708,40
9779,258,9762,1416458,1416716,40
3229,59,9768,934693,934752,40
3087,60,9772,934698,934758,40
7775,272,9773,1431630,1431902,40
7380,42,9776,795444,795486,40
7937,83,9800,1125196,1125279,40
5789,135,9805,1241306,1241441,40
5606,63,9824,934701,934764,40
1415,248,9856,1416402,1416650,40
6014,38,9864,795418,795456,40
5920,217,9877,1376401,1376618,40
6575,118,9886,1241282,1241400,40
3695,29,9888,628585,628614,40
3805,37,9904,795408,795445,40
8717,229,9909,1398071,1398300,40
6852,152,9911,1284643,1284795,40
5520,3,9923,225277,225280,40
1419,165,9926,1320711,1320876,40
4496,211,9928,1376392,1376603,40
4064,29,9937,628607,628636,40
5537,248,9964,1416297,1416545,40
8675,169,9986,1320703,1320872,40
2809,157,9993,1320710,1320867,40
375,88,58,1135133,1135221,41
712,277,87,1441333,1441610,41
798,269,88,1441354,1441623,41
537,103,116,1199229,1199332,41
844,38,126,805340,805378,41
408,8,133,235186,235194,41
622,236,138,1426188,1426424,41
952,136,193,1294544,1294680,41
172,281,278,1453989,1454270,41
134,100,299,1199109,1199209,41
154,97,343,1199074,1199171,41
284,63,347,1053470,1053533,41
818,297,442,1453826,1454123,41
579,198,492,1385986,1386184,41
520,2,565,234842,234844,41
498,40,571,805004,805044,41
312,275,572,1440934,1441209,41
761,270,588,1440938,1441208,41
878,134,730,1294112,1294246,41
739,111,739,1250752,1250863,41
679,39,849,804785,804824,41
709,25,891,637928,637953,41
725,216,916,1407270,1407486,41
289,132,949,1293920,1294052,41
5903,111,8013,1243517,1243628,41
6147,173,8021,1353081,1353254,41
9172,174,8032,1353078,1353252,41
8417,144,8040,1286873,1287017,41
8596,299,8057,1446228,1446527,41
1942,179,8060,1353080,1353259,41
2086,156,8080,1322895,1323051,41
8986,58,8093,936949,937007,41
9560,152,8100,1322886,1323038,41
2520,84,8115,1127473,1127557,41
2352,275,8122,1433444,1433719,41
5988,97,8133,1191579,1191676,41
6561,173,8146,1353029,1353202,41
6840,143,8147,1286898,1287041,41
2585,120,8150,1243563,1243683,41
2923,234,8157,1418318,1418552,41
5045,107,8191,1191595,1191702,41
8197,146,8209,1322844,1322990,41
3986,238,8210,1418268,1418506,41
5867,72,8212,1045998,1046070,41
4762,256,8239,1433347,1433603,41
4244,221,8262,1400047,1400268,41
6552,192,8277,1378411,1378603,41
2225,284,8280,1446024,1446308,41
2631,127,8303,1286892,1287019,41
8240,253,8350,1418183,1418436,41
5294,300,8365,1445943,1446243,41
4259,291,8393,1445935,1446226,41
7409,28,8405,630778,630806,41
6568,138,8408,1286845,1286983,41
2050,99,8414,1191575,1191674,41
7301,57,8425,936937,936994,41
4702,94,8450,1191547,1191641,41
5592,205,8455,1378327,1378532,41
6112,165,8457,1322777,1322942,41
9178,116,8465,1243512,1243628,41
2864,264,8480,1433182,1433446,41
2715,122,8491,1243512,1243634,41
1635,181,8492,1352922,1353103,41
2219,42,8493,797667,797709,41
5058,209,8521,1399916,1400125,41
4401,161,8530,1322784,1322945,41
4162,32,8560,630786,630818,41
3899,207,8561,1378284,1378491,41
6969,24,8579,630790,630814,41
3774,227,8587,1399851,1400078,41
4814,135,8589,1286828,1286963,41
5589,285,8595,1445744,1446029,41
8647,190,8620,1378290,1378480,41
8708,275,8635,1433061,1433336,41
4321,11,8653,440432,440443,41
1090,219,8657,1399846,1400065,41
2135,37,8658,797628,797665,41
8861,60,8673,936924,936984,41
5028,22,8694,630774,630796,41
5113,58,8704,936907,936965,41
5744,144,8720,1286782,1286926,41
9901,40,8722,797607,797647,41
8473,13,8737,440426,440439,41
7458,285,8739,1445605,1445890,41
2362,23,8754,630763,630786,41
8653,248,8769,1417930,1418178,41
1028,142,8777,1286781,1286923,41
6367,77,8791,1127430,1127507,41
5921,75,8813,1045874,1045949,41
6833,208,8826,1378176,1378384,41
4290,5,8834,227325,227330,41
7092,278,8844,1432897,1433175,41
9119,163,8844,1322686,1322849,41
8002,288,8851,1445498,1445786,41
5843,107,8877,1191514,1191621,41
9717,274,8878,1432911,1433185,41
7118,95,8881,1191543,1191638,41
8356,281,8901,1445456,1445737,41
8154,126,8915,1243462,1243588,41
2676,101,8921,1191541,1191642,41
6163,85,8924,1127459,1127544,41
2577,111,8926,1243469,1243580,41
4400,17,8944,440420,440437,41
7985,249,8950,1417862,1418111,41
4782,285,8952,1445406,1445691,41
7194,207,9019,1378137,1378344,41
5751,271,9026,1432832,1433103,41
5563,57,9046,936885,936942,41
4048,122,9061,1243409,1243531,41
2030,72,9064,1045893,1045965,41
3999,51,9072,936898,936949,41
2389,73,9080,1045889,1045962,41
9466,111,9081,1243403,1243514,41
4533,76,9087,1127418,1127494,41
6085,10,9093,227301,227311,41
4299,185,9135,1352673,1352858,41
2294,293,9138,1445225,1445518,41
9876,255,9140,1417762,1418017,41
1923,3,9142,227292,227295,41
4965,258,9158,1432741,1432999,41
9446,263,9163,1432739,1433002,41
2363,134,9182,1286677,1286811,41
3852,250,9189,1417785,1418035,41
3759,159,9191,1322617,1322776,41
2712,214,9196,1399640,1399854,41
9813,183,9207,1352747,1352930,41
7816,167,9226,1352746,1352913,41
1401,288,9228,1445148,1445436,41
3754,178,9243,1352752,1352930,41
5982,170,9247,1352761,1352931,41
2693,268,9252,1432683,1432951,41
5899,195,9254,1378121,1378316,41
9767,287,9282,1445102,1445389,41
4464,224,9344,1399567,1399791,41
6727,189,9348,1378080,1378269,41
5881,283,9350,1445041,1445324,41
5437,25,9357,630726,630751,41
9221,242,9446,1417643,1417885,41
6266,171,9465,1352695,1352866,41
4315,274,9471,1432527,1432801,41
8602,231,9481,1399515,1399746,41
9519,102,9482,1191517,1191619,41
6352,238,9484,1417640,1417878,41
5787,183,9503,1352726,1352909,41
1468,171,9521,1352726,1352897,41
5243,137,9522,1286744,1286881,41
1135,176,9523,1352730,1352906,41
6090,297,9531,1444863,1445160,41
5357,95,9550,1191562,1191657,41
8147,282,9553,1444858,1445140,41
5972,23,9577,630666,630689,41
8274,131,9581,1286753,1286884,41
8312,126,9582,1243481,1243607,41
3268,77,9609,1127457,1127534,41
5031,46,9639,797529,797575,41
6943,171,9647,1352659,1352830,41
6998,197,9651,1377934,1378131,41
4938,173,9653,1352680,1352853,41
1533,87,9665,1127451,1127538,41
2033,45,9671,797562,797607,41
4098,6,9687,227160,227166,41
2267,282,9710,1444703,1444985,41
7781,45,9716,797542,797587,41
4848,164,9718,1322624,1322788,41
2237,212,9721,1399390,1399602,41
8066,118,9735,1243454,1243572,41
6029,272,9736,1432356,1432628,41
9636,156,9755,1322646,1322802,41
2726,21,9760,440293,440314,41
7459,31,9767,630670,630701,41
8095,287,9783,1444632,1444919,41
1904,27,9797,630662,630689,41
7792,169,9804,1352621,1352790,41
8502,239,9806,1417445,1417684,41
5647,86,9814,1127458,1127544,41
4239,46,9837,797550,797596,41
5946,218,9869,1399315,1399533,41
7028,219,9877,1399317,1399536,41
3335,178,9892,1352600,1352778,41
3604,178,9894,1352611,1352789,41
2279,228,9895,1399310,1399538,41
7214,51,9903,936884,936935,41
8263,23,9917,630668,630691,41
6759,153,9926,1322646,1322799,41
7904,31,9952,630647,630678,41
8209,213,9964,1399261,1399474,41
8380,102,9979,1191511,1191613,41
546,183,133,1387673,1387856,42
629,132,135,1296573,1296705,42
950,95,223,1201317,1201412,42
421,80,265,1137197,1137277,42
934,280,317,1454121,1454401,42
322,295,420,1464661,1464956,42
319,1,429,236738,236739,42
925,100,545,1201038,1201138,42
756,225,556,1426763,1426988,42
813,242,569,1441628,1441870,42
929,263,569,1441630,1441893,42
936,116,574,1252968,1253084,42
993,181,623,1387297,1387478,42
909,94,631,1201048,1201142,42
676,147,677,1332066,1332213,42
770,51,718,946302,946353,42
503,258,721,1441501,1441759,42
508,72,722,1136916,1136988,42
736,206,804,1408571,1408777,42
550,46,810,946258,946304,42
945,249,813,1441427,1441676,42
938,203,857,1408551,1408754,42
481,201,863,1408553,1408754,42
191,169,870,1361941,1362110,42
415,157,871,1361955,1362112,42
326,88,917,1200900,1200988,42
125,113,924,1252787,1252900,42
464,235,941,1426478,1426713,42
266,6,943,236414,236420,42
531,266,960,1453519,1453785,42
834,104,973,1252785,1252889,42
7531,95,8004,1193881,1193976,42
5182,174,8017,1354852,1355026,42
8229,208,8018,1401448,1401656,42
3408,71,8020,1129831,1129902,42
2397,109,8021,1245775,1245884,42
5108,86,8046,1193898,1193984,42
5569,251,8083,1434190,1434441,42
5161,66,8094,1048269,1048335,42
1339,56,8100,1048274,1048330,42
9931,231,8123,1419360,1419591,42
9474,30,8163,632901,632931,42
9502,179,8168,1379969,1380148,42
2787,166,8169,1354800,1354966,42
9138,158,8182,1354799,1354957,42
7475,127,8183,1288954,1289081,42
7351,182,8188,1379954,1380136,42
8938,4,8189,229336,229340,42
6141,83,8190,1129798,1129881,42
9203,224,8195,1419302,1419526,42
6454,198,8211,1401334,1401532,42
1988,135,8213,1288988,1289123,42
9188,98,8215,1193891,1193989,42
6520,235,8219,1419285,1419520,42
2209,283,8265,1446216,1446499,42
4590,178,8293,1379941,1380119,42
9087,151,8302,1324871,1325022,42
2742,69,8306,1048279,1048348,42
8721,143,8320,1324869,1325012,42
5346,217,8325,1401267,1401484,42
6456,136,8355,1324861,1324997,42
5114,93,8357,1193875,1193968,42
3746,80,8358,1129824,1129904,42
8590,49,8368,939224,939273,42
8332,227,8376,1419169,1419396,42
9911,204,8393,1401243,1401447,42
2350,38,8398,799866,799904,42
2576,74,8410,1129813,1129887,42
3778,160,8412,1354753,1354913,42
8334,7,8421,229297,229304,42
4510,268,8438,1446062,1446330,42
2290,44,8447,939217,939261,42
9084,37,8448,799872,799909,42
5180,57,8451,1048288,1048345,42
2416,4,8452,229309,229313,42
6825,187,8459,1379863,1380050,42
7939,163,8463,1354748,1354911,42
6394,296,8465,1456622,1456918,42
5338,72,8467,1129836,1129908,42
4653,75,8512,1129794,1129869,42
1059,45,8523,939221,939266,42
9985,182,8535,1379821,1380003,42
8325,177,8568,1379796,1379973,42
4663,65,8574,1048265,1048330,42
9871,9,8583,229263,229272,42
7129,63,8589,1048260,1048323,42
7911,36,8624,799835,799871,42
8346,207,8650,1401039,1401246,42
6550,257,8671,1433685,1433942,42
7439,32,8676,799813,799845,42
3380,12,8680,442423,442435,42
1973,192,8682,1379727,1379919,42
5577,176,8689,1379738,1379914,42
8930,185,8709,1379720,1379905,42
8463,86,8714,1193751,1193837,42
7627,248,8761,1433612,1433860,42
1752,71,8766,1129681,1129752,42
4696,94,8767,1193716,1193810,42
9582,211,8775,1400970,1401181,42
8761,172,8782,1354638,1354810,42
7867,221,8784,1418863,1419084,42
7977,171,8802,1354656,1354827,42
6518,169,8807,1354668,1354837,42
1436,46,8810,939171,939217,42
8067,127,8819,1288886,1289013,42
4947,202,8848,1400935,1401137,42
6309,206,8854,1400936,1401142,42
2948,256,8884,1433497,1433753,42
6480,31,8887,799808,799839,42
1960,91,8893,1193744,1193835,42
3902,127,8916,1288853,1288980,42
8945,257,8923,1433474,1433731,42
7779,31,8926,799806,799837,42
8840,235,8936,1418761,1418996,42
9210,32,8942,799803,799835,42
1596,130,8944,1288871,1289001,42
3150,295,8947,1456147,1456442,42
6181,14,8954,442412,442426,42
1074,100,8963,1193761,1193861,42
2626,65,8973,1048234,1048299,42
8249,293,8990,1456110,1456403,42
1314,236,9009,1418752,1418988,42
9681,26,9039,632850,632876,42
6365,182,9055,1379616,1379798,42
7715,216,9056,1400877,1401093,42
9898,139,9061,1324726,1324865,42
3563,186,9100,1379600,1379786,42
8705,172,9102,1354608,1354780,42
8171,225,9106,1418674,1418899,42
7708,80,9107,1129717,1129797,42
5038,176,9109,1379624,1379800,42
2763,59,9134,1048223,1048282,42
4634,206,9136,1400840,1401046,42
3743,154,9138,1324748,1324902,42
9291,271,9141,1445438,1445709,42
1191,285,9155,1445431,1445716,42
4130,54,9155,939181,939235,42
7089,154,9171,1324772,1324926,42
9493,37,9176,799823,799860,42
5292,298,9186,1455918,1456216,42
5630,17,9197,442394,442411,42
2861,143,9210,1324771,1324914,42
7478,195,9214,1379605,1379800,42
3379,294,9224,1455889,1456183,42
3137,63,9231,1048256,1048319,42
5651,178,9245,1379616,1379794,42
1046,228,9278,1418602,1418830,42
7796,55,9294,939158,939213,42
3942,132,9318,1288888,1289020,42
3281,8,9339,229092,229100,42
2899,154,9350,1324715,1324869,42
9854,222,9351,1418540,1418762,42
9902,71,9356,1129704,1129775,42
6707,268,9361,1445296,1445564,42
9264,65,9377,1048216,1048281,42
3669,174,9379,1354589,1354763,42
9552,111,9380,1245632,1245743,42
9054,33,9400,799798,799831,42
7817,60,9403,1048228,1048288,42
6756,234,9426,1418493,1418727,42
6936,200,9432,1400731,1400931,42
2647,8,9436,229102,229110,42
5714,226,9455,1418481,1418707,42
6108,287,9457,1445204,1445491,42
8897,9,9460,229104,229113,42
9709,102,9472,1245619,1245721,42
6902,72,9480,1129702,1129774,42
9258,80,9495,1129690,1129770,42
9316,219,9497,1418471,1418690,42
8533,105,9517,1245593,1245698,42
1584,294,9519,1455599,1455893,42
4563,218,9522,1418471,1418689,42
7640,189,9557,1379518,1379707,42
7037,172,9579,1354569,1354741,42
4790,89,9589,1193743,1193832,42
8064,205,9593,1400685,1400890,42
4421,299,9612,1455511,1455810,42
4341,100,9614,1193755,1193855,42
7758,257,9652,1433002,1433259,42
7427,101,9665,1245569,1245670,42
2582,90,9666,1193751,1193841,42
8909,87,9668,1193755,1193842,42
1476,204,9675,1400657,1400861,42
7738,234,9675,1418365,1418599,42
2995,217,9678,1400685,1400902,42
3114,4,9684,229069,229073,42
8001,98,9688,1193786,1193884,42
7947,35,9694,799819,799854,42
7650,70,9698,1129768,1129838,42
3948,135,9699,1288864,1288999,42
4166,221,9714,1418343,1418564,42
2142,1,9717,229085,229086,42
4422,252,9734,1432937,1433189,42
7750,221,9734,1418350,1418571,42
3047,36,9741,799837,799873,42
5389,264,9764,1432919,1433183,42
8931,48,9773,939212,939260,42
8544,231,9774,1418337,1418568,42
9127,62,9783,1048301,1048363,42
7130,134,9809,1288862,1288996,42
6764,266,9813,1444921,1445187,42
5024,224,9817,1418331,1418555,42
5698,84,9824,1129778,1129862,42
2186,1,9825,229077,229078,42
1356,217,9829,1400710,1400927,42
3383,188,9832,1379552,1379740,42
3097,166,9862,1354604,1354770,42
8038,282,9865,1444871,1445153,42
6252,203,9868,1400715,1400918,42
8664,69,9878,1048339,1048408,42
9774,109,9880,1245644,1245753,42
7718,57,9888,1048357,1048414,42
4436,111,9901,1245632,1245743,42
7188,240,9902,1418276,1418516,42
4142,86,9923,1193837,1193923,42
5998,71,9930,1129822,1129893,42
3058,213,9934,1400679,1400892,42
6939,148,9954,1324738,1324886,42
5281,184,9964,1379518,1379702,42
1285,169,9967,1354611,1354780,42
5149,231,9983,1418218,1418449,42
7288,167,9999,1354614,1354781,42
972,187,271,1410395,1410582,43
451,111,314,1298652,1298763,43
856,195,441,1410230,1410425,43
509,88,478,1203432,1203520,43
450,267,554,1454216,1454483,43
791,168,622,1388963,1389131,43
246,27,782,642188,642215,43
575,145,795,1363918,1364063,43
3834,109,8004,1291033,1291142,43
7747,12,8030,444401,444413,43
5052,89,8042,1195939,1196028,43
4168,41,8043,941372,941413,43
9129,37,8071,801938,801975,43
4167,91,8094,1195899,1195990,43
5009,85,8098,1195909,1195994,43
3327,24,8101,634949,634973,43
4017,7,8116,231077,231084,43
6205,196,8122,1402583,1402779,43
5703,233,8156,1434637,1434870,43
3973,74,8165,1131867,1131941,43
3027,178,8188,1381443,1381621,43
2147,257,8197,1446592,1446849,43
4637,22,8199,634908,634930,43
9696,16,8223,444320,444336,43
2105,195,8226,1402535,1402730,43
5621,288,8229,1456921,1457209,43
5607,235,8240,1434607,1434842,43
9700,203,8268,1402548,1402751,43
4730,220,8272,1420067,1420287,43
7809,103,8286,1247641,1247744,43
8042,21,8296,634876,634897,43
9374,94,8308,1247630,1247724,43
5819,66,8313,1131856,1131922,43
6318,284,8345,1456821,1457105,43
7421,133,8377,1326684,1326817,43
1194,199,8380,1402499,1402698,43
7083,167,8393,1381414,1381581,43
1441,209,8410,1419968,1420177,43
7333,60,8410,1050359,1050419,43
2144,131,8437,1326686,1326817,43
6734,139,8439,1326690,1326829,43
7841,103,8454,1247598,1247701,43
3724,169,8467,1381365,1381534,43
4850,125,8474,1290853,1290978,43
6762,88,8489,1195841,1195929,43
2287,211,8497,1419887,1420098,43
3607,87,8507,1195849,1195936,43
6542,300,8518,1465222,1465522,43
3925,288,8526,1456677,1456965,43
3719,118,8544,1290851,1290969,43
2104,226,8553,1434373,1434599,43
3035,54,8562,1050373,1050427,43
9255,244,8574,1434353,1434597,43
7941,27,8583,634813,634840,43
8988,147,8591,1356485,1356632,43
4936,185,8596,1402426,1402611,43
7948,227,8610,1434336,1434563,43
1990,21,8621,634815,634836,43
6856,295,8621,1456598,1456893,43
6843,210,8627,1419897,1420107,43
9520,220,8641,1419890,1420110,43
3960,271,8648,1446270,1446541,43
7546,187,8660,1402470,1402657,43
3450,257,8669,1446272,1446529,43
9872,151,8675,1356557,1356708,43
3326,138,8695,1326736,1326874,43
5330,43,8716,941254,941297,43
6399,197,8721,1402435,1402632,43
3666,255,8722,1446228,1446483,43
3626,65,8733,1131873,1131938,43
4577,224,8740,1419874,1420098,43
4146,243,8749,1434291,1434534,43
3851,216,8754,1419903,1420119,43
2385,162,8761,1356574,1356736,43
7349,199,8768,1402487,1402686,43
7377,183,8785,1402487,1402670,43
8552,136,8802,1326786,1326922,43
9244,104,8811,1247700,1247804,43
4031,236,8838,1434220,1434456,43
8233,299,8860,1464883,1465182,43
1333,11,8874,444181,444192,43
8550,97,8884,1247671,1247768,43
4760,46,8886,941257,941303,43
7610,175,8887,1381392,1381567,43
3246,241,8898,1434194,1434435,43
5528,131,8901,1326770,1326901,43
5360,96,8904,1247704,1247800,43
9853,173,8906,1381406,1381579,43
4552,291,8909,1456358,1456649,43
4275,30,8915,801852,801882,43
8775,218,8916,1419842,1420060,43
3664,108,8919,1247741,1247849,43
6080,89,8927,1195994,1196083,43
2646,274,8943,1456343,1456617,43
3712,24,8955,634835,634859,43
5234,3,8970,230854,230857,43
7025,282,8982,1456306,1456588,43
8633,234,8986,1434191,1434425,43
5673,170,8987,1381436,1381606,43
8944,80,8988,1196005,1196085,43
5119,181,8996,1381435,1381616,43
1945,232,8997,1434189,1434421,43
7964,164,9005,1381465,1381629,43
5010,187,9006,1402456,1402643,43
5309,24,9023,634854,634878,43
9060,10,9023,444242,444252,43
5883,118,9048,1291003,1291121,43
6641,278,9061,1456237,1456515,43
7974,113,9085,1290993,1291106,43
1474,200,9090,1402398,1402598,43
5497,296,9093,1456211,1456507,43
8774,299,9096,1464649,1464948,43
4005,15,9097,444224,444239,43
7725,173,9107,1381465,1381638,43
5712,23,9108,634846,634869,43
2060,227,9117,1434145,1434372,43
2442,121,9125,1291043,1291164,43
2902,260,9130,1445995,1446255,43
9957,219,9140,1419831,1420050,43
3427,264,9147,1445990,1446254,43
1170,173,9164,1381499,1381672,43
9306,115,9183,1291066,1291181,43
1320,213,9185,1419824,1420037,43
9301,99,9185,1247859,1247958,43
6916,140,9198,1326875,1327015,43
1209,130,9213,1326875,1327005,43
4815,116,9218,1291089,1291205,43
7530,71,9221,1132059,1132130,43
3813,1,9235,230848,230849,43
3858,102,9236,1247863,1247965,43
7695,199,9261,1402392,1402591,43
2172,120,9267,1291065,1291185,43
1791,266,9287,1445866,1446132,43
5185,10,9299,444200,444210,43
8677,98,9309,1247848,1247946,43
2462,164,9313,1381421,1381585,43
3155,188,9390,1402301,1402489,43
8403,192,9390,1402307,1402499,43
7845,261,9404,1445767,1446028,43
9439,65,9411,1132003,1132068,43
8567,68,9422,1131994,1132062,43
9220,231,9432,1433924,1434155,43
1219,109,9435,1291011,1291120,43
8353,95,9441,1247818,1247913,43
8994,192,9444,1402305,1402497,43
5947,108,9472,1247806,1247914,43
6146,234,9474,1433888,1434122,43
8044,285,9488,1455865,1456150,43
7015,94,9513,1247813,1247907,43
3977,278,9539,1455827,1456105,43
1644,106,9550,1247794,1247900,43
8510,150,9569,1356526,1356676,43
4451,266,9579,1445653,1445919,43
4251,265,9590,1445660,1445925,43
4196,138,9594,1326751,1326889,43
8444,147,9616,1356524,1356671,43
6271,78,9617,1196084,1196162,43
3491,218,9619,1419576,1419794,43
6889,81,9622,1196095,1196176,43
5391,129,9637,1326757,1326886,43
3231,119,9652,1290982,1291101,43
7600,281,9657,1455715,1455996,43
5482,6,9659,230689,230695,43
7084,293,9663,1455718,1456011,43
1953,110,9686,1290993,1291103,43
2272,53,9687,1050526,1050579,43
7287,262,9724,1445591,1445853,43
8645,103,9726,1247824,1247927,43
5039,292,9728,1455674,1455966,43
1098,202,9730,1402239,1402441,43
4905,128,9742,1326746,1326874,43
1873,28,9753,801809,801837,43
4473,4,9760,230666,230670,43
5872,276,9789,1455633,1455909,43
1055,117,9836,1290930,1291047,43
9295,23,9849,634671,634694,43
9169,103,9862,1247779,1247882,43
3684,205,9865,1419455,1419660,43
9329,217,9875,1419447,1419664,43
6741,69,9885,1131998,1132067,43
9196,52,9886,1050473,1050525,43
5691,28,9893,801747,801775,43
9950,29,9900,801741,801770,43
3242,74,9914,1131975,1132049,43
6068,45,9940,941243,941288,43
6694,281,9954,1455472,1455753,43
5892,109,9965,1290861,1290970,43
3143,140,9975,1326588,1326728,43
5444,73,9977,1131965,1132038,43
2493,280,9982,1455453,1455733,43
5118,222,9988,1419392,1419614,43
7263,26,9990,634686,634712,43
7916,217,9991,1419408,1419625,43
3167,142,9992,1326640,1326782,43
1104,19,9998,634707,634726,43
899,191,58,1429369,1429560,44
454,205,88,1429341,1429546,44
382,151,149,1391097,1391248,44
796,46,177,1060342,1060388,44
265,284,201,1473564,1473848,44
923,298,218,1473552,1473850,44
563,70,231,1141848,1141918,44
281,110,240,1300761,1300871,44
694,288,294,1473495,1473783,44
518,286,346,1473452,1473738,44
135,135,354,1366174,1366309,44
572,19,375,644433,644452,44
826,10,377,453752,453762,44
151,251,395,1455138,1455389,44
802,277,408,1465148,1465425,44
105,7,409,240302,240309,44
605,38,562,950871,950909,44
851,53,611,1060017,1060070,44
584,98,667,1257302,1257400,44
195,101,669,1300423,1300524,44
440,187,734,1411575,1411762,44
257,137,745,1365840,1365977,44
229,8,773,453423,453431,44
4917,20,8008,636876,636896,44
1648,36,8019,943473,943509,44
5844,158,8025,1383355,1383513,44
7486,293,8026,1465779,1466072,44
1670,297,8028,1465791,1466088,44
9656,148,8080,1358564,1358712,44
8509,159,8081,1383345,1383504,44
7068,11,8105,446148,446159,44
8309,257,8126,1457500,1457757,44
6504,182,8148,1404239,1404421,44
1264,197,8156,1421478,1421675,44
9535,3,8178,232666,232669,44
6562,222,8181,1435656,1435878,44
4809,266,8195,1457433,1457699,44
4509,163,8200,1383330,1383493,44
4572,186,8208,1404252,1404438,44
8476,54,8211,1052617,1052671,44
7585,235,8216,1447451,1447686,44
4884,93,8228,1249995,1250088,44
1897,207,8238,1421467,1421674,44
9786,116,8257,1328844,1328960,44
7536,114,8267,1293099,1293213,44
4819,244,8269,1447401,1447645,44
6137,143,8274,1358584,1358727,44
4357,140,8282,1358587,1358727,44
9173,68,8288,1134194,1134262,44
6009,86,8296,1250026,1250112,44
6011,162,8297,1383322,1383484,44
7870,246,8301,1447381,1447627,44
1425,186,8304,1404253,1404439,44
8634,242,8304,1447392,1447634,44
1166,132,8313,1328908,1329040,44
1939,87,8318,1250081,1250168,44
8936,181,8328,1404266,1404447,44
8306,159,8338,1383369,1383528,44
3600,251,8360,1447346,1447597,44
9715,236,8367,1447358,1447594,44
1872,34,8368,803918,803952,44
6798,179,8375,1404271,1404450,44
2335,256,8417,1457222,1457478,44
8149,76,8427,1198303,1198379,44
9959,110,8427,1293178,1293288,44
1823,296,8434,1465403,1465699,44
1449,181,8435,1404261,1404442,44
3559,255,8439,1447336,1447591,44
1748,110,8442,1293222,1293332,44
4893,230,8468,1435601,1435831,44
7415,144,8481,1358648,1358792,44
1859,107,8495,1293212,1293319,44
4796,196,8505,1421407,1421603,44
7492,44,8509,943480,943524,44
3331,176,8541,1404227,1404403,44
6328,254,8544,1447254,1447508,44
4193,84,8576,1198314,1198398,44
6951,256,8577,1457087,1457343,44
8000,61,8579,1134265,1134326,44
2078,255,8584,1447259,1447514,44
3456,127,8615,1328895,1329022,44
1310,119,8616,1328906,1329025,44
3477,49,8621,1052696,1052745,44
3220,68,8641,1134246,1134314,44
9112,123,8646,1328880,1329003,44
5104,43,8672,943448,943491,44
9827,256,8696,1456969,1457225,44
4770,60,8699,1134225,1134285,44
5485,63,8722,1134205,1134268,44
5617,195,8722,1421281,1421476,44
2162,211,8729,1435448,1435659,44
8455,76,8746,1198270,1198346,44
1747,41,8747,943448,943489,44
7067,146,8750,1358535,1358681,44
9690,168,8759,1383261,1383429,44
6275,50,8779,1052662,1052712,44
1510,208,8804,1421226,1421434,44
1912,161,8808,1383249,1383410,44
4449,182,8827,1404088,1404270,44
7998,24,8839,636707,636731,44
5390,179,8841,1404087,1404266,44
4912,182,8845,1404093,1404275,44
1600,15,8854,445963,445978,44
8094,86,8861,1250021,1250107,44
9796,144,8876,1358531,1358675,44
9233,254,8906,1446983,1447237,44
4795,279,8940,1456726,1457005,44
6107,52,8943,1052611,1052663,44
3749,46,8960,1052601,1052647,44
2992,149,8998,1358457,1358606,44
2126,142,9013,1358459,1358601,44
2829,128,9020,1328769,1328897,44
8389,181,9020,1403971,1404152,44
8971,170,9038,1403965,1404135,44
9530,178,9048,1403956,1404134,44
3187,71,9061,1198199,1198270,44
4609,51,9072,1052574,1052625,44
7982,91,9085,1249934,1250025,44
4934,54,9092,1052572,1052626,44
3019,69,9141,1134078,1134147,44
4068,29,9141,803725,803754,44
8468,167,9142,1383078,1383245,44
8771,210,9174,1420917,1421127,44
8571,72,9182,1198121,1198193,44
2817,106,9185,1292994,1293100,44
3883,300,9208,1464646,1464946,44
4143,105,9208,1292994,1293099,44
2724,126,9212,1328692,1328818,44
6366,19,9229,636569,636588,44
1547,126,9230,1328685,1328811,44
7962,117,9230,1328696,1328813,44
5852,2,9268,232251,232253,44
5302,139,9272,1358318,1358457,44
9300,277,9276,1456438,1456715,44
1435,175,9280,1403793,1403968,44
6155,149,9281,1358352,1358501,44
1297,191,9293,1420861,1421052,44
7815,215,9297,1434969,1435184,44
1906,201,9299,1420878,1421079,44
2952,14,9324,445781,445795,44
9784,279,9326,1456410,1456689,44
7791,261,9338,1456422,1456683,44
8792,46,9352,1052549,1052595,44
1127,298,9360,1464515,1464813,44
5995,252,9362,1446687,1446939,44
1312,164,9363,1383083,1383247,44
1738,178,9367,1403852,1404030,44
4997,206,9373,1420900,1421106,44
3751,211,9384,1434975,1435186,44
8951,37,9385,943367,943404,44
8454,123,9387,1328796,1328919,44
7235,174,9411,1403857,1404031,44
8807,214,9421,1434939,1435153,44
5049,51,9427,1052583,1052634,44
1568,295,9434,1464460,1464755,44
7482,280,9438,1464472,1464752,44
6204,223,9470,1434938,1435161,44
4383,158,9483,1383129,1383287,44
4802,96,9487,1249989,1250085,44
3255,255,9492,1446623,1446878,44
5204,110,9505,1293119,1293229,44
7385,231,9506,1434937,1435168,44
7617,37,9512,943375,943412,44
1444,75,9530,1198223,1198298,44
4716,79,9547,1198211,1198290,44
1093,95,9554,1249979,1250074,44
1456,121,9565,1328762,1328883,44
5170,75,9565,1198230,1198305,44
6216,109,9575,1293092,1293201,44
3009,109,9590,1293087,1293196,44
7709,169,9624,1383034,1383203,44
4282,102,9640,1293063,1293165,44
6938,87,9676,1249943,1250030,44
1951,206,9679,1420758,1420964,44
3359,87,9698,1249939,1250026,44
4434,159,9699,1382997,1383156,44
7054,160,9701,1383004,1383164,44
6277,106,9722,1293032,1293138,44
6787,176,9725,1403688,1403864,44
1771,139,9740,1358342,1358481,44
2912,298,9766,1464145,1464443,44
3589,277,9769,1456093,1456370,44
9727,142,9770,1358355,1358497,44
5737,285,9787,1464143,1464428,44
5275,274,9790,1456118,1456392,44
2501,37,9792,943340,943377,44
8441,25,9798,803693,803718,44
4515,24,9809,636497,636521,44
1483,197,9816,1420722,1420919,44
1142,100,9832,1293057,1293157,44
7940,295,9854,1464082,1464377,44
2868,98,9864,1249971,1250069,44
8612,222,9874,1434700,1434922,44
9794,88,9878,1249986,1250074,44
8451,43,9908,943293,943336,44
4612,7,9985,231977,231984,44
3474,230,9992,1434594,1434824,44
456,271,65,1473905,1474176,45
424,148,85,1392831,1392979,45
866,71,107,1208062,1208133,45
413,211,207,1444435,1444646,45
836,73,223,1207967,1208040,45
395,94,400,1302592,1302686,45
846,230,452,1455839,1456069,45
285,115,454,1338208,1338323,45
850,107,469,1338203,1338310,45
353,99,475,1302566,1302665,45
664,69,481,1207784,1207853,45
157,193,490,1430193,1430386,45
414,196,532,1444147,1444343,45
400,60,632,1143593,1143653,45
174,292,636,1479827,1480119,45
458,143,716,1392300,1392443,45
323,47,721,1061920,1061967,45
286,104,774,1302336,1302440,45
164,97,839,1302285,1302382,45
280,196,844,1443857,1444053,45
778,53,853,1143441,1143494,45
120,133,882,1367525,1367658,45
515,220,985,1455342,1455562,45
443,274,988,1473016,1473290,45
3470,157,8006,1405758,1405915,45
9480,238,8006,1448347,1448585,45
6639,195,8008,1422813,1423008,45
2340,245,8021,1458016,1458261,45
6270,22,8040,805787,805809,45
2422,242,8041,1458003,1458245,45
7746,191,8046,1422835,1423026,45
3478,177,8060,1422837,1423014,45
9877,2,8074,234094,234096,45
8133,106,8085,1330829,1330935,45
9022,227,8098,1448321,1448548,45
9819,18,8110,638551,638569,45
8319,89,8153,1252116,1252205,45
7429,71,8162,1200369,1200440,45
5457,300,8170,1472300,1472600,45
2035,74,8173,1200379,1200453,45
4336,170,8174,1405743,1405913,45
8331,297,8190,1472295,1472592,45
9133,31,8196,945419,945450,45
6533,164,8203,1405747,1405911,45
2660,116,8207,1330788,1330904,45
8221,43,8209,1054703,1054746,45
1204,149,8230,1385061,1385210,45
6691,173,8234,1405724,1405897,45
4116,225,8240,1448234,1448459,45
8760,9,8255,447642,447651,45
5832,61,8262,1136310,1136371,45
8172,55,8283,1136299,1136354,45
5060,51,8286,1054684,1054735,45
6693,217,8297,1448186,1448403,45
9837,78,8313,1252095,1252173,45
8569,148,8319,1385037,1385185,45
3206,28,8322,805722,805750,45
3564,261,8332,1457762,1458023,45
7537,51,8336,1054689,1054740,45
7874,9,8354,447609,447618,45
8492,129,8357,1360402,1360531,45
5145,282,8359,1465706,1465988,45
4502,251,8376,1457764,1458015,45
5671,59,8389,1136281,1136340,45
3506,293,8420,1472077,1472370,45
7866,279,8421,1465689,1465968,45
1244,185,8423,1422676,1422861,45
1384,83,8425,1252097,1252180,45
2896,105,8437,1295144,1295249,45
3964,148,8448,1385026,1385174,45
7008,60,8451,1136299,1136359,45
5642,96,8491,1295120,1295216,45
3381,168,8495,1405632,1405800,45
1842,209,8519,1436498,1436707,45
8480,189,8571,1422558,1422747,45
2438,256,8587,1457612,1457868,45
7593,257,8607,1457610,1457867,45
8374,204,8624,1436449,1436653,45
1624,14,8632,638354,638368,45
4886,95,8636,1295071,1295166,45
7061,292,8636,1471869,1472161,45
6626,3,8665,233793,233796,45
8409,264,8671,1465481,1465745,45
5939,111,8680,1330662,1330773,45
2377,268,8683,1465472,1465740,45
9185,255,8697,1457608,1457863,45
6544,10,8732,447409,447419,45
8288,4,8739,233752,233756,45
3847,156,8749,1384915,1385071,45
7181,204,8791,1436375,1436579,45
8844,246,8796,1457526,1457772,45
4904,98,8805,1295027,1295125,45
8082,292,8820,1471692,1471984,45
2132,41,8822,1054533,1054574,45
3384,98,8822,1295033,1295131,45
2115,34,8823,945243,945277,45
9538,242,8835,1457518,1457760,45
1777,166,8845,1405541,1405707,45
2224,33,8888,945202,945235,45
3198,138,8908,1360233,1360371,45
3829,212,8910,1436328,1436540,45
3764,205,8917,1436338,1436543,45
5379,88,8932,1251961,1252049,45
2140,127,8943,1360249,1360376,45
3024,222,8943,1447849,1448071,45
6514,3,8946,233651,233654,45
6513,246,8949,1457408,1457654,45
1782,32,8954,945209,945241,45
2146,249,8954,1457411,1457660,45
9124,90,8962,1251999,1252089,45
9165,280,8974,1465212,1465492,45
3825,292,8977,1471542,1471834,45
7045,289,8978,1471548,1471837,45
1391,125,8983,1360317,1360442,45
5386,220,8989,1447919,1448139,45
2745,216,9017,1436395,1436611,45
1012,264,9034,1465219,1465483,45
5335,213,9038,1436416,1436629,45
1751,5,9052,233620,233625,45
9462,268,9064,1465192,1465460,45
8347,65,9071,1200259,1200324,45
9598,62,9072,1136167,1136229,45
4645,20,9074,638217,638237,45
6412,229,9084,1447872,1448101,45
3293,144,9091,1384933,1385077,45
4087,171,9094,1405568,1405739,45
6726,244,9097,1457394,1457638,45
5092,249,9117,1457380,1457629,45
3998,157,9122,1405593,1405750,45
4798,78,9153,1252032,1252110,45
2328,165,9162,1405554,1405719,45
5283,38,9163,945212,945250,45
1102,271,9199,1465064,1465335,45
8344,184,9204,1422499,1422683,45
2937,252,9215,1457316,1457568,45
7006,188,9217,1422515,1422703,45
9299,36,9229,945194,945230,45
4334,295,9236,1471294,1471589,45
6202,2,9236,233555,233557,45
9581,133,9237,1360356,1360489,45
1662,45,9240,1054523,1054568,45
4787,174,9250,1405570,1405744,45
3382,144,9259,1384969,1385113,45
5082,276,9281,1465016,1465292,45
3366,86,9282,1252045,1252131,45
3481,16,9287,638179,638195,45
2384,125,9290,1360366,1360491,45
8358,29,9321,805450,805479,45
3618,262,9346,1464966,1465228,45
8656,257,9354,1457260,1457517,45
6499,280,9355,1464958,1465238,45
5099,64,9356,1200262,1200326,45
1009,30,9383,805432,805462,45
3489,160,9397,1405517,1405677,45
4585,223,9402,1447765,1447988,45
2137,227,9456,1447718,1447945,45
3927,297,9480,1471060,1471357,45
8826,204,9480,1436286,1436490,45
5896,224,9482,1447725,1447949,45
6521,80,9509,1251968,1252048,45
7158,245,9510,1457169,1457414,45
9083,224,9515,1447722,1447946,45
6097,29,9532,805373,805402,45
7113,178,9539,1422446,1422624,45
7539,288,9547,1471005,1471293,45
2447,258,9558,1457151,1457409,45
3031,204,9580,1436300,1436504,45
6509,295,9599,1470956,1471251,45
2836,17,9619,638026,638043,45
4404,5,9636,233337,233342,45
7680,175,9638,1405508,1405683,45
5354,107,9639,1330637,1330744,45
8287,300,9651,1470914,1471214,45
6660,228,9653,1447680,1447908,45
4992,137,9654,1360329,1360466,45
2238,277,9655,1464773,1465050,45
9662,204,9667,1436306,1436510,45
6457,101,9674,1295059,1295160,45
6362,129,9686,1360347,1360476,45
2701,207,9689,1436293,1436500,45
2113,226,9707,1447660,1447886,45
7673,135,9712,1360363,1360498,45
2510,211,9715,1436300,1436511,45
1576,66,9730,1200240,1200306,45
6912,27,9742,805342,805369,45
1003,240,9743,1457055,1457295,45
2746,34,9749,945090,945124,45
9807,139,9756,1384946,1385085,45
2645,16,9760,638033,638049,45
7618,97,9769,1295080,1295177,45
6313,287,9773,1470807,1471094,45
4556,161,9775,1405561,1405722,45
3981,275,9795,1464673,1464948,45
8522,183,9822,1422446,1422629,45
3480,134,9839,1360369,1360503,45
2242,271,9848,1464634,1464905,45
5694,193,9854,1422442,1422635,45
1280,196,9862,1436253,1436449,45
8210,195,9872,1422462,1422657,45
9737,175,9872,1405583,1405758,45
7111,237,9874,1447591,1447828,45
2718,2,9876,233288,233290,45
2161,105,9890,1295131,1295236,45
8736,224,9894,1447592,1447816,45
2408,24,9903,805340,805364,45
3294,157,9931,1405581,1405738,45
4511,20,9941,637983,638003,45
1095,151,9960,1384959,1385110,45
6471,51,9967,1054406,1054457,45
9710,4,9973,233235,233239,45
9925,36,9976,945047,945083,45
4701,256,9979,1456890,1457146,45
2685,149,9995,1384955,1385104,45
1856,25,9996,805304,805329,45
985,170,58,1432370,1432540,46
489,49,62,1146057,1146106,46
398,228,108,1466796,1467024,46
422,75,139,1261936,1262011,46
947,135,142,1394865,1395000,46
595,150,154,1415427,1415577,46
304,227,188,1466723,1466950,46
203,284,200,1480401,1480685,46
351,134,263,1394804,1394938,46
832,85,314,1304904,1304989,46
495,207,354,1457241,1457448,46
557,236,436,1466503,1466739,46
865,203,550,1457073,1457276,46
459,4,616,242685,242689,46
356,47,683,1145561,1145608,46
583,255,751,1473782,1474037,46
955,104,795,1340106,1340210,46
363,283,816,1479803,1480086,46
951,178,952,1431637,1431815,46
5539,157,8009,1407723,1407880,46
5324,48,8018,1138283,1138331,46
6635,120,8027,1362616,1362736,46
9469,149,8044,1407702,1407851,46
4105,290,8052,1472584,1472874,46
7913,115,8063,1362622,1362737,46
7149,104,8064,1332951,1333055,46
2744,8,8066,449070,449078,46
9278,286,8069,1472591,1472877,46
3595,132,8091,1387154,1387286,46
3069,290,8125,1472555,1472845,46
5228,255,8127,1466510,1466765,46
4207,254,8129,1466520,1466774,46
7414,142,8143,1387159,1387301,46
5236,57,8157,1202419,1202476,46
8555,290,8157,1472547,1472837,46
3614,18,8160,640052,640070,46
4646,203,8170,1449624,1449827,46
7293,19,8170,807409,807428,46
9677,196,8183,1438311,1438507,46
2953,163,8212,1424546,1424709,46
2951,87,8213,1297331,1297418,46
9878,289,8221,1472507,1472796,46
3549,8,8254,448975,448983,46
4206,176,8263,1424516,1424692,46
3111,215,8269,1449549,1449764,46
8839,141,8279,1387158,1387299,46
9158,27,8295,947127,947154,46
3479,156,8325,1407643,1407799,46
7945,96,8329,1332920,1333016,46
2932,210,8349,1449484,1449694,46
1621,285,8357,1472394,1472679,46
3089,257,8359,1466370,1466627,46
9167,62,8359,1202386,1202448,46
9874,61,8370,1202381,1202442,46
8183,261,8386,1466357,1466618,46
6196,87,8397,1297293,1297380,46
9055,64,8401,1202379,1202443,46
3941,123,8413,1362581,1362704,46
6887,102,8460,1332865,1332967,46
3056,245,8477,1466284,1466529,46
8326,12,8488,639892,639904,46
3662,82,8494,1297244,1297326,46
6013,29,8501,947048,947077,46
4176,184,8510,1438140,1438324,46
8155,91,8515,1297238,1297329,46
6295,178,8561,1424366,1424544,46
9592,230,8562,1458678,1458908,46
9425,104,8565,1332827,1332931,46
1911,96,8574,1332827,1332923,46
7620,179,8577,1424386,1424565,46
1781,33,8614,947001,947034,46
6001,8,8615,448785,448793,46
4906,155,8618,1407525,1407680,46
3608,284,8622,1472148,1472432,46
6245,238,8622,1458649,1458887,46
9005,270,8623,1472165,1472435,46
5849,71,8628,1254182,1254253,46
1835,209,8636,1449375,1449584,46
3831,114,8658,1362509,1362623,46
4398,141,8677,1387030,1387171,46
9908,230,8692,1458618,1458848,46
8815,37,8704,1056417,1056454,46
6696,250,8706,1466103,1466353,46
4252,157,8708,1407555,1407712,46
8810,31,8736,946994,947025,46
3735,53,8741,1138146,1138199,46
2303,212,8744,1449318,1449530,46
3933,221,8745,1449329,1449550,46
1174,161,8755,1407558,1407719,46
9745,244,8764,1466052,1466296,46
4327,112,8778,1362521,1362633,46
9771,39,8784,1056419,1056458,46
3989,40,8798,1056409,1056449,46
9998,25,8822,807174,807199,46
4684,215,8831,1449285,1449500,46
4229,147,8837,1407530,1407677,46
7555,150,8863,1407508,1407658,46
1691,10,8877,448676,448686,46
2133,37,8882,1056360,1056397,46
5845,4,8887,234843,234847,46
6701,156,8908,1407470,1407626,46
9380,109,8916,1332786,1332895,46
9992,23,8925,807126,807149,46
2915,104,8942,1332774,1332878,46
6515,132,8943,1386966,1387098,46
7598,247,8943,1465874,1466121,46
1646,263,8951,1465870,1466133,46
3115,149,8958,1407469,1407618,46
7057,1,8964,234810,234811,46
5255,32,8965,946941,946973,46
7239,223,8966,1458441,1458664,46
6057,192,8971,1437963,1438155,46
4417,210,8975,1449219,1449429,46
8327,171,8976,1424290,1424461,46
4138,7,8988,448654,448661,46
3529,127,8998,1387036,1387163,46
8316,35,9022,946935,946970,46
5304,206,9023,1449181,1449387,46
2427,73,9083,1254081,1254154,46
3644,45,9100,1056284,1056329,46
8266,141,9103,1386949,1387090,46
9919,274,9112,1471680,1471954,46
7402,287,9123,1471677,1471964,46
9095,88,9126,1297183,1297271,46
7713,295,9149,1475962,1476257,46
5454,127,9166,1386952,1387079,46
3104,69,9182,1254065,1254134,46
7306,178,9184,1424168,1424346,46
1184,289,9185,1471660,1471949,46
7743,191,9209,1437857,1438048,46
3484,193,9216,1437861,1438054,46
8020,161,9219,1407430,1407591,46
6958,195,9223,1437867,1438062,46
6246,27,9257,946853,946880,46
2300,222,9263,1458234,1458456,46
6469,122,9263,1362454,1362576,46
7212,62,9271,1202225,1202287,46
6630,28,9283,946855,946883,46
1304,105,9291,1332779,1332884,46
8679,156,9309,1407394,1407550,46
4629,12,9314,639585,639597,46
4908,251,9317,1465616,1465867,46
3377,69,9365,1254026,1254095,46
3576,6,9367,448445,448451,46
7552,274,9396,1471472,1471746,46
5875,29,9415,946770,946799,46
8238,233,9418,1458124,1458357,46
1758,176,9435,1424086,1424262,46
3504,99,9454,1332701,1332800,46
6964,146,9498,1407290,1407436,46
8744,132,9503,1386837,1386969,46
2628,146,9507,1407284,1407430,46
2097,137,9513,1386850,1386987,46
4345,292,9527,1475589,1475881,46
1045,124,9528,1362361,1362485,46
1153,253,9528,1465459,1465712,46
5695,71,9528,1254007,1254078,46
2759,70,9535,1254003,1254073,46
1316,48,9536,1137964,1138012,46
7022,137,9583,1386825,1386962,46
3785,293,9600,1475518,1475811,46
4919,116,9607,1362344,1362460,46
7386,78,9613,1253966,1254044,46
1472,53,9631,1137916,1137969,46
8530,288,9657,1471267,1471555,46
4291,25,9659,806861,806886,46
2155,134,9663,1386790,1386924,46
8911,164,9664,1423948,1424112,46
3033,97,9686,1332668,1332765,46
8435,189,9695,1437570,1437759,46
1216,17,9697,639399,639416,46
7356,290,9702,1471244,1471534,46
8335,102,9704,1332682,1332784,46
1827,300,9711,1475410,1475710,46
1112,215,9719,1448785,1449000,46
1132,2,9728,234377,234379,46
5140,52,9730,1137924,1137976,46
1799,296,9764,1475367,1475663,46
4595,100,9776,1332662,1332762,46
9252,232,9778,1457930,1458162,46
2798,284,9808,1471210,1471494,46
9308,140,9823,1386774,1386914,46
6324,88,9851,1297039,1297127,46
7479,149,9856,1407154,1407303,46
3884,217,9859,1448723,1448940,46
3904,21,9860,806803,806824,46
8139,206,9870,1448729,1448935,46
1499,293,9872,1475265,1475558,46
4111,244,9885,1465273,1465517,46
5305,70,9897,1253952,1254022,46
7893,270,9920,1471140,1471410,46
2860,186,9942,1437552,1437738,46
9708,59,9953,1202077,1202136,46
682,91,116,1342487,1342578,47
941,191,123,1458561,1458752,47
385,11,139,649124,649135,47
253,251,143,1480940,1481191,47
204,51,194,1211879,1211930,47
212,227,215,1475007,1475234,47
854,5,250,457882,457887,47
603,63,265,1263668,1263731,47
601,149,270,1433660,1433809,47
384,108,352,1371964,1372072,47
982,119,366,1396440,1396559,47
474,69,375,1263597,1263666,47
553,145,407,1416798,1416943,47
473,144,409,1416811,1416955,47
576,282,624,1484536,1484818,47
131,142,645,1416606,1416748,47
619,113,714,1371686,1371799,47
338,71,764,1263277,1263348,47
946,273,827,1484345,1484618,47
773,100,840,1371589,1371689,47
759,119,857,1396034,1396153,47
1052,141,8005,1409275,1409416,47
9202,141,8011,1409280,1409421,47
2273,65,8021,1256091,1256156,47
4901,181,8029,1439581,1439762,47
8277,208,8035,1459873,1460081,47
3523,248,8054,1473079,1473327,47
9678,273,8067,1477108,1477381,47
3321,72,8109,1256056,1256128,47
2358,132,8125,1409245,1409377,47
6150,250,8153,1473004,1473254,47
4073,101,8172,1364393,1364494,47
4091,115,8185,1388839,1388954,47
8434,102,8253,1364329,1364431,47
9433,98,8259,1334700,1334798,47
4722,271,8260,1476918,1477189,47
1734,269,8271,1472912,1473181,47
1993,113,8281,1364334,1364447,47
3802,281,8288,1476891,1477172,47
4324,129,8296,1388777,1388906,47
1573,220,8319,1459719,1459939,47
4757,251,8323,1472905,1473156,47
2717,227,8325,1467097,1467324,47
3935,165,8329,1425837,1426002,47
7126,184,8348,1439468,1439652,47
2437,17,8363,808663,808680,47
1566,95,8396,1334716,1334811,47
7504,46,8428,1139844,1139890,47
4149,270,8431,1472801,1473071,47
8799,142,8434,1409108,1409250,47
1531,52,8455,1204082,1204134,47
1077,188,8483,1450508,1450696,47
4015,254,8496,1472759,1473013,47
6114,1,8509,235895,235896,47
1550,292,8522,1476668,1476960,47
7507,240,8530,1466960,1467200,47
2587,7,8531,449842,449849,47
4674,213,8534,1459646,1459859,47
6418,269,8541,1472744,1473013,47
4332,78,8546,1299056,1299134,47
7629,184,8565,1439403,1439587,47
6534,191,8567,1450528,1450719,47
5289,109,8568,1364316,1364425,47
1854,20,8569,808564,808584,47
5293,52,8575,1204075,1204127,47
5559,83,8579,1299068,1299151,47
2774,46,8609,1139820,1139866,47
5665,198,8611,1450491,1450689,47
5628,176,8616,1439409,1439585,47
8683,16,8626,808547,808563,47
3991,27,8631,948452,948479,47
1647,55,8638,1204048,1204103,47
1478,35,8672,1057943,1057978,47
5669,59,8686,1204006,1204065,47
3949,244,8689,1466838,1467082,47
6334,113,8694,1364245,1364358,47
7178,159,8698,1425720,1425879,47
8029,228,8708,1466838,1467066,47
6654,78,8752,1298984,1299062,47
9716,116,8789,1388619,1388735,47
3129,130,8796,1388614,1388744,47
6730,37,8808,1057884,1057921,47
6015,256,8822,1472485,1472741,47
8204,220,8846,1459427,1459647,47
9292,66,8857,1255812,1255878,47
2508,126,8882,1388576,1388702,47
9142,243,8897,1466674,1466917,47
2301,104,8900,1364173,1364277,47
1350,259,8902,1472414,1472673,47
9593,221,8925,1459406,1459627,47
1965,266,8936,1472392,1472658,47
7995,164,8936,1425620,1425784,47
4840,173,8937,1439251,1439424,47
5549,102,8953,1364200,1364302,47
4140,144,8970,1408941,1409085,47
4456,223,8971,1459398,1459621,47
7344,18,8972,808384,808402,47
3807,263,8996,1472351,1472614,47
4915,57,8997,1203947,1204004,47
2564,158,9021,1425606,1425764,47
3527,245,9028,1466627,1466872,47
8678,108,9028,1364203,1364311,47
6523,269,9041,1472322,1472591,47
2027,177,9068,1439204,1439381,47
8629,153,9071,1425621,1425774,47
8852,253,9080,1472305,1472558,47
1004,231,9111,1466608,1466839,47
7173,27,9162,948206,948233,47
2175,213,9167,1459326,1459539,47
1825,271,9169,1476043,1476314,47
6348,177,9180,1439180,1439357,47
3055,114,9191,1364169,1364283,47
6737,163,9196,1425592,1425755,47
7367,95,9198,1334568,1334663,47
5912,76,9202,1298930,1299006,47
5212,110,9205,1364185,1364295,47
2894,96,9236,1334554,1334650,47
7639,34,9243,1057753,1057787,47
1175,131,9247,1408899,1409030,47
6617,294,9255,1475958,1476252,47
7049,29,9257,948212,948241,47
6678,190,9283,1450173,1450363,47
4560,197,9287,1450175,1450372,47
4308,80,9306,1298908,1298988,47
2492,232,9323,1466446,1466678,47
7399,185,9340,1450155,1450340,47
8932,178,9352,1439115,1439293,47
3892,79,9360,1298901,1298980,47
1886,286,9362,1475875,1476161,47
4543,278,9389,1475864,1476142,47
9358,111,9396,1364140,1364251,47
5399,100,9400,1364148,1364248,47
9579,277,9411,1475850,1476127,47
2525,252,9413,1472093,1472345,47
9875,2,9424,235301,235303,47
9110,133,9429,1408888,1409021,47
6893,272,9444,1475824,1476096,47
7140,169,9445,1439130,1439299,47
8557,265,9445,1472089,1472354,47
2145,243,9447,1466461,1466704,47
3515,112,9450,1364204,1364316,47
4648,91,9451,1334616,1334707,47
1730,281,9467,1475803,1476084,47
3550,80,9468,1298982,1299062,47
6592,67,9469,1255842,1255909,47
3065,182,9474,1439162,1439344,47
2032,165,9476,1425616,1425781,47
6331,272,9496,1475785,1476057,47
2184,114,9510,1364217,1364331,47
6702,148,9519,1425609,1425757,47
3623,53,9524,1203945,1203998,47
8030,282,9535,1475748,1476030,47
7436,280,9571,1475724,1476004,47
9873,207,9572,1459224,1459431,47
5430,64,9574,1255840,1255904,47
8615,80,9606,1298956,1299036,47
5830,212,9624,1459175,1459387,47
5882,232,9625,1466389,1466621,47
7494,254,9633,1472011,1472265,47
3170,55,9635,1203926,1203981,47
4626,35,9635,1057725,1057760,47
8168,49,9646,1139630,1139679,47
2006,258,9648,1472003,1472261,47
4921,228,9661,1466404,1466632,47
6670,139,9690,1408919,1409058,47
5435,50,9691,1203909,1203959,47
2414,4,9695,235156,235160,47
8619,121,9695,1388575,1388696,47
1725,20,9732,808110,808130,47
8011,6,9748,449178,449184,47
5378,130,9760,1388517,1388647,47
7589,59,9763,1203860,1203919,47
9322,139,9820,1408798,1408937,47
2321,266,9830,1471832,1472098,47
8848,56,9847,1203808,1203864,47
8658,9,9855,449098,449107,47
9500,153,9858,1425433,1425586,47
7905,274,9861,1475444,1475718,47
1749,35,9889,1057593,1057628,47
3411,234,9945,1466167,1466401,47
4523,183,9950,1438931,1439114,47
6874,120,9954,1388435,1388555,47
9638,4,9956,234959,234963,47
5942,168,9963,1438936,1439104,47
6494,46,9965,1139481,1139527,47
5941,40,9986,1139467,1139507,47
1109,95,9999,1334424,1334519,47
717,87,70,1344373,1344460,48
390,223,97,1476042,1476265,48
558,234,287,1481436,1481670,48
885,197,299,1468712,1468909,48
342,228,330,1475846,1476074,48
886,45,346,1213450,1213495,48
881,254,350,1484979,1485233,48
107,155,459,1448548,1448703,48
645,41,575,1148967,1149008,48
488,179,593,1459414,1459593,48
116,87,620,1343926,1344013,48
882,113,738,1397790,1397903,48
517,63,757,1264995,1265058,48
372,76,781,1343790,1343866,48
680,236,798,1480953,1481189,48
727,275,884,1486894,1487169,48
102,77,967,1343631,1343708,48
7454,4,8014,451063,451067,48
9897,238,8032,1473749,1473987,48
9659,28,8033,1059666,1059694,48
2892,262,8056,1477300,1477562,48
2653,103,8061,1390538,1390641,48
6992,64,8061,1300943,1301007,48
9597,193,8067,1461074,1461267,48
3841,5,8068,451034,451039,48
1121,6,8074,451030,451036,48
2235,76,8093,1336559,1336635,48
2548,235,8099,1473714,1473949,48
7590,281,8105,1479675,1479956,48
1512,264,8125,1477266,1477530,48
4322,8,8128,642330,642338,48
6361,237,8134,1473730,1473967,48
9863,290,8138,1479650,1479940,48
5953,24,8159,950004,950028,48
8759,77,8162,1336556,1336633,48
4165,178,8172,1452036,1452214,48
7938,142,8191,1427498,1427640,48
9691,227,8196,1468211,1468438,48
2985,137,8204,1427511,1427648,48
6543,77,8207,1336565,1336642,48
7814,229,8224,1473671,1473900,48
2047,184,8228,1452028,1452212,48
1190,177,8231,1452041,1452218,48
1612,23,8241,949991,950014,48
4854,187,8248,1452033,1452220,48
2547,144,8251,1427536,1427680,48
4409,143,8251,1427547,1427690,48
1054,177,8276,1452024,1452201,48
7050,294,8308,1479497,1479791,48
4481,278,8335,1479491,1479769,48
6463,283,8342,1479489,1479772,48
2246,232,8368,1473594,1473826,48
5618,64,8373,1300920,1300984,48
3980,59,8401,1257725,1257784,48
4024,4,8416,450803,450807,48
9470,158,8419,1440989,1441147,48
9946,240,8424,1473542,1473782,48
7778,274,8442,1479399,1479673,48
7909,112,8442,1390518,1390630,48
8365,137,8447,1427497,1427634,48
5272,60,8451,1257737,1257797,48
6072,280,8454,1479388,1479668,48
1636,217,8465,1468130,1468347,48
7481,122,8465,1410885,1411007,48
7254,46,8468,1205821,1205867,48
9869,15,8487,809828,809843,48
5466,222,8490,1468115,1468337,48
6981,271,8499,1477044,1477315,48
6192,144,8501,1427515,1427659,48
8290,219,8512,1468129,1468348,48
2429,242,8522,1473522,1473764,48
4948,276,8530,1479319,1479595,48
4125,20,8547,949872,949892,48
6650,12,8576,642088,642100,48
5579,111,8583,1390537,1390648,48
2942,191,8611,1460936,1461127,48
6299,132,8611,1410856,1410988,48
1981,235,8631,1473449,1473684,48
5388,142,8631,1427481,1427623,48
5422,275,8631,1479221,1479496,48
2016,288,8635,1479219,1479507,48
5661,11,8649,642055,642066,48
1385,279,8671,1479198,1479477,48
3867,73,8696,1300862,1300935,48
1984,297,8708,1479167,1479464,48
6368,122,8714,1410864,1410986,48
6211,53,8726,1257690,1257743,48
2680,249,8744,1473431,1473680,48
5570,82,8764,1336478,1336560,48
6082,218,8765,1468056,1468274,48
6062,113,8771,1390523,1390636,48
8649,279,8778,1479121,1479400,48
6699,106,8801,1390519,1390625,48
2804,6,8805,450567,450573,48
6688,125,8818,1410813,1410938,48
7670,101,8821,1366128,1366229,48
1137,260,8834,1476868,1477128,48
6180,137,8842,1427415,1427552,48
2900,296,8854,1479051,1479347,48
4118,168,8857,1440919,1441087,48
6278,218,8857,1468038,1468256,48
7485,179,8869,1451915,1452094,48
9482,220,8879,1468027,1468247,48
7883,252,8881,1476854,1477106,48
5139,4,8896,450519,450523,48
3919,103,8901,1390558,1390661,48
1346,169,8909,1451924,1452093,48
7491,124,8911,1410872,1410996,48
8114,83,8916,1336554,1336637,48
6113,163,8919,1440965,1441128,48
1555,93,8921,1366209,1366302,48
4498,242,8921,1473363,1473605,48
1999,57,8930,1257740,1257797,48
4054,214,8941,1468020,1468234,48
8814,196,8943,1460908,1461104,48
5666,240,8944,1473354,1473594,48
2521,113,8976,1390589,1390702,48
2480,205,8988,1460892,1461097,48
8693,183,9005,1451924,1452107,48
8122,54,9017,1257724,1257778,48
1416,236,9023,1473287,1473523,48
7957,48,9025,1205768,1205816,48
1753,207,9033,1460885,1461092,48
3388,126,9035,1410899,1411025,48
1520,198,9040,1460898,1461096,48
2852,17,9043,809605,809622,48
6077,94,9054,1366235,1366329,48
8281,13,9056,809603,809616,48
4385,73,9086,1300914,1300987,48
2481,95,9093,1366202,1366297,48
9036,249,9116,1473202,1473451,48
5806,125,9141,1410834,1410959,48
5412,223,9153,1467878,1468101,48
6725,121,9161,1410838,1410959,48
5644,176,9167,1451872,1452048,48
4503,147,9203,1427398,1427545,48
2820,186,9212,1451835,1452021,48
4816,293,9221,1478707,1479000,48
9986,116,9265,1390521,1390637,48
4581,224,9267,1467801,1468025,48
3174,226,9275,1467810,1468036,48
7044,211,9276,1467828,1468039,48
3833,241,9289,1473072,1473313,48
4470,158,9291,1440930,1441088,48
4974,216,9297,1467832,1468048,48
2011,76,9309,1336559,1336635,48
5331,33,9313,1059285,1059318,48
2684,88,9318,1336551,1336639,48
3963,147,9329,1427422,1427569,48
3610,74,9368,1300870,1300944,48
1549,141,9394,1427371,1427512,48
2449,292,9399,1478549,1478841,48
3026,193,9431,1460698,1460891,48
1793,13,9436,809374,809387,48
8477,280,9449,1478518,1478798,48
4386,104,9463,1390502,1390606,48
4650,17,9469,809354,809371,48
5361,69,9486,1300823,1300892,48
8597,243,9493,1472925,1473168,48
1820,3,9503,235909,235912,48
6663,159,9520,1440799,1440958,48
1641,256,9522,1476284,1476540,48
7062,109,9569,1390443,1390552,48
7328,105,9571,1390448,1390553,48
7880,252,9579,1476233,1476485,48
3107,257,9585,1476229,1476486,48
8662,22,9601,949408,949430,48
5080,166,9603,1440779,1440945,48
2637,31,9605,1059137,1059168,48
3123,287,9605,1478369,1478656,48
6651,122,9606,1410749,1410871,48
9899,274,9613,1478375,1478649,48
8636,15,9620,809292,809307,48
7334,31,9621,1059151,1059182,48
9260,4,9629,450059,450063,48
7036,202,9652,1460623,1460825,48
7942,26,9669,1059117,1059143,48
4053,160,9677,1440775,1440935,48
1085,95,9702,1366076,1366171,48
1044,150,9703,1427291,1427441,48
7596,4,9708,450001,450005,48
9279,1,9715,235763,235764,48
9342,138,9715,1427296,1427434,48
9458,278,9732,1478257,1478535,48
2297,248,9735,1472830,1473078,48
3996,197,9753,1460577,1460774,48
3210,273,9759,1476131,1476404,48
2632,207,9767,1460593,1460800,48
2799,57,9770,1257556,1257613,48
9269,12,9790,641423,641435,48
9287,276,9799,1478195,1478471,48
7735,57,9819,1257523,1257580,48
1606,201,9834,1460566,1460767,48
9762,191,9847,1460567,1460758,48
7568,140,9911,1427241,1427381,48
3162,185,9928,1451593,1451778,48
3048,293,9930,1478067,1478360,48
7671,267,9938,1476021,1476288,48
7850,149,9940,1427270,1427419,48
2426,236,9941,1472732,1472968,48
3172,43,9950,1205479,1205522,48
6382,74,9951,1300724,1300798,48
7150,253,9971,1476005,1476258,48
1971,282,9980,1478037,1478319,48
623,130,63,1437228,1437358,49
274,160,90,1461559,1461719,49
311,253,158,1487889,1488142,49
327,199,263,1477270,1477469,49
642,159,277,1461416,1461575,49
153,127,352,1437014,1437141,49
512,235,372,1485672,1485907,49
892,294,547,1488758,1489052,49
873,230,556,1482251,1482481,49
496,127,623,1436799,1436926,49
225,242,667,1485404,1485646,49
371,292,673,1488651,1488943,49
534,130,708,1436754,1436884,49
482,64,739,1310123,1310187,49
842,42,849,1214744,1214786,49
182,92,865,1399741,1399833,49
427,290,938,1488403,1488693,49
5821,15,8009,951334,951349,49
5868,128,8031,1429458,1429586,49
1115,117,8036,1412898,1413015,49
2534,284,8043,1481313,1481597,49
9829,75,8059,1338543,1338618,49
4004,13,8061,811129,811142,49
6260,208,8065,1469618,1469826,49
7487,204,8074,1469628,1469832,49
2863,211,8080,1474832,1475043,49
3179,292,8103,1481262,1481554,49
7147,229,8111,1474824,1475053,49
6529,212,8117,1474838,1475050,49
5439,267,8147,1480016,1480283,49
5333,213,8172,1474807,1475020,49
1168,213,8174,1474809,1475022,49
1889,154,8180,1453808,1453962,49
1941,207,8196,1469661,1469868,49
1365,141,8204,1442899,1443040,49
8687,141,8216,1442893,1443034,49
6390,73,8217,1338551,1338624,49
6953,4,8220,451690,451694,49
9651,286,8220,1481162,1481448,49
2946,172,8222,1462693,1462865,49
4725,220,8237,1474771,1474991,49
9742,189,8247,1462689,1462878,49
9949,105,8270,1412947,1413052,49
7625,28,8272,1143098,1143126,49
3844,25,8275,1060996,1061021,49
6909,217,8287,1474732,1474949,49
8424,75,8296,1338552,1338627,49
5587,87,8328,1368201,1368288,49
2072,244,8329,1477886,1478130,49
8967,111,8343,1412905,1413016,49
2911,226,8345,1474703,1474929,49
7560,115,8355,1412915,1413030,49
8605,225,8357,1474708,1474933,49
5220,201,8359,1469636,1469837,49
2784,153,8368,1453802,1453955,49
1627,185,8369,1462681,1462866,49
1100,202,8383,1469624,1469826,49
1726,60,8406,1302873,1302933,49
1878,176,8416,1462668,1462844,49
2157,62,8425,1302871,1302933,49
7986,35,8426,1143065,1143100,49
5911,107,8438,1412933,1413040,49
5303,198,8460,1469560,1469758,49
6685,22,8464,1060938,1060960,49
7327,60,8482,1302844,1302904,49
2532,146,8490,1442863,1443009,49
8462,219,8498,1474583,1474802,49
6609,144,8500,1442881,1443025,49
9477,175,8537,1462591,1462766,49
8742,84,8539,1368208,1368292,49
3588,231,8541,1477688,1477919,49
6746,259,8544,1479657,1479916,49
7346,7,8545,643029,643036,49
1239,215,8554,1474579,1474794,49
1674,59,8555,1302865,1302924,49
9243,213,8555,1474584,1474797,49
6005,160,8558,1453793,1453953,49
1270,143,8575,1442917,1443060,49
6784,39,8584,1207511,1207550,49
1429,210,8588,1474555,1474765,49
4959,32,8597,1143038,1143070,49
9777,43,8606,1207502,1207545,49
1581,50,8607,1259569,1259619,49
8470,163,8609,1453768,1453931,49
5826,48,8620,1259572,1259620,49
5035,240,8648,1477604,1477844,49
7876,169,8660,1453746,1453915,49
4237,18,8679,951061,951079,49
3340,272,8699,1479509,1479781,49
8245,65,8704,1302809,1302874,49
7462,3,8725,451343,451346,49
4083,289,8727,1480666,1480955,49
7047,165,8732,1453727,1453892,49
1890,16,8733,951035,951051,49
4955,291,8748,1480659,1480950,49
1071,168,8757,1453733,1453901,49
5978,92,8760,1392604,1392696,49
7757,40,8763,1207461,1207501,49
7447,250,8771,1477557,1477807,49
2920,110,8774,1412915,1413025,49
2621,201,8779,1469470,1469671,49
3178,291,8789,1480634,1480925,49
2410,258,8793,1479504,1479762,49
7496,224,8793,1474498,1474722,49
9223,178,8806,1462593,1462771,49
5655,227,8810,1474496,1474723,49
1732,12,8823,810771,810783,49
4887,121,8838,1429524,1429645,49
8496,46,8853,1259523,1259569,49
5446,81,8859,1368220,1368301,49
7591,18,8865,950995,951013,49
3509,96,8879,1392613,1392709,49
4636,285,8896,1480543,1480828,49
9413,231,8906,1477508,1477739,49
4718,220,8915,1474451,1474671,49
3278,113,8923,1412922,1413035,49
7314,193,8931,1469470,1469663,49
7766,284,8942,1480507,1480791,49
4979,163,8950,1453772,1453935,49
3357,229,8964,1474434,1474663,49
5574,231,8975,1477462,1477693,49
3787,61,8980,1302819,1302880,49
5196,85,8980,1368233,1368318,49
6768,203,8981,1469484,1469687,49
3650,111,9002,1412942,1413053,49
9913,162,9025,1453762,1453924,49
8235,103,9048,1392618,1392721,49
7980,185,9050,1462528,1462713,49
4818,247,9051,1477387,1477634,49
3818,202,9053,1469446,1469648,49
5489,250,9057,1477398,1477648,49
7085,123,9062,1429526,1429649,49
4483,49,9093,1259505,1259554,49
9394,43,9103,1207423,1207466,49
7315,242,9112,1477363,1477605,49
6942,269,9118,1479231,1479500,49
1255,208,9134,1469438,1469646,49
1937,192,9141,1469450,1469642,49
9917,37,9143,1207427,1207464,49
5820,15,9149,950883,950898,49
3419,138,9167,1442911,1443049,49
9162,245,9175,1477334,1477579,49
8054,84,9242,1368174,1368258,49
2663,36,9247,1207352,1207388,49
9687,201,9275,1469339,1469540,49
8481,255,9279,1479087,1479342,49
6291,2,9281,236556,236558,49
6396,159,9295,1453700,1453859,49
1236,77,9298,1338448,1338525,49
1457,242,9325,1477221,1477463,49
1570,239,9326,1477232,1477471,49
2947,3,9354,450892,450895,49
2259,8,9385,642495,642503,49
1769,10,9390,810422,810432,49
4964,188,9403,1462418,1462606,49
9404,182,9437,1462402,1462584,49
9589,89,9458,1368056,1368145,49
4666,5,9460,450802,450807,49
3452,261,9470,1478899,1479160,49
5083,268,9499,1478879,1479147,49
8132,218,9499,1474150,1474368,49
8593,243,9511,1477100,1477343,49
5348,282,9530,1479928,1480210,49
7174,14,9549,810304,810318,49
1381,118,9550,1412761,1412879,49
9564,260,9557,1478860,1479120,49
6554,32,9563,1142661,1142693,49
6652,63,9590,1302579,1302642,49
1834,83,9601,1368016,1368099,49
4494,84,9630,1367993,1368077,49
6813,52,9636,1259227,1259279,49
7413,128,9649,1429247,1429375,49
4369,56,9652,1302559,1302615,49
6207,96,9666,1392377,1392473,49
4759,295,9679,1479786,1480081,49
2356,132,9687,1429234,1429366,49
8676,180,9691,1462293,1462473,49
2023,132,9719,1429231,1429363,49
8525,230,9721,1474021,1474251,49
6625,275,9725,1478723,1478998,49
1136,284,9734,1479751,1480035,49
8367,12,9755,810188,810200,49
2909,123,9767,1429244,1429367,49
1193,10,9768,810183,810193,49
1805,184,9781,1462270,1462454,49
5147,12,9782,810175,810187,49
6131,266,9782,1478712,1478978,49
3302,39,9784,1207113,1207152,49
8962,269,9784,1478724,1478993,49
2043,268,9795,1478730,1478998,49
4351,95,9798,1392419,1392514,49
8187,223,9798,1474070,1474293,49
6466,98,9809,1392427,1392525,49
4708,140,9818,1442671,1442811,49
8237,247,9827,1476973,1477220,49
8534,70,9832,1338322,1338392,49
5639,188,9856,1462304,1462492,49
2737,212,9861,1474042,1474254,49
4256,72,9862,1338321,1338393,49
6386,259,9862,1478679,1478938,49
4169,278,9876,1479618,1479896,49
3131,153,9882,1453570,1453723,49
5407,82,9882,1368060,1368142,49
7825,46,9907,1259244,1259290,49
1120,100,9921,1392421,1392521,49
4970,6,9931,642156,642162,49
2271,300,9965,1480002,1480302,49
8279,181,9968,1462286,1462467,49
2714,150,9979,1442651,1442801,49
9137,113,9979,1412721,1412834,49
4281,54,9993,1259210,1259264,49
760,12,86,960317,960329,50
714,211,100,1486803,1487014,50
480,229,103,1486801,1487030,50
494,220,134,1486789,1487009,50
119,96,224,1422540,1422636,50
630,80,230,1402242,1402322,50
487,283,256,1489735,1490018,50
536,262,303,1489263,1489525,50
206,298,348,1489650,1489948,50
567,79,376,1402137,1402216,50
883,158,414,1471976,1472134,50
254,251,463,1488218,1488469,50
540,46,558,1312115,1312161,50
279,27,599,1152040,1152067,50
730,55,632,1312042,1312097,50
397,268,705,1488893,1489161,50
377,9,756,819391,819400,50
738,195,832,1483316,1483511,50
247,88,881,1401685,1401773,50
765,188,912,1478343,1478531,50
903,73,987,1377216,1377289,50
6656,142,8004,1455688,1455830,50
6301,13,8026,952479,952492,50
8817,146,8068,1455630,1455776,50
3956,58,8075,1340431,1340489,50
5614,189,8079,1471193,1471382,50
3420,273,8086,1481527,1481800,50
2772,68,8088,1370170,1370238,50
1893,143,8109,1455633,1455776,50
9443,199,8110,1476063,1476262,50
2260,259,8122,1481511,1481770,50
2972,31,8147,1209175,1209206,50
1158,287,8156,1481864,1482151,50
5854,231,8168,1478933,1479164,50
2733,92,8184,1414823,1414915,50
7973,26,8196,1144582,1144608,50
4788,168,8197,1464378,1464546,50
7848,8,8203,812027,812035,50
1780,102,8222,1414800,1414902,50
9562,125,8226,1444770,1444895,50
6446,290,8250,1481781,1482071,50
7749,113,8266,1431348,1431461,50
4894,32,8291,1209098,1209130,50
6191,124,8316,1444701,1444825,50
7684,165,8316,1464292,1464457,50
5397,40,8325,1261229,1261269,50
3232,15,8345,952273,952288,50
4211,102,8345,1414758,1414860,50
6226,69,8347,1370081,1370150,50
1278,222,8348,1478795,1479017,50
5232,96,8413,1414715,1414811,50
6293,169,8416,1464222,1464391,50
5605,43,8443,1261160,1261203,50
6405,111,8468,1431214,1431325,50
5340,29,8476,1208997,1209026,50
6683,180,8494,1470929,1471109,50
4923,230,8501,1478654,1478884,50
6305,143,8502,1455434,1455577,50
6364,245,8516,1480295,1480540,50
8143,243,8516,1480309,1480552,50
5266,284,8525,1481520,1481804,50
2233,25,8540,1144404,1144429,50
8118,56,8554,1340263,1340319,50
3247,66,8570,1340248,1340314,50
1745,8,8577,811759,811767,50
7219,199,8579,1475783,1475982,50
3816,111,8591,1431202,1431313,50
5148,283,8616,1481437,1481720,50
7733,249,8616,1480265,1480514,50
3528,116,8637,1431192,1431308,50
7915,231,8649,1478631,1478862,50
7160,210,8675,1475756,1475966,50
6465,275,8684,1481047,1481322,50
3341,144,8690,1455406,1455550,50
5477,100,8700,1414671,1414771,50
4399,49,8709,1304455,1304504,50
8966,4,8710,643628,643632,50
5201,111,8715,1431185,1431296,50
7958,193,8732,1475739,1475932,50
3638,157,8735,1464135,1464292,50
4724,207,8740,1475734,1475941,50
4269,210,8745,1475746,1475956,50
9765,192,8750,1475761,1475953,50
2002,129,8755,1444602,1444731,50
5855,205,8756,1475757,1475962,50
2791,45,8761,1261101,1261146,50
2579,10,8771,811647,811657,50
1640,299,8774,1481286,1481585,50
1885,271,8824,1480952,1481223,50
4700,250,8824,1480141,1480391,50
5176,189,8836,1470938,1471127,50
4216,112,8877,1431194,1431306,50
8952,243,8883,1480101,1480344,50
8461,95,8891,1414685,1414780,50
4555,286,8896,1481187,1481473,50
7997,18,8896,1061945,1061963,50
2955,208,8901,1475727,1475935,50
3493,186,8906,1470943,1471129,50
9970,249,8916,1480102,1480351,50
5057,172,8937,1470946,1471118,50
7878,280,8944,1481149,1481429,50
2665,41,8958,1261030,1261071,50
6832,113,8959,1431224,1431337,50
3561,134,8961,1444597,1444731,50
1490,166,8967,1464177,1464343,50
1855,152,8973,1455437,1455589,50
5667,149,8975,1455451,1455600,50
6584,298,8993,1481104,1481402,50
6378,126,9022,1444614,1444740,50
4954,44,9023,1261033,1261077,50
4931,155,9024,1464151,1464306,50
5981,142,9024,1455449,1455591,50
7795,246,9048,1480032,1480278,50
7005,123,9050,1444640,1444763,50
3572,69,9067,1369988,1370057,50
6763,1,9076,237006,237007,50
9596,160,9080,1464115,1464275,50
9371,203,9103,1475623,1475826,50
6145,113,9104,1431267,1431380,50
8713,242,9138,1479957,1480199,50
4584,127,9141,1444600,1444727,50
5805,255,9152,1480711,1480966,50
1408,199,9162,1475617,1475816,50
5934,192,9171,1475617,1475809,50
6844,65,9171,1340219,1340284,50
8440,109,9202,1431252,1431361,50
2834,210,9211,1475579,1475789,50
3708,210,9211,1475599,1475809,50
1261,252,9222,1479906,1480158,50
6411,72,9223,1369979,1370051,50
4863,92,9232,1414754,1414846,50
3403,72,9242,1369978,1370050,50
3264,184,9245,1470848,1471032,50
1403,213,9274,1478300,1478513,50
3334,67,9296,1369954,1370021,50
5573,158,9298,1464084,1464242,50
8010,44,9315,1260974,1261018,50
6559,299,9328,1480791,1481090,50
6716,192,9344,1475546,1475738,50
3974,225,9347,1478251,1478476,50
7705,68,9350,1369949,1370017,50
7074,121,9389,1444551,1444672,50
5257,109,9394,1431214,1431323,50
2189,43,9413,1260938,1260981,50
1863,177,9417,1470765,1470942,50
5721,215,9419,1478194,1478409,50
8671,169,9434,1464043,1464212,50
9248,71,9434,1369927,1369998,50
7446,205,9448,1475484,1475689,50
3512,20,9453,1061703,1061723,50
9870,233,9470,1479701,1479934,50
4644,245,9504,1479669,1479914,50
9508,51,9516,1304312,1304363,50
1800,147,9524,1455329,1455476,50
6505,192,9533,1475454,1475646,50
6486,60,9539,1340147,1340207,50
8822,102,9542,1414669,1414771,50
4040,159,9558,1464007,1464166,50
5127,244,9559,1479628,1479872,50
4286,151,9561,1455354,1455505,50
7657,54,9586,1304318,1304372,50
5684,47,9591,1304322,1304369,50
7925,195,9603,1475406,1475601,50
8077,270,9604,1480284,1480554,50
2883,40,9606,1260923,1260963,50
9102,102,9612,1414680,1414782,50
8268,289,9645,1480497,1480786,50
3177,192,9649,1475405,1475597,50
8778,190,9657,1470721,1470911,50
2728,4,9666,642946,642950,50
3059,221,9669,1478054,1478275,50
3819,285,9685,1480470,1480755,50
1760,212,9705,1478050,1478262,50
5448,284,9741,1480423,1480707,50
1513,269,9766,1480208,1480477,50
5085,126,9788,1444489,1444615,50
5380,160,9788,1463981,1464141,50
3201,113,9790,1431167,1431280,50
1626,126,9813,1444486,1444612,50
2888,284,9814,1480358,1480642,50
7341,178,9832,1470679,1470857,50
6229,173,9865,1470653,1470826,50
6254,78,9872,1369818,1369896,50
2664,11,9878,951400,951411,50
4957,49,9878,1304227,1304276,50
7871,12,9897,951387,951399,50
2940,191,9898,1475278,1475469,50
9345,130,9899,1444470,1444600,50
6988,151,9909,1455276,1455427,50
3580,65,9922,1340055,1340120,50
1814,204,9928,1475249,1475453,50
8057,52,9953,1304206,1304258,50
1681,9,9967,810867,810876,50
9744,248,9978,1479354,1479602,50
2814,95,9979,1414604,1414699,50
3099,106,9979,1431121,1431227,50

Average Waiting Time = 895513

Average Turn Around Time = 895662
